STATE/UT,Year,CAUSE,Male upto 14 years,Male 15-29 years,Male 30-44 years,Male 45-59 years,Male 60 years and above,Total Male,Female upto 14 years,Female 15-29 years,Female 30-44 years,Female 45-59 years,Female 60 years and above,Total Female,Grand Total
ANDHRA PRADESH,2005,House Wife,0,0,0,0,0,0,0,932,693,382,172,2179,2179
ANDHRA PRADESH,2005,Service (Government),0,10,43,57,0,110,0,6,24,0,0,30,140
ANDHRA PRADESH,2005,Service (Private),2,213,286,161,37,699,0,69,39,18,5,131,830
ANDHRA PRADESH,2005,Public Sector Undertaking,0,42,109,80,2,233,0,5,36,3,0,44,277
ANDHRA PRADESH,2005,Student,53,197,24,0,0,274,65,155,6,0,0,226,500
ANDHRA PRADESH,2005,Unemployed,1,169,160,52,48,430,0,70,10,0,0,80,510
ANDHRA PRADESH,2005,Self-employed (Business activity),2,238,304,244,94,882,0,53,31,27,4,115,997
ANDHRA PRADESH,2005,Professional Activity,0,37,61,43,41,182,1,26,8,3,0,38,220
ANDHRA PRADESH,2005,Farming/Agriculture Activity,6,481,729,578,223,2017,22,127,174,85,65,473,2490
ANDHRA PRADESH,2005,Others (Please Specify),25,357,443,256,168,1249,23,208,138,70,29,468,1717
ANDHRA PRADESH,2005,Retired Person,0,2,0,35,20,57,0,1,0,1,1,3,60
ANDHRA PRADESH,2005,Others (Please Specify),54,698,1019,650,311,2732,50,252,201,144,143,790,3522
ANDHRA PRADESH,2005,Total,143,2444,3178,2156,944,8865,161,1904,1360,733,419,4577,13442
ANDHRA PRADESH,2005,Total Salaried,2,265,438,298,39,1042,0,80,99,21,5,205,1247
ANDHRA PRADESH,2005,Total Self-employed,33,1113,1537,1121,526,4330,46,414,351,185,98,1094,5424
ARUNACHAL PRADESH,2005,House Wife,0,0,0,0,0,0,0,1,6,1,1,9,9
ARUNACHAL PRADESH,2005,Service (Government),0,0,3,0,0,3,0,1,0,0,0,1,4
ARUNACHAL PRADESH,2005,Service (Private),0,0,4,0,0,4,0,0,1,0,0,1,5
ARUNACHAL PRADESH,2005,Public Sector Undertaking,0,0,0,0,0,0,0,0,0,0,0,0,0
ARUNACHAL PRADESH,2005,Student,0,1,0,0,0,1,0,1,0,0,0,1,2
ARUNACHAL PRADESH,2005,Unemployed,0,1,2,1,0,4,0,1,0,0,0,1,5
ARUNACHAL PRADESH,2005,Self-employed (Business activity),0,5,11,1,1,18,0,1,0,0,0,1,19
ARUNACHAL PRADESH,2005,Professional Activity,0,1,0,0,0,1,0,0,0,0,0,0,1
ARUNACHAL PRADESH,2005,Farming/Agriculture Activity,0,5,8,2,3,18,0,5,2,0,0,7,25
ARUNACHAL PRADESH,2005,Others (Please Specify),0,0,0,0,0,0,0,0,0,0,0,0,0
ARUNACHAL PRADESH,2005,Retired Person,0,0,0,0,0,0,0,0,0,0,0,0,0
ARUNACHAL PRADESH,2005,Others (Please Specify),0,0,0,0,0,0,0,0,0,0,0,0,0
ARUNACHAL PRADESH,2005,Total,0,13,28,4,4,49,0,10,9,1,1,21,70
ARUNACHAL PRADESH,2005,Total Salaried,0,0,7,0,0,7,0,1,1,0,0,2,9
ARUNACHAL PRADESH,2005,Total Self-employed,0,11,19,3,4,37,0,6,2,0,0,8,45
ASSAM,2005,House Wife,0,0,0,0,0,0,0,281,206,76,3,566,566
ASSAM,2005,Service (Government),0,2,6,6,0,14,0,0,0,0,0,0,14
ASSAM,2005,Service (Private),0,17,17,9,0,43,0,8,2,0,0,10,53
ASSAM,2005,Public Sector Undertaking,0,20,17,19,0,56,0,4,0,0,0,4,60
ASSAM,2005,Student,16,87,0,0,0,103,18,33,0,0,0,51,154
ASSAM,2005,Unemployed,0,5,40,33,9,87,0,0,8,1,0,9,96
ASSAM,2005,Self-employed (Business activity),0,112,164,72,2,350,0,14,13,1,1,29,379
ASSAM,2005,Professional Activity,0,15,32,19,0,66,0,0,0,0,3,3,69
ASSAM,2005,Farming/Agriculture Activity,0,60,117,65,14,256,2,16,16,9,0,43,299
ASSAM,2005,Others (Please Specify),11,260,292,119,21,703,11,46,43,19,5,124,827
ASSAM,2005,Retired Person,0,0,0,3,6,9,0,0,0,0,2,2,11
ASSAM,2005,Others (Please Specify),9,65,106,63,21,264,6,23,11,10,4,54,318
ASSAM,2005,Total,36,643,791,408,73,1951,37,425,299,116,18,895,2846
ASSAM,2005,Total Salaried,0,39,40,34,0,113,0,12,2,0,0,14,127
ASSAM,2005,Total Self-employed,11,447,605,275,37,1375,13,76,72,29,9,199,1574
BIHAR,2005,House Wife,0,0,0,0,0,0,0,55,38,11,5,109,109
BIHAR,2005,Service (Government),0,0,3,2,0,5,0,1,0,0,0,1,6
BIHAR,2005,Service (Private),0,12,15,7,0,34,0,0,2,0,0,2,36
BIHAR,2005,Public Sector Undertaking,0,1,3,5,0,9,0,0,0,0,0,0,9
BIHAR,2005,Student,7,24,2,0,0,33,3,5,6,0,0,14,47
BIHAR,2005,Unemployed,0,11,5,4,3,23,0,5,0,0,0,5,28
BIHAR,2005,Self-employed (Business activity),0,7,6,4,1,18,0,0,0,0,0,0,18
BIHAR,2005,Professional Activity,0,8,7,4,0,19,0,0,0,0,0,0,19
BIHAR,2005,Farming/Agriculture Activity,1,5,17,8,1,32,0,3,2,2,0,7,39
BIHAR,2005,Others (Please Specify),1,11,9,1,0,22,0,5,2,2,0,9,31
BIHAR,2005,Retired Person,0,0,0,1,1,2,0,1,1,0,0,2,4
BIHAR,2005,Others (Please Specify),5,44,39,34,8,130,2,29,26,8,2,67,197
BIHAR,2005,Total,14,123,106,70,14,327,5,104,77,23,7,216,543
BIHAR,2005,Total Salaried,0,13,21,14,0,48,0,1,2,0,0,3,51
BIHAR,2005,Total Self-employed,2,31,39,17,2,91,0,8,4,4,0,16,107
CHHATTISGARH,2005,House Wife,0,0,0,0,0,0,8,433,283,115,52,891,891
CHHATTISGARH,2005,Service (Government),0,27,18,12,1,58,0,3,1,1,1,6,64
CHHATTISGARH,2005,Service (Private),14,48,64,44,8,178,2,6,7,2,0,17,195
CHHATTISGARH,2005,Public Sector Undertaking,0,20,11,2,0,33,0,9,3,3,0,15,48
CHHATTISGARH,2005,Student,19,91,6,0,0,116,21,46,5,0,0,72,188
CHHATTISGARH,2005,Unemployed,17,139,50,17,5,228,3,10,7,4,1,25,253
CHHATTISGARH,2005,Self-employed (Business activity),13,36,43,43,12,147,1,13,7,5,1,27,174
CHHATTISGARH,2005,Professional Activity,13,33,50,27,8,131,1,4,2,2,0,9,140
CHHATTISGARH,2005,Farming/Agriculture Activity,6,301,490,309,94,1200,0,81,76,44,11,212,1412
CHHATTISGARH,2005,Others (Please Specify),24,83,180,82,41,410,8,41,42,15,11,117,527
CHHATTISGARH,2005,Retired Person,0,7,1,0,3,11,0,0,0,0,1,1,12
CHHATTISGARH,2005,Others (Please Specify),54,277,261,140,61,793,29,96,32,18,9,184,977
CHHATTISGARH,2005,Total,160,1062,1174,676,233,3305,73,742,465,209,87,1576,4881
CHHATTISGARH,2005,Total Salaried,14,95,93,58,9,269,2,18,11,6,1,38,307
CHHATTISGARH,2005,Total Self-employed,56,453,763,461,155,1888,10,139,127,66,23,365,2253
GOA,2005,House Wife,0,0,0,0,0,0,0,18,8,13,8,47,47
GOA,2005,Service (Government),0,2,3,2,0,7,0,0,0,0,0,0,7
GOA,2005,Service (Private),0,13,25,8,0,46,0,4,2,0,0,6,52
GOA,2005,Public Sector Undertaking,0,2,3,1,0,6,0,0,0,0,0,0,6
GOA,2005,Student,2,6,0,0,0,8,1,6,0,0,0,7,15
GOA,2005,Unemployed,0,15,17,8,5,45,0,10,1,1,1,13,58
GOA,2005,Self-employed (Business activity),0,2,3,3,0,8,0,0,1,0,0,1,9
GOA,2005,Professional Activity,0,1,0,0,0,1,0,0,0,0,0,0,1
GOA,2005,Farming/Agriculture Activity,0,0,4,2,4,10,0,0,0,0,1,1,11
GOA,2005,Others (Please Specify),0,2,7,2,2,13,0,0,1,0,0,1,14
GOA,2005,Retired Person,0,0,0,3,1,4,0,0,0,0,1,1,5
GOA,2005,Others (Please Specify),0,11,23,11,4,49,1,4,2,1,0,8,57
GOA,2005,Total,2,54,85,40,16,197,2,42,15,15,11,85,282
GOA,2005,Total Salaried,0,17,31,11,0,59,0,4,2,0,0,6,65
GOA,2005,Total Self-employed,0,5,14,7,6,32,0,0,2,0,1,3,35
GUJARAT,2005,House Wife,0,0,0,0,0,0,0,548,498,203,71,1320,1320
GUJARAT,2005,Service (Government),0,21,35,17,0,73,0,1,1,2,0,4,77
GUJARAT,2005,Service (Private),0,135,191,97,5,428,0,32,19,5,0,56,484
GUJARAT,2005,Public Sector Undertaking,0,18,33,16,0,67,0,2,1,0,0,3,70
GUJARAT,2005,Student,16,82,7,0,0,105,21,99,0,0,0,120,225
GUJARAT,2005,Unemployed,1,151,140,75,5,372,1,26,8,3,2,40,412
GUJARAT,2005,Self-employed (Business activity),0,84,108,59,16,267,0,1,0,0,1,2,269
GUJARAT,2005,Professional Activity,0,120,115,68,17,320,0,10,3,0,0,13,333
GUJARAT,2005,Farming/Agriculture Activity,0,159,182,136,42,519,2,45,29,16,4,96,615
GUJARAT,2005,Others (Please Specify),3,139,173,67,10,392,2,34,18,9,5,68,460
GUJARAT,2005,Retired Person,0,0,1,35,68,104,0,0,0,5,23,28,132
GUJARAT,2005,Others (Please Specify),5,71,97,53,29,255,7,53,24,16,13,113,368
GUJARAT,2005,Total,25,980,1082,623,192,2902,33,851,601,259,119,1863,4765
GUJARAT,2005,Total Salaried,0,174,259,130,5,568,0,35,21,7,0,63,631
GUJARAT,2005,Total Self-employed,3,502,578,330,85,1498,4,90,50,25,10,179,1677
HARYANA,2005,House Wife,0,0,0,0,0,0,2,119,125,49,8,303,303
HARYANA,2005,Service (Government),0,14,16,7,0,37,0,1,5,0,0,6,43
HARYANA,2005,Service (Private),0,72,48,24,0,144,1,6,3,1,0,11,155
HARYANA,2005,Public Sector Undertaking,0,4,10,1,0,15,0,3,2,0,0,5,20
HARYANA,2005,Student,7,57,3,0,0,67,6,25,3,0,0,34,101
HARYANA,2005,Unemployed,5,64,54,17,6,146,0,7,4,1,1,13,159
HARYANA,2005,Self-employed (Business activity),0,10,38,15,8,71,0,0,0,0,0,0,71
HARYANA,2005,Professional Activity,0,6,11,0,1,18,1,0,0,0,0,1,19
HARYANA,2005,Farming/Agriculture Activity,1,37,57,23,10,128,2,6,2,2,0,12,140
HARYANA,2005,Others (Please Specify),5,83,68,34,12,202,2,11,3,3,0,19,221
HARYANA,2005,Retired Person,0,0,6,4,1,11,0,0,2,2,1,5,16
HARYANA,2005,Others (Please Specify),10,163,297,149,35,654,1,79,38,18,8,144,798
HARYANA,2005,Total,28,510,608,274,73,1493,15,257,187,76,18,553,2046
HARYANA,2005,Total Salaried,0,90,74,32,0,196,1,10,10,1,0,22,218
HARYANA,2005,Total Self-employed,6,136,174,72,31,419,5,17,5,5,0,32,451
HIMACHAL PRADESH,2005,House Wife,0,0,0,0,0,0,0,41,26,8,0,75,75
HIMACHAL PRADESH,2005,Service (Government),0,1,9,4,0,14,0,1,1,0,0,2,16
HIMACHAL PRADESH,2005,Service (Private),0,10,14,4,1,29,0,0,0,0,0,0,29
HIMACHAL PRADESH,2005,Public Sector Undertaking,0,1,5,1,0,7,0,1,0,0,0,1,8
HIMACHAL PRADESH,2005,Student,0,9,1,0,0,10,1,14,0,0,0,15,25
HIMACHAL PRADESH,2005,Unemployed,0,9,9,1,0,19,0,5,3,0,0,8,27
HIMACHAL PRADESH,2005,Self-employed (Business activity),0,2,3,2,0,7,0,0,0,0,0,0,7
HIMACHAL PRADESH,2005,Professional Activity,0,1,3,0,0,4,0,0,0,0,0,0,4
HIMACHAL PRADESH,2005,Farming/Agriculture Activity,0,8,3,7,2,20,0,0,0,0,0,0,20
HIMACHAL PRADESH,2005,Others (Please Specify),0,12,24,16,12,64,0,4,6,4,1,15,79
HIMACHAL PRADESH,2005,Retired Person,0,0,0,0,0,0,0,0,0,0,0,0,0
HIMACHAL PRADESH,2005,Others (Please Specify),2,16,15,7,0,40,0,15,11,1,2,29,69
HIMACHAL PRADESH,2005,Total,2,69,86,42,15,214,1,81,47,13,3,145,359
HIMACHAL PRADESH,2005,Total Salaried,0,12,28,9,1,50,0,2,1,0,0,3,53
HIMACHAL PRADESH,2005,Total Self-employed,0,23,33,25,14,95,0,4,6,4,1,15,110
JAMMU & KASHMIR,2005,House Wife,0,0,0,0,0,0,0,17,14,1,0,32,32
JAMMU & KASHMIR,2005,Service (Government),0,14,4,0,0,18,0,0,0,0,0,0,18
JAMMU & KASHMIR,2005,Service (Private),0,23,11,0,0,34,0,0,0,0,0,0,34
JAMMU & KASHMIR,2005,Public Sector Undertaking,0,0,0,0,0,0,0,0,0,0,0,0,0
JAMMU & KASHMIR,2005,Student,1,14,5,0,0,20,1,3,0,0,0,4,24
JAMMU & KASHMIR,2005,Unemployed,0,18,8,1,0,27,0,3,10,0,0,13,40
JAMMU & KASHMIR,2005,Self-employed (Business activity),0,0,0,0,0,0,0,0,0,0,0,0,0
JAMMU & KASHMIR,2005,Professional Activity,0,0,0,0,0,0,0,0,0,0,0,0,0
JAMMU & KASHMIR,2005,Farming/Agriculture Activity,0,1,0,0,0,1,0,1,0,0,0,1,2
JAMMU & KASHMIR,2005,Others (Please Specify),0,19,9,5,0,33,0,17,9,0,2,28,61
JAMMU & KASHMIR,2005,Retired Person,0,6,0,1,0,7,0,0,0,0,0,0,7
JAMMU & KASHMIR,2005,Others (Please Specify),2,18,22,10,4,56,3,13,3,0,1,20,76
JAMMU & KASHMIR,2005,Total,3,113,59,17,4,196,4,54,36,1,3,98,294
JAMMU & KASHMIR,2005,Total Salaried,0,37,15,0,0,52,0,0,0,0,0,0,52
JAMMU & KASHMIR,2005,Total Self-employed,0,20,9,5,0,34,0,18,9,0,2,29,63
JHARKHAND,2005,House Wife,0,0,0,0,0,0,0,57,76,22,3,158,158
JHARKHAND,2005,Service (Government),0,0,4,5,0,9,0,1,1,0,0,2,11
JHARKHAND,2005,Service (Private),0,14,13,6,0,33,0,0,9,0,0,9,42
JHARKHAND,2005,Public Sector Undertaking,0,2,3,0,0,5,0,1,0,0,0,1,6
JHARKHAND,2005,Student,2,53,14,0,0,69,6,14,9,0,0,29,98
JHARKHAND,2005,Unemployed,0,20,6,0,0,26,0,8,14,0,0,22,48
JHARKHAND,2005,Self-employed (Business activity),0,5,14,14,0,33,0,0,0,1,0,1,34
JHARKHAND,2005,Professional Activity,0,0,4,5,0,9,0,0,0,0,0,0,9
JHARKHAND,2005,Farming/Agriculture Activity,0,38,56,29,1,124,0,0,0,0,0,0,124
JHARKHAND,2005,Others (Please Specify),2,21,24,8,0,55,5,16,9,4,1,35,90
JHARKHAND,2005,Retired Person,0,0,0,0,3,3,0,0,0,0,0,0,3
JHARKHAND,2005,Others (Please Specify),4,28,49,66,10,157,2,15,10,1,0,28,185
JHARKHAND,2005,Total,8,181,187,133,14,523,13,112,128,28,4,285,808
JHARKHAND,2005,Total Salaried,0,16,20,11,0,47,0,2,10,0,0,12,59
JHARKHAND,2005,Total Self-employed,2,64,98,56,1,221,5,16,9,5,1,36,257
KARNATAKA,2005,House Wife,0,0,0,0,0,0,4,816,658,280,116,1874,1874
KARNATAKA,2005,Service (Government),0,32,41,66,0,139,0,9,7,5,0,21,160
KARNATAKA,2005,Service (Private),1,342,295,235,16,889,1,54,35,24,10,124,1013
KARNATAKA,2005,Public Sector Undertaking,0,57,60,56,11,184,0,11,13,10,0,34,218
KARNATAKA,2005,Student,35,137,15,2,0,189,32,134,13,0,0,179,368
KARNATAKA,2005,Unemployed,3,192,117,68,23,403,0,34,20,8,4,66,469
KARNATAKA,2005,Self-employed (Business activity),1,118,168,101,14,402,0,9,23,14,0,46,448
KARNATAKA,2005,Professional Activity,1,59,96,69,17,242,2,3,3,21,7,36,278
KARNATAKA,2005,Farming/Agriculture Activity,4,350,691,422,196,1663,0,58,91,61,10,220,1883
KARNATAKA,2005,Others (Please Specify),12,511,605,440,214,1782,6,208,126,94,57,491,2273
KARNATAKA,2005,Retired Person,0,1,2,8,24,35,0,2,0,3,0,5,40
KARNATAKA,2005,Others (Please Specify),47,462,601,485,184,1779,42,276,237,131,68,754,2533
KARNATAKA,2005,Total,104,2261,2691,1952,699,7707,87,1614,1226,651,272,3850,11557
KARNATAKA,2005,Total Salaried,1,431,396,357,27,1212,1,74,55,39,10,179,1391
KARNATAKA,2005,Total Self-employed,18,1038,1560,1032,441,4089,8,278,243,190,74,793,4882
KERALA,2005,House Wife,0,0,0,0,0,0,0,305,421,390,297,1413,1413
KERALA,2005,Service (Government),0,1,30,36,0,67,0,4,6,8,0,18,85
KERALA,2005,Service (Private),0,45,131,82,15,273,0,24,14,9,2,49,322
KERALA,2005,Public Sector Undertaking,0,6,17,23,0,46,0,6,1,3,0,10,56
KERALA,2005,Student,40,100,0,0,0,140,40,100,1,0,0,141,281
KERALA,2005,Unemployed,0,268,355,228,129,980,1,114,58,33,35,241,1221
KERALA,2005,Self-employed (Business activity),0,37,148,172,38,395,0,3,1,1,0,5,400
KERALA,2005,Professional Activity,0,31,65,48,7,151,0,7,3,1,0,11,162
KERALA,2005,Farming/Agriculture Activity,0,89,337,383,264,1073,1,3,17,17,7,45,1118
KERALA,2005,Others (Please Specify),1,453,699,815,469,2437,2,77,75,86,72,312,2749
KERALA,2005,Retired Person,0,0,0,31,61,92,0,0,1,1,10,12,104
KERALA,2005,Others (Please Specify),5,208,337,389,237,1176,6,47,34,27,43,157,1333
KERALA,2005,Total,46,1238,2119,2207,1220,6830,50,690,632,576,466,2414,9244
KERALA,2005,Total Salaried,0,52,178,141,15,386,0,34,21,20,2,77,463
KERALA,2005,Total Self-employed,1,610,1249,1418,778,4056,3,90,96,105,79,373,4429
MADHYA PRADESH,2005,House Wife,0,0,0,0,0,0,0,1114,523,178,77,1892,1892
MADHYA PRADESH,2005,Service (Government),0,7,19,17,0,43,0,6,4,1,0,11,54
MADHYA PRADESH,2005,Service (Private),0,73,64,26,5,168,0,40,5,1,1,47,215
MADHYA PRADESH,2005,Public Sector Undertaking,0,44,33,10,5,92,0,16,14,1,0,31,123
MADHYA PRADESH,2005,Student,34,95,1,0,0,130,18,51,0,0,0,69,199
MADHYA PRADESH,2005,Unemployed,0,108,62,36,6,212,0,17,8,2,0,27,239
MADHYA PRADESH,2005,Self-employed (Business activity),3,60,66,35,10,174,0,18,5,1,0,24,198
MADHYA PRADESH,2005,Professional Activity,2,30,77,19,3,131,0,17,4,6,3,30,161
MADHYA PRADESH,2005,Farming/Agriculture Activity,7,452,333,177,86,1055,4,108,64,12,5,193,1248
MADHYA PRADESH,2005,Others (Please Specify),15,193,236,104,68,616,26,96,36,9,9,176,792
MADHYA PRADESH,2005,Retired Person,0,0,0,0,8,8,0,0,0,0,0,0,8
MADHYA PRADESH,2005,Others (Please Specify),22,62,58,48,32,222,30,44,21,1,1,97,319
MADHYA PRADESH,2005,Total,83,1124,949,472,223,2851,78,1527,684,212,96,2597,5448
MADHYA PRADESH,2005,Total Salaried,0,124,116,53,10,303,0,62,23,3,1,89,392
MADHYA PRADESH,2005,Total Self-employed,27,735,712,335,167,1976,30,239,109,28,17,423,2399
MAHARASHTRA,2005,House Wife,0,0,0,0,0,0,3,1857,1084,409,229,3582,3582
MAHARASHTRA,2005,Service (Government),0,36,122,102,0,260,0,18,18,4,0,40,300
MAHARASHTRA,2005,Service (Private),0,456,650,340,39,1485,1,78,34,6,2,121,1606
MAHARASHTRA,2005,Public Sector Undertaking,0,30,39,33,3,105,0,9,3,1,0,13,118
MAHARASHTRA,2005,Student,53,346,3,0,0,402,55,327,0,0,0,382,784
MAHARASHTRA,2005,Unemployed,0,459,368,121,2,950,0,63,13,3,0,79,1029
MAHARASHTRA,2005,Self-employed (Business activity),0,98,188,81,17,384,0,4,1,1,0,6,390
MAHARASHTRA,2005,Professional Activity,0,97,151,102,27,377,0,7,2,4,3,16,393
MAHARASHTRA,2005,Farming/Agriculture Activity,4,826,1433,908,467,3638,2,127,76,58,25,288,3926
MAHARASHTRA,2005,Others (Please Specify),17,501,625,373,251,1767,15,117,57,59,19,267,2034
MAHARASHTRA,2005,Retired Person,0,0,0,15,99,114,0,0,0,1,6,7,121
MAHARASHTRA,2005,Others (Please Specify),1,28,52,26,14,121,3,6,8,3,2,22,143
MAHARASHTRA,2005,Total,75,2877,3631,2101,919,9603,79,2613,1296,549,286,4823,14426
MAHARASHTRA,2005,Total Salaried,0,522,811,475,42,1850,1,105,55,11,2,174,2024
MAHARASHTRA,2005,Total Self-employed,21,1522,2397,1464,762,6166,17,255,136,122,47,577,6743
MANIPUR,2005,House Wife,0,0,0,0,0,0,0,0,2,0,0,2,2
MANIPUR,2005,Service (Government),0,1,7,0,0,8,0,0,0,0,0,0,8
MANIPUR,2005,Service (Private),0,0,0,0,0,0,0,0,0,0,0,0,0
MANIPUR,2005,Public Sector Undertaking,0,0,0,0,0,0,0,0,0,0,0,0,0
MANIPUR,2005,Student,0,1,0,0,0,1,0,1,0,0,0,1,2
MANIPUR,2005,Unemployed,0,0,0,0,0,0,0,0,0,0,0,0,0
MANIPUR,2005,Self-employed (Business activity),0,1,2,1,0,4,0,0,0,0,0,0,4
MANIPUR,2005,Professional Activity,0,0,0,0,0,0,0,0,0,0,0,0,0
MANIPUR,2005,Farming/Agriculture Activity,0,0,2,0,0,2,0,0,0,0,0,0,2
MANIPUR,2005,Others (Please Specify),0,1,5,0,0,6,0,0,0,0,0,0,6
MANIPUR,2005,Retired Person,0,0,0,0,0,0,0,0,0,0,0,0,0
MANIPUR,2005,Others (Please Specify),0,1,1,0,0,2,0,1,0,0,0,1,3
MANIPUR,2005,Total,0,5,17,1,0,23,0,2,2,0,0,4,27
MANIPUR,2005,Total Salaried,0,1,7,0,0,8,0,0,0,0,0,0,8
MANIPUR,2005,Total Self-employed,0,2,9,1,0,12,0,0,0,0,0,0,12
MEGHALAYA,2005,House Wife,0,0,0,0,0,0,0,6,3,2,0,11,11
MEGHALAYA,2005,Service (Government),0,0,1,0,0,1,0,0,0,0,0,0,1
MEGHALAYA,2005,Service (Private),0,0,2,1,0,3,0,0,0,0,0,0,3
MEGHALAYA,2005,Public Sector Undertaking,0,0,0,1,0,1,0,0,0,0,0,0,1
MEGHALAYA,2005,Student,2,4,0,0,0,6,0,5,0,0,0,5,11
MEGHALAYA,2005,Unemployed,1,6,5,2,1,15,0,2,2,0,0,4,19
MEGHALAYA,2005,Self-employed (Business activity),0,2,1,0,0,3,0,0,0,0,0,0,3
MEGHALAYA,2005,Professional Activity,0,0,0,0,0,0,0,0,0,0,0,0,0
MEGHALAYA,2005,Farming/Agriculture Activity,0,1,2,0,1,4,0,0,0,0,0,0,4
MEGHALAYA,2005,Others (Please Specify),0,1,3,5,1,10,0,0,0,0,0,0,10
MEGHALAYA,2005,Retired Person,0,0,0,1,4,5,0,0,0,0,0,0,5
MEGHALAYA,2005,Others (Please Specify),0,2,0,0,0,2,0,0,0,0,1,1,3
MEGHALAYA,2005,Total,3,16,14,10,7,50,0,13,5,2,1,21,71
MEGHALAYA,2005,Total Salaried,0,0,3,2,0,5,0,0,0,0,0,0,5
MEGHALAYA,2005,Total Self-employed,0,4,6,5,2,17,0,0,0,0,0,0,17
MIZORAM,2005,House Wife,0,0,0,0,0,0,0,0,2,1,0,3,3
MIZORAM,2005,Service (Government),0,1,3,0,0,4,0,0,0,0,0,0,4
MIZORAM,2005,Service (Private),0,0,1,0,0,1,0,0,0,0,0,0,1
MIZORAM,2005,Public Sector Undertaking,0,0,0,0,0,0,0,0,0,0,0,0,0
MIZORAM,2005,Student,0,0,0,0,0,0,0,0,0,0,0,0,0
MIZORAM,2005,Unemployed,0,8,5,0,0,13,0,1,1,0,0,2,15
MIZORAM,2005,Self-employed (Business activity),0,0,0,0,0,0,0,0,0,0,0,0,0
MIZORAM,2005,Professional Activity,0,0,0,0,0,0,0,0,0,0,0,0,0
MIZORAM,2005,Farming/Agriculture Activity,0,0,0,0,0,0,0,0,0,0,0,0,0
MIZORAM,2005,Others (Please Specify),0,0,3,0,0,3,0,0,1,0,0,1,4
MIZORAM,2005,Retired Person,0,0,0,0,0,0,0,0,0,0,0,0,0
MIZORAM,2005,Others (Please Specify),2,10,8,4,2,26,0,2,0,0,0,2,28
MIZORAM,2005,Total,2,19,20,4,2,47,0,3,4,1,0,8,55
MIZORAM,2005,Total Salaried,0,1,4,0,0,5,0,0,0,0,0,0,5
MIZORAM,2005,Total Self-employed,0,0,3,0,0,3,0,0,1,0,0,1,4
NAGALAND,2005,House Wife,0,0,0,0,0,0,0,0,1,0,0,1,1
NAGALAND,2005,Service (Government),0,0,7,2,0,9,0,0,1,0,0,1,10
NAGALAND,2005,Service (Private),0,0,0,0,0,0,0,0,0,0,0,0,0
NAGALAND,2005,Public Sector Undertaking,0,0,0,0,0,0,0,0,0,0,0,0,0
NAGALAND,2005,Student,0,3,0,0,0,3,0,2,0,0,0,2,5
NAGALAND,2005,Unemployed,0,0,1,0,0,1,0,0,0,0,0,0,1
NAGALAND,2005,Self-employed (Business activity),0,0,1,0,0,1,0,0,0,0,0,0,1
NAGALAND,2005,Professional Activity,0,0,1,0,0,1,0,0,0,0,0,0,1
NAGALAND,2005,Farming/Agriculture Activity,0,0,0,0,0,0,0,0,0,0,0,0,0
NAGALAND,2005,Others (Please Specify),0,1,3,2,0,6,0,1,1,0,0,2,8
NAGALAND,2005,Retired Person,0,0,0,0,0,0,0,0,0,0,0,0,0
NAGALAND,2005,Others (Please Specify),0,0,0,0,0,0,0,0,0,0,0,0,0
NAGALAND,2005,Total,0,4,13,4,0,21,0,3,3,0,0,6,27
NAGALAND,2005,Total Salaried,0,0,7,2,0,9,0,0,1,0,0,1,10
NAGALAND,2005,Total Self-employed,0,1,5,2,0,8,0,1,1,0,0,2,10
ODISHA,2005,House Wife,0,0,0,0,0,0,0,247,237,89,14,587,587
ODISHA,2005,Service (Government),0,16,26,12,0,54,0,7,18,1,0,26,80
ODISHA,2005,Service (Private),0,31,25,31,1,88,0,33,32,20,3,88,176
ODISHA,2005,Public Sector Undertaking,0,29,34,25,1,89,0,7,8,8,0,23,112
ODISHA,2005,Student,28,111,10,0,0,149,26,85,2,0,0,113,262
ODISHA,2005,Unemployed,0,101,136,35,6,278,2,44,49,9,6,110,388
ODISHA,2005,Self-employed (Business activity),0,59,167,73,21,320,0,20,9,11,2,42,362
ODISHA,2005,Professional Activity,0,19,27,32,2,80,0,8,8,7,2,25,105
ODISHA,2005,Farming/Agriculture Activity,0,38,86,61,19,204,0,13,22,15,0,50,254
ODISHA,2005,Others (Please Specify),26,182,283,247,154,892,13,140,107,69,35,364,1256
ODISHA,2005,Retired Person,0,0,0,0,10,10,0,0,0,0,2,2,12
ODISHA,2005,Others (Please Specify),4,140,125,102,19,390,19,82,80,34,9,224,614
ODISHA,2005,Total,58,726,919,618,233,2554,60,686,572,263,73,1654,4208
ODISHA,2005,Total Salaried,0,76,85,68,2,231,0,47,58,29,3,137,368
ODISHA,2005,Total Self-employed,26,298,563,413,196,1496,13,181,146,102,39,481,1977
PUNJAB,2005,House Wife,0,0,0,0,0,0,0,33,28,15,1,77,77
PUNJAB,2005,Service (Government),0,2,6,6,1,15,0,1,0,0,0,1,16
PUNJAB,2005,Service (Private),0,19,16,0,0,35,0,0,0,0,0,0,35
PUNJAB,2005,Public Sector Undertaking,0,0,2,0,0,2,0,0,0,0,0,0,2
PUNJAB,2005,Student,0,16,0,1,0,17,0,4,0,0,0,4,21
PUNJAB,2005,Unemployed,0,25,13,8,1,47,1,1,3,0,0,5,52
PUNJAB,2005,Self-employed (Business activity),0,14,24,17,3,58,0,2,2,1,0,5,63
PUNJAB,2005,Professional Activity,0,4,4,5,1,14,0,0,0,0,0,0,14
PUNJAB,2005,Farming/Agriculture Activity,0,24,0,17,6,47,0,0,0,0,0,0,47
PUNJAB,2005,Others (Please Specify),0,55,55,28,10,148,0,1,2,0,0,3,151
PUNJAB,2005,Retired Person,0,0,0,3,5,8,0,0,0,0,0,0,8
PUNJAB,2005,Others (Please Specify),0,5,47,27,12,91,1,0,5,4,1,11,102
PUNJAB,2005,Total,0,164,167,112,39,482,2,42,40,20,2,106,588
PUNJAB,2005,Total Salaried,0,21,24,6,1,52,0,1,0,0,0,1,53
PUNJAB,2005,Total Self-employed,0,97,83,67,20,267,0,3,4,1,0,8,275
RAJASTHAN,2005,House Wife,0,0,0,0,0,0,13,459,408,201,19,1100,1100
RAJASTHAN,2005,Service (Government),0,9,19,10,0,38,0,0,0,0,0,0,38
RAJASTHAN,2005,Service (Private),0,108,107,58,2,275,0,8,3,0,0,11,286
RAJASTHAN,2005,Public Sector Undertaking,0,15,9,6,0,30,0,2,2,0,0,4,34
RAJASTHAN,2005,Student,19,56,0,0,0,75,13,22,2,0,0,37,112
RAJASTHAN,2005,Unemployed,3,57,32,6,2,100,0,2,0,0,0,2,102
RAJASTHAN,2005,Self-employed (Business activity),0,46,51,20,3,120,0,0,0,0,0,0,120
RAJASTHAN,2005,Professional Activity,0,12,13,2,0,27,0,0,0,0,0,0,27
RAJASTHAN,2005,Farming/Agriculture Activity,11,138,210,65,12,436,0,6,14,5,0,25,461
RAJASTHAN,2005,Others (Please Specify),17,199,215,90,17,538,6,28,10,4,1,49,587
RAJASTHAN,2005,Retired Person,0,0,0,2,2,4,0,0,0,0,0,0,4
RAJASTHAN,2005,Others (Please Specify),38,292,469,317,99,1215,18,47,24,2,1,92,1307
RAJASTHAN,2005,Total,88,932,1125,576,137,2858,50,574,463,212,21,1320,4178
RAJASTHAN,2005,Total Salaried,0,132,135,74,2,343,0,10,5,0,0,15,358
RAJASTHAN,2005,Total Self-employed,28,395,489,177,32,1121,6,34,24,9,1,74,1195
SIKKIM,2005,House Wife,0,0,0,0,0,0,0,10,7,1,2,20,20
SIKKIM,2005,Service (Government),0,0,2,0,0,2,0,0,0,0,0,0,2
SIKKIM,2005,Service (Private),0,2,0,0,0,2,0,0,3,0,0,3,5
SIKKIM,2005,Public Sector Undertaking,0,0,0,0,0,0,0,0,0,0,0,0,0
SIKKIM,2005,Student,2,2,1,0,0,5,2,3,0,0,0,5,10
SIKKIM,2005,Unemployed,0,2,2,0,0,4,0,0,0,0,0,0,4
SIKKIM,2005,Self-employed (Business activity),0,0,0,0,0,0,0,0,1,0,0,1,1
SIKKIM,2005,Professional Activity,0,0,0,0,0,0,0,0,0,0,0,0,0
SIKKIM,2005,Farming/Agriculture Activity,0,15,7,8,4,34,0,1,3,3,0,7,41
SIKKIM,2005,Others (Please Specify),0,3,5,3,0,11,0,0,2,1,3,6,17
SIKKIM,2005,Retired Person,0,0,0,0,0,0,0,0,0,0,0,0,0
SIKKIM,2005,Others (Please Specify),0,2,0,2,0,4,0,0,3,2,0,5,9
SIKKIM,2005,Total,2,26,17,13,4,62,2,14,19,7,5,47,109
SIKKIM,2005,Total Salaried,0,2,2,0,0,4,0,0,3,0,0,3,7
SIKKIM,2005,Total Self-employed,0,18,12,11,4,45,0,1,6,4,3,14,59
TAMIL NADU,2005,House Wife,0,0,0,0,0,0,0,647,737,493,181,2058,2058
TAMIL NADU,2005,Service (Government),0,35,63,58,3,159,0,5,16,11,0,32,191
TAMIL NADU,2005,Service (Private),0,259,357,280,51,947,3,115,93,33,5,249,1196
TAMIL NADU,2005,Public Sector Undertaking,0,48,88,59,10,205,0,14,30,23,8,75,280
TAMIL NADU,2005,Student,73,173,15,0,0,261,59,203,7,1,0,270,531
TAMIL NADU,2005,Unemployed,7,390,426,267,84,1174,5,249,141,76,40,511,1685
TAMIL NADU,2005,Self-employed (Business activity),0,195,301,243,54,793,0,42,28,37,18,125,918
TAMIL NADU,2005,Professional Activity,0,72,93,73,8,246,0,21,13,4,2,40,286
TAMIL NADU,2005,Farming/Agriculture Activity,11,217,369,263,142,1002,5,102,73,40,33,253,1255
TAMIL NADU,2005,Others (Please Specify),4,351,524,368,183,1430,6,193,126,120,36,481,1911
TAMIL NADU,2005,Retired Person,0,0,0,10,84,94,0,0,0,0,8,8,102
TAMIL NADU,2005,Others (Please Specify),52,226,471,346,101,1196,94,144,101,85,43,467,1663
TAMIL NADU,2005,Total,147,1966,2707,1967,720,7507,172,1735,1365,923,374,4569,12076
TAMIL NADU,2005,Total Salaried,0,342,508,397,64,1311,3,134,139,67,13,356,1667
TAMIL NADU,2005,Total Self-employed,15,835,1287,947,387,3471,11,358,240,201,89,899,4370
TRIPURA,2005,House Wife,0,0,0,0,0,0,0,47,38,15,4,104,104
TRIPURA,2005,Service (Government),0,3,13,7,0,23,0,5,3,2,0,10,33
TRIPURA,2005,Service (Private),0,8,15,11,0,34,0,6,5,3,0,14,48
TRIPURA,2005,Public Sector Undertaking,0,8,9,5,0,22,0,3,4,5,0,12,34
TRIPURA,2005,Student,6,22,1,0,0,29,8,28,4,0,0,40,69
TRIPURA,2005,Unemployed,0,33,25,14,0,72,0,11,3,2,2,18,90
TRIPURA,2005,Self-employed (Business activity),0,34,19,3,6,62,0,0,0,0,0,0,62
TRIPURA,2005,Professional Activity,0,8,15,13,5,41,0,0,0,0,0,0,41
TRIPURA,2005,Farming/Agriculture Activity,0,14,6,6,3,29,0,0,0,0,0,0,29
TRIPURA,2005,Others (Please Specify),3,10,9,11,7,40,5,29,16,5,2,57,97
TRIPURA,2005,Retired Person,0,0,0,7,7,14,0,0,0,0,0,0,14
TRIPURA,2005,Others (Please Specify),1,9,15,6,4,35,3,45,5,6,0,59,94
TRIPURA,2005,Total,10,149,127,83,32,401,16,174,78,38,8,314,715
TRIPURA,2005,Total Salaried,0,19,37,23,0,79,0,14,12,10,0,36,115
TRIPURA,2005,Total Self-employed,3,66,49,33,21,172,5,29,16,5,2,57,229
UTTAR PRADESH,2005,House Wife,0,0,0,0,0,0,0,547,348,119,0,1014,1014
UTTAR PRADESH,2005,Service (Government),0,8,16,11,0,35,0,8,3,2,0,13,48
UTTAR PRADESH,2005,Service (Private),3,74,54,27,6,164,25,29,0,5,36,95,259
UTTAR PRADESH,2005,Public Sector Undertaking,0,18,32,22,0,72,0,23,18,11,0,52,124
UTTAR PRADESH,2005,Student,19,105,16,0,0,140,12,60,7,0,0,79,219
UTTAR PRADESH,2005,Unemployed,2,69,91,26,7,195,0,39,24,9,0,72,267
UTTAR PRADESH,2005,Self-employed (Business activity),2,68,76,42,32,220,2,1,5,0,0,8,228
UTTAR PRADESH,2005,Professional Activity,1,13,17,24,6,61,0,1,2,0,0,3,64
UTTAR PRADESH,2005,Farming/Agriculture Activity,3,108,164,103,44,422,1,41,27,15,16,100,522
UTTAR PRADESH,2005,Others (Please Specify),13,71,106,78,37,305,11,90,27,31,8,167,472
UTTAR PRADESH,2005,Retired Person,0,0,0,3,3,6,0,0,0,2,1,3,9
UTTAR PRADESH,2005,Others (Please Specify),15,33,41,33,30,152,8,25,12,14,12,71,223
UTTAR PRADESH,2005,Total,58,567,613,369,165,1772,59,864,473,208,73,1677,3449
UTTAR PRADESH,2005,Total Salaried,3,100,102,60,6,271,25,60,21,18,36,160,431
UTTAR PRADESH,2005,Total Self-employed,19,260,363,247,119,1008,14,133,61,46,24,278,1286
UTTARAKHAND,2005,House Wife,0,0,0,0,0,0,0,44,20,3,0,67,67
UTTARAKHAND,2005,Service (Government),0,2,3,2,0,7,0,0,0,0,0,0,7
UTTARAKHAND,2005,Service (Private),0,7,7,3,0,17,0,2,1,0,0,3,20
UTTARAKHAND,2005,Public Sector Undertaking,0,3,3,0,0,6,0,1,0,0,0,1,7
UTTARAKHAND,2005,Student,0,8,0,0,0,8,3,3,0,0,0,6,14
UTTARAKHAND,2005,Unemployed,0,19,18,6,0,43,0,0,1,0,0,1,44
UTTARAKHAND,2005,Self-employed (Business activity),0,7,16,2,1,26,0,0,0,0,0,0,26
UTTARAKHAND,2005,Professional Activity,0,2,4,4,0,10,0,0,0,0,0,0,10
UTTARAKHAND,2005,Farming/Agriculture Activity,0,4,4,5,2,15,0,3,3,3,0,9,24
UTTARAKHAND,2005,Others (Please Specify),0,8,8,4,0,20,0,1,0,1,0,2,22
UTTARAKHAND,2005,Retired Person,0,0,0,1,2,3,0,0,0,0,0,0,3
UTTARAKHAND,2005,Others (Please Specify),0,16,3,2,4,25,1,0,1,2,0,4,29
UTTARAKHAND,2005,Total,0,76,66,29,9,180,4,54,26,9,0,93,273
UTTARAKHAND,2005,Total Salaried,0,12,13,5,0,30,0,3,1,0,0,4,34
UTTARAKHAND,2005,Total Self-employed,0,21,32,15,3,71,0,4,3,4,0,11,82
WEST BENGAL,2005,House Wife,0,0,0,0,0,0,0,1834,1296,830,195,4155,4155
WEST BENGAL,2005,Service (Government),0,46,70,48,0,164,0,2,9,9,0,20,184
WEST BENGAL,2005,Service (Private),0,418,464,237,0,1119,0,94,104,47,0,245,1364
WEST BENGAL,2005,Public Sector Undertaking,0,97,222,152,0,471,0,32,12,2,0,46,517
WEST BENGAL,2005,Student,141,285,27,0,0,453,164,102,12,0,0,278,731
WEST BENGAL,2005,Unemployed,0,617,301,10,0,928,0,152,63,6,0,221,1149
WEST BENGAL,2005,Self-employed (Business activity),0,212,351,307,34,904,0,11,56,8,21,96,1000
WEST BENGAL,2005,Professional Activity,0,57,133,148,8,346,0,3,1,2,0,6,352
WEST BENGAL,2005,Farming/Agriculture Activity,0,233,293,282,45,853,0,12,60,30,10,112,965
WEST BENGAL,2005,Others (Please Specify),0,372,610,528,202,1712,4,193,86,133,42,458,2170
WEST BENGAL,2005,Retired Person,0,0,0,0,212,212,0,0,0,0,15,15,227
WEST BENGAL,2005,Others (Please Specify),73,625,430,296,28,1452,37,345,220,111,36,749,2201
WEST BENGAL,2005,Total,214,2962,2901,2008,529,8614,205,2780,1919,1178,319,6401,15015
WEST BENGAL,2005,Total Salaried,0,561,756,437,0,1754,0,128,125,58,0,311,2065
WEST BENGAL,2005,Total Self-employed,0,874,1387,1265,289,3815,4,219,203,173,73,672,4487
TOTAL (STATES),2005,House Wife,0,0,0,0,0,0,30,10468,7786,3907,1458,23649,23649
TOTAL (STATES),2005,Service (Government),0,290,592,489,5,1376,0,80,118,46,1,245,1621
TOTAL (STATES),2005,Service (Private),20,2399,2876,1691,186,7172,33,608,413,174,64,1292,8464
TOTAL (STATES),2005,Public Sector Undertaking,0,465,742,517,32,1756,0,149,147,70,8,374,2130
TOTAL (STATES),2005,Student,575,2085,151,3,0,2814,575,1531,77,1,0,2184,4998
TOTAL (STATES),2005,Unemployed,40,2956,2448,1036,342,6822,13,874,451,158,92,1588,8410
TOTAL (STATES),2005,Self-employed (Business activity),21,1452,2273,1554,367,5667,3,192,183,108,48,534,6201
TOTAL (STATES),2005,Professional Activity,17,626,979,705,151,2478,5,107,49,50,20,231,2709
TOTAL (STATES),2005,Farming/Agriculture Activity,54,3604,5600,3859,1685,14802,41,758,751,417,187,2154,16956
TOTAL (STATES),2005,Others (Please Specify),179,3899,5223,3686,1879,14866,145,1556,943,738,338,3720,18586
TOTAL (STATES),2005,Retired Person,0,16,10,163,624,813,0,4,4,15,71,94,907
TOTAL (STATES),2005,Others (Please Specify),405,3512,4586,3266,1249,13018,363,1643,1109,639,399,4153,17171
TOTAL (STATES),2005,Total,1311,21304,25480,16969,6520,71584,1208,17970,12031,6323,2686,40218,111802
TOTAL (STATES),2005,Total Salaried,20,3154,4210,2697,223,10304,33,837,678,290,73,1911,12215
TOTAL (STATES),2005,Total Self-employed,271,9581,14075,9804,4082,37813,194,2613,1926,1313,593,6639,44452
A & N ISLANDS,2005,House Wife,0,0,0,0,0,0,0,11,7,10,4,32,32
A & N ISLANDS,2005,Service (Government),0,1,5,7,0,13,0,0,0,0,0,0,13
A & N ISLANDS,2005,Service (Private),0,9,12,14,12,47,0,4,0,0,0,4,51
A & N ISLANDS,2005,Public Sector Undertaking,0,0,0,0,0,0,0,0,0,0,0,0,0
A & N ISLANDS,2005,Student,2,3,0,0,0,5,3,4,0,0,0,7,12
A & N ISLANDS,2005,Unemployed,0,1,1,1,0,3,0,8,0,0,1,9,12
A & N ISLANDS,2005,Self-employed (Business activity),3,1,0,0,1,5,0,0,0,0,0,0,5
A & N ISLANDS,2005,Professional Activity,0,0,0,0,0,0,0,0,0,0,0,0,0
A & N ISLANDS,2005,Farming/Agriculture Activity,0,0,2,1,4,7,0,0,1,0,0,1,8
A & N ISLANDS,2005,Others (Please Specify),0,0,4,2,0,6,0,0,0,0,0,0,6
A & N ISLANDS,2005,Retired Person,0,0,0,0,0,0,0,0,0,0,0,0,0
A & N ISLANDS,2005,Others (Please Specify),0,0,0,0,0,0,0,0,0,0,0,0,0
A & N ISLANDS,2005,Total,5,15,24,25,17,86,3,27,8,10,5,53,139
A & N ISLANDS,2005,Total Salaried,0,10,17,21,12,60,0,4,0,0,0,4,64
A & N ISLANDS,2005,Total Self-employed,3,1,6,3,5,18,0,0,1,0,0,1,19
CHANDIGARH,2005,House Wife,0,0,0,0,0,0,0,6,5,3,0,14,14
CHANDIGARH,2005,Service (Government),0,1,0,1,0,2,0,0,0,1,0,1,3
CHANDIGARH,2005,Service (Private),0,5,6,6,0,17,0,1,0,0,0,1,18
CHANDIGARH,2005,Public Sector Undertaking,0,0,5,0,0,5,0,0,0,0,0,0,5
CHANDIGARH,2005,Student,1,2,0,0,0,3,0,3,0,0,0,3,6
CHANDIGARH,2005,Unemployed,0,12,3,0,0,15,0,2,0,0,0,2,17
CHANDIGARH,2005,Self-employed (Business activity),0,8,2,1,0,11,0,0,0,0,0,0,11
CHANDIGARH,2005,Professional Activity,0,0,0,0,0,0,0,0,0,0,0,0,0
CHANDIGARH,2005,Farming/Agriculture Activity,0,0,0,0,0,0,0,0,0,0,0,0,0
CHANDIGARH,2005,Others (Please Specify),0,5,2,2,0,9,0,3,1,0,0,4,13
CHANDIGARH,2005,Retired Person,0,0,0,0,0,0,0,0,0,0,0,0,0
CHANDIGARH,2005,Others (Please Specify),1,0,0,0,0,1,1,0,0,0,0,1,2
CHANDIGARH,2005,Total,2,33,18,10,0,63,1,15,6,4,0,26,89
CHANDIGARH,2005,Total Salaried,0,6,11,7,0,24,0,1,0,1,0,2,26
CHANDIGARH,2005,Total Self-employed,0,13,4,3,0,20,0,3,1,0,0,4,24
D & N HAVELI,2005,House Wife,0,0,0,0,0,0,0,7,7,7,1,22,22
D & N HAVELI,2005,Service (Government),0,0,0,0,0,0,0,2,1,0,0,3,3
D & N HAVELI,2005,Service (Private),0,3,1,0,0,4,0,0,0,0,0,0,4
D & N HAVELI,2005,Public Sector Undertaking,0,0,0,0,0,0,0,0,0,0,0,0,0
D & N HAVELI,2005,Student,0,0,0,0,0,0,0,0,0,0,0,0,0
D & N HAVELI,2005,Unemployed,0,1,1,0,0,2,0,0,0,0,0,0,2
D & N HAVELI,2005,Self-employed (Business activity),0,0,0,0,0,0,0,0,0,0,0,0,0
D & N HAVELI,2005,Professional Activity,0,0,0,0,0,0,0,0,0,0,0,0,0
D & N HAVELI,2005,Farming/Agriculture Activity,0,3,6,4,0,13,0,0,0,0,0,0,13
D & N HAVELI,2005,Others (Please Specify),0,0,0,0,0,0,0,0,0,0,0,0,0
D & N HAVELI,2005,Retired Person,0,0,0,0,0,0,0,0,0,0,0,0,0
D & N HAVELI,2005,Others (Please Specify),0,9,5,2,6,22,0,3,0,0,0,3,25
D & N HAVELI,2005,Total,0,16,13,6,6,41,0,12,8,7,1,28,69
D & N HAVELI,2005,Total Salaried,0,3,1,0,0,4,0,2,1,0,0,3,7
D & N HAVELI,2005,Total Self-employed,0,3,6,4,0,13,0,0,0,0,0,0,13
DAMAN & DIU,2005,House Wife,0,0,0,0,0,0,0,2,2,0,0,4,4
DAMAN & DIU,2005,Service (Government),0,0,0,0,0,0,0,0,0,0,0,0,0
DAMAN & DIU,2005,Service (Private),0,6,1,1,0,8,0,0,0,0,0,0,8
DAMAN & DIU,2005,Public Sector Undertaking,0,0,0,1,0,1,0,0,0,0,0,0,1
DAMAN & DIU,2005,Student,1,0,0,0,0,1,0,0,0,0,0,0,1
DAMAN & DIU,2005,Unemployed,0,0,0,4,0,4,0,0,0,0,0,0,4
DAMAN & DIU,2005,Self-employed (Business activity),0,0,1,0,0,1,0,0,0,0,0,0,1
DAMAN & DIU,2005,Professional Activity,0,0,0,0,0,0,0,0,0,0,0,0,0
DAMAN & DIU,2005,Farming/Agriculture Activity,0,0,0,0,0,0,0,0,0,0,0,0,0
DAMAN & DIU,2005,Others (Please Specify),0,3,1,4,0,8,0,0,0,0,0,0,8
DAMAN & DIU,2005,Retired Person,0,0,0,0,0,0,0,0,0,0,0,0,0
DAMAN & DIU,2005,Others (Please Specify),0,1,1,0,0,2,0,3,0,0,0,3,5
DAMAN & DIU,2005,Total,1,10,4,10,0,25,0,5,2,0,0,7,32
DAMAN & DIU,2005,Total Salaried,0,6,1,2,0,9,0,0,0,0,0,0,9
DAMAN & DIU,2005,Total Self-employed,0,3,2,4,0,9,0,0,0,0,0,0,9
DELHI (UT),2005,House Wife,0,0,0,0,0,0,0,162,102,23,7,294,294
DELHI (UT),2005,Service (Government),0,7,18,11,0,36,0,3,0,1,0,4,40
DELHI (UT),2005,Service (Private),0,76,58,29,2,165,1,14,3,0,0,18,183
DELHI (UT),2005,Public Sector Undertaking,0,1,2,1,0,4,0,1,0,0,0,1,5
DELHI (UT),2005,Student,4,50,5,0,0,59,5,33,1,0,0,39,98
DELHI (UT),2005,Unemployed,1,109,69,24,6,209,2,25,5,0,0,32,241
DELHI (UT),2005,Self-employed (Business activity),0,7,8,0,1,16,0,0,0,0,0,0,16
DELHI (UT),2005,Professional Activity,0,0,1,3,1,5,0,1,0,0,0,1,6
DELHI (UT),2005,Farming/Agriculture Activity,0,1,5,1,0,7,0,0,0,0,0,0,7
DELHI (UT),2005,Others (Please Specify),0,54,44,17,7,122,0,11,12,1,0,24,146
DELHI (UT),2005,Retired Person,0,0,0,0,3,3,0,0,0,0,0,0,3
DELHI (UT),2005,Others (Please Specify),3,65,54,25,4,151,5,31,17,1,1,55,206
DELHI (UT),2005,Total,8,370,264,111,24,777,13,281,140,26,8,468,1245
DELHI (UT),2005,Total Salaried,0,84,78,41,2,205,1,18,3,1,0,23,228
DELHI (UT),2005,Total Self-employed,0,62,58,21,9,150,0,12,12,1,0,25,175
LAKSHADWEEP,2005,House Wife,0,0,0,0,0,0,0,0,0,0,0,0,0
LAKSHADWEEP,2005,Service (Government),0,0,0,0,0,0,0,0,0,0,0,0,0
LAKSHADWEEP,2005,Service (Private),0,0,0,0,0,0,0,0,0,0,0,0,0
LAKSHADWEEP,2005,Public Sector Undertaking,0,0,0,0,0,0,0,0,0,0,0,0,0
LAKSHADWEEP,2005,Student,0,0,0,0,0,0,0,0,0,0,0,0,0
LAKSHADWEEP,2005,Unemployed,0,0,0,0,0,0,0,0,0,0,0,0,0
LAKSHADWEEP,2005,Self-employed (Business activity),0,0,0,0,0,0,0,0,0,0,0,0,0
LAKSHADWEEP,2005,Professional Activity,0,0,0,0,0,0,0,0,0,0,0,0,0
LAKSHADWEEP,2005,Farming/Agriculture Activity,0,0,0,0,0,0,0,0,0,0,0,0,0
LAKSHADWEEP,2005,Others (Please Specify),0,0,0,0,0,0,0,0,0,0,0,0,0
LAKSHADWEEP,2005,Retired Person,0,0,0,0,0,0,0,0,0,0,0,0,0
LAKSHADWEEP,2005,Others (Please Specify),0,0,0,0,0,0,0,0,0,0,0,0,0
LAKSHADWEEP,2005,Total,0,0,0,0,0,0,0,0,0,0,0,0,0
LAKSHADWEEP,2005,Total Salaried,0,0,0,0,0,0,0,0,0,0,0,0,0
LAKSHADWEEP,2005,Total Self-employed,0,0,0,0,0,0,0,0,0,0,0,0,0
PUDUCHERRY,2005,House Wife,0,0,0,0,0,0,0,48,51,18,9,126,126
PUDUCHERRY,2005,Service (Government),0,1,5,6,0,12,0,0,0,1,0,1,13
PUDUCHERRY,2005,Service (Private),0,16,33,25,1,75,0,10,1,0,0,11,86
PUDUCHERRY,2005,Public Sector Undertaking,0,0,1,0,1,2,0,0,0,0,0,0,2
PUDUCHERRY,2005,Student,1,5,1,0,0,7,2,14,0,0,0,16,23
PUDUCHERRY,2005,Unemployed,0,22,12,21,16,71,0,28,2,0,11,41,112
PUDUCHERRY,2005,Self-employed (Business activity),0,2,5,1,2,10,0,0,0,0,0,0,10
PUDUCHERRY,2005,Professional Activity,0,1,5,2,0,8,0,0,0,0,0,0,8
PUDUCHERRY,2005,Farming/Agriculture Activity,0,28,65,45,6,144,0,1,2,0,0,3,147
PUDUCHERRY,2005,Others (Please Specify),0,0,0,0,0,0,0,0,0,0,0,0,0
PUDUCHERRY,2005,Retired Person,0,0,0,1,3,4,0,0,0,0,0,0,4
PUDUCHERRY,2005,Others (Please Specify),0,0,2,4,1,7,0,0,0,0,0,0,7
PUDUCHERRY,2005,Total,1,75,129,105,30,340,2,101,56,19,20,198,538
PUDUCHERRY,2005,Total Salaried,0,17,39,31,2,89,0,10,1,1,0,12,101
PUDUCHERRY,2005,Total Self-employed,0,31,75,48,8,162,0,1,2,0,0,3,165
TOTAL (UTs),2005,House Wife,0,0,0,0,0,0,0,236,174,61,21,492,492
TOTAL (UTs),2005,Service (Government),0,10,28,25,0,63,0,5,1,3,0,9,72
TOTAL (UTs),2005,Service (Private),0,115,111,75,15,316,1,29,4,0,0,34,350
TOTAL (UTs),2005,Public Sector Undertaking,0,1,8,2,1,12,0,1,0,0,0,1,13
TOTAL (UTs),2005,Student,9,60,6,0,0,75,10,54,1,0,0,65,140
TOTAL (UTs),2005,Unemployed,1,145,86,50,22,304,2,63,7,0,12,84,388
TOTAL (UTs),2005,Self-employed (Business activity),3,18,16,2,4,43,0,0,0,0,0,0,43
TOTAL (UTs),2005,Professional Activity,0,1,6,5,1,13,0,1,0,0,0,1,14
TOTAL (UTs),2005,Farming/Agriculture Activity,0,32,78,51,10,171,0,1,3,0,0,4,175
TOTAL (UTs),2005,Others (Please Specify),0,62,51,25,7,145,0,14,13,1,0,28,173
TOTAL (UTs),2005,Retired Person,0,0,0,1,6,7,0,0,0,0,0,0,7
TOTAL (UTs),2005,Others (Please Specify),4,75,62,31,11,183,6,37,17,1,1,62,245
TOTAL (UTs),2005,Total,17,519,452,267,77,1332,19,441,220,66,34,780,2112
TOTAL (UTs),2005,Total Salaried,0,126,147,102,16,391,1,35,5,3,0,44,435
TOTAL (UTs),2005,Total Self-employed,3,113,151,83,22,372,0,16,16,1,0,33,405
TOTAL (ALL INDIA),2005,House Wife,0,0,0,0,0,0,30,10704,7960,3968,1479,24141,24141
TOTAL (ALL INDIA),2005,Service (Government),0,300,620,514,5,1439,0,85,119,49,1,254,1693
TOTAL (ALL INDIA),2005,Service (Private),20,2514,2987,1766,201,7488,34,637,417,174,64,1326,8814
TOTAL (ALL INDIA),2005,Public Sector Undertaking,0,466,750,519,33,1768,0,150,147,70,8,375,2143
TOTAL (ALL INDIA),2005,Student,584,2145,157,3,0,2889,585,1585,78,1,0,2249,5138
TOTAL (ALL INDIA),2005,Unemployed,41,3101,2534,1086,364,7126,15,937,458,158,104,1672,8798
TOTAL (ALL INDIA),2005,Self-employed (Business activity),24,1470,2289,1556,371,5710,3,192,183,108,48,534,6244
TOTAL (ALL INDIA),2005,Professional Activity,17,627,985,710,152,2491,5,108,49,50,20,232,2723
TOTAL (ALL INDIA),2005,Farming/Agriculture Activity,54,3636,5678,3910,1695,14973,41,759,754,417,187,2158,17131
TOTAL (ALL INDIA),2005,Others (Please Specify),179,3961,5274,3711,1886,15011,145,1570,956,739,338,3748,18759
TOTAL (ALL INDIA),2005,Retired Person,0,16,10,164,630,820,0,4,4,15,71,94,914
TOTAL (ALL INDIA),2005,Others (Please Specify),409,3587,4648,3297,1260,13201,369,1680,1126,640,400,4215,17416
TOTAL (ALL INDIA),2005,Total,1328,21823,25932,17236,6597,72916,1227,18411,12251,6389,2720,40998,113914
TOTAL (ALL INDIA),2005,Total Salaried,20,3280,4357,2799,239,10695,34,872,683,293,73,1955,12650
TOTAL (ALL INDIA),2005,Total Self-employed,274,9694,14226,9887,4104,38185,194,2629,1942,1314,593,6672,44857
