STATE/UT,Year,CAUSE,Male upto 14 years,Male 15-29 years,Male 30-44 years,Male 45-59 years,Male 60 years and above,Total Male,Female upto 14 years,Female 15-29 years,Female 30-44 years,Female 45-59 years,Female 60 years and above,Total Female,Grand Total
ANDHRA PRADESH,2006,House Wife,0,0,0,0,0,0,2,994,750,303,107,2156,2156
ANDHRA PRADESH,2006,Service (Government),4,51,84,44,0,183,0,19,26,3,0,48,231
ANDHRA PRADESH,2006,Service (Private),0,157,240,159,20,576,0,30,35,6,0,71,647
ANDHRA PRADESH,2006,Public Sector Undertaking,0,67,69,48,6,190,0,1,10,3,0,14,204
ANDHRA PRADESH,2006,Student,55,216,12,4,0,287,53,168,4,0,0,225,512
ANDHRA PRADESH,2006,Unemployed,0,169,132,70,0,371,0,34,24,0,0,58,429
ANDHRA PRADESH,2006,Self-employed (Business activity),0,263,305,214,60,842,0,15,12,21,4,52,894
ANDHRA PRADESH,2006,Professional Activity,0,66,240,197,49,552,1,12,8,0,1,22,574
ANDHRA PRADESH,2006,Farming/Agriculture Activity,15,505,777,489,214,2000,14,241,210,115,27,607,2607
ANDHRA PRADESH,2006,Others (Please Specify),46,505,651,430,191,1823,71,269,145,83,110,678,2501
ANDHRA PRADESH,2006,Retired Person,0,1,3,9,38,51,0,0,5,0,1,6,57
ANDHRA PRADESH,2006,Others (Please Specify),49,696,765,368,110,1988,54,204,128,49,41,476,2464
ANDHRA PRADESH,2006,Total,169,2696,3278,2032,688,8863,195,1987,1357,583,291,4413,13276
ANDHRA PRADESH,2006,Total Salaried,4,275,393,251,26,949,0,50,71,12,0,133,1082
ANDHRA PRADESH,2006,Total Self-employed,61,1339,1973,1330,514,5217,86,537,375,219,142,1359,6576
ARUNACHAL PRADESH,2006,House Wife,0,0,0,0,0,0,0,7,11,3,0,21,21
ARUNACHAL PRADESH,2006,Service (Government),0,2,9,7,0,18,0,0,1,0,0,1,19
ARUNACHAL PRADESH,2006,Service (Private),0,11,12,4,1,28,0,0,0,0,0,0,28
ARUNACHAL PRADESH,2006,Public Sector Undertaking,0,0,0,0,0,0,0,0,0,0,0,0,0
ARUNACHAL PRADESH,2006,Student,1,1,0,0,0,2,2,6,0,0,0,8,10
ARUNACHAL PRADESH,2006,Unemployed,0,3,5,1,0,9,0,0,0,0,0,0,9
ARUNACHAL PRADESH,2006,Self-employed (Business activity),0,2,2,1,0,5,0,0,0,0,0,0,5
ARUNACHAL PRADESH,2006,Professional Activity,0,0,0,0,0,0,0,0,0,0,0,0,0
ARUNACHAL PRADESH,2006,Farming/Agriculture Activity,0,1,2,1,0,4,0,0,0,0,0,0,4
ARUNACHAL PRADESH,2006,Others (Please Specify),0,8,12,3,0,23,1,2,0,0,0,3,26
ARUNACHAL PRADESH,2006,Retired Person,0,0,0,0,0,0,0,0,0,0,0,0,0
ARUNACHAL PRADESH,2006,Others (Please Specify),0,0,3,4,0,7,0,0,0,0,0,0,7
ARUNACHAL PRADESH,2006,Total,1,28,45,21,1,96,3,15,12,3,0,33,129
ARUNACHAL PRADESH,2006,Total Salaried,0,13,21,11,1,46,0,0,1,0,0,1,47
ARUNACHAL PRADESH,2006,Total Self-employed,0,11,16,5,0,32,1,2,0,0,0,3,35
ASSAM,2006,House Wife,0,0,0,0,0,0,0,258,247,68,6,579,579
ASSAM,2006,Service (Government),0,6,6,5,0,17,0,0,0,0,0,0,17
ASSAM,2006,Service (Private),0,14,19,5,0,38,0,4,3,1,0,8,46
ASSAM,2006,Public Sector Undertaking,0,18,10,11,0,39,0,9,5,0,0,14,53
ASSAM,2006,Student,27,127,3,0,0,157,19,32,2,0,0,53,210
ASSAM,2006,Unemployed,0,0,15,24,2,41,0,0,0,0,0,0,41
ASSAM,2006,Self-employed (Business activity),0,148,199,118,1,466,0,28,13,6,0,47,513
ASSAM,2006,Professional Activity,1,26,82,29,0,138,0,0,0,0,0,0,138
ASSAM,2006,Farming/Agriculture Activity,0,82,139,54,20,295,2,2,13,10,0,27,322
ASSAM,2006,Others (Please Specify),9,261,310,106,23,709,4,27,35,14,8,88,797
ASSAM,2006,Retired Person,0,2,1,2,5,10,0,0,0,0,0,0,10
ASSAM,2006,Others (Please Specify),7,69,69,31,30,206,7,53,30,8,1,99,305
ASSAM,2006,Total,44,753,853,385,81,2116,32,413,348,107,15,915,3031
ASSAM,2006,Total Salaried,0,38,35,21,0,94,0,13,8,1,0,22,116
ASSAM,2006,Total Self-employed,10,517,730,307,44,1608,6,57,61,30,8,162,1770
BIHAR,2006,House Wife,0,0,0,0,0,0,0,56,68,12,1,137,137
BIHAR,2006,Service (Government),0,1,3,2,0,6,0,1,3,0,0,4,10
BIHAR,2006,Service (Private),0,5,9,1,0,15,0,0,0,1,0,1,16
BIHAR,2006,Public Sector Undertaking,0,1,1,0,0,2,0,0,5,0,0,5,7
BIHAR,2006,Student,10,30,3,0,0,43,8,14,5,0,0,27,70
BIHAR,2006,Unemployed,0,8,9,0,1,18,1,4,2,1,0,8,26
BIHAR,2006,Self-employed (Business activity),0,7,8,1,0,16,0,1,7,0,0,8,24
BIHAR,2006,Professional Activity,0,1,2,0,0,3,0,0,0,1,0,1,4
BIHAR,2006,Farming/Agriculture Activity,0,13,21,2,2,38,0,4,4,0,0,8,46
BIHAR,2006,Others (Please Specify),0,13,15,13,1,42,1,13,16,3,0,33,75
BIHAR,2006,Retired Person,0,0,0,0,1,1,0,0,0,0,1,1,2
BIHAR,2006,Others (Please Specify),18,44,31,16,6,115,14,30,19,20,3,86,201
BIHAR,2006,Total,28,123,102,35,11,299,24,123,129,38,5,319,618
BIHAR,2006,Total Salaried,0,7,13,3,0,23,0,1,8,1,0,10,33
BIHAR,2006,Total Self-employed,0,34,46,16,3,99,1,18,27,4,0,50,149
CHHATTISGARH,2006,House Wife,0,0,0,0,0,0,3,393,248,83,45,772,772
CHHATTISGARH,2006,Service (Government),0,6,13,11,1,31,0,1,2,1,0,4,35
CHHATTISGARH,2006,Service (Private),0,24,60,43,0,127,0,4,5,0,0,9,136
CHHATTISGARH,2006,Public Sector Undertaking,0,0,14,2,0,16,0,0,1,0,0,1,17
CHHATTISGARH,2006,Student,23,84,0,0,0,107,16,69,0,0,0,85,192
CHHATTISGARH,2006,Unemployed,0,93,41,10,0,144,1,5,1,1,0,8,152
CHHATTISGARH,2006,Self-employed (Business activity),0,29,63,17,4,113,0,12,2,8,0,22,135
CHHATTISGARH,2006,Professional Activity,1,25,38,13,6,83,0,0,0,0,0,0,83
CHHATTISGARH,2006,Farming/Agriculture Activity,6,377,481,245,103,1212,20,115,83,41,12,271,1483
CHHATTISGARH,2006,Others (Please Specify),24,179,178,105,21,507,17,84,28,23,4,156,663
CHHATTISGARH,2006,Retired Person,0,0,0,0,1,1,0,0,0,0,0,0,1
CHHATTISGARH,2006,Others (Please Specify),58,250,197,144,70,719,39,92,58,31,18,238,957
CHHATTISGARH,2006,Total,112,1067,1085,590,206,3060,96,775,428,188,79,1566,4626
CHHATTISGARH,2006,Total Salaried,0,30,87,56,1,174,0,5,8,1,0,14,188
CHHATTISGARH,2006,Total Self-employed,31,610,760,380,134,1915,37,211,113,72,16,449,2364
GOA,2006,House Wife,0,0,0,0,0,0,0,12,16,13,10,51,51
GOA,2006,Service (Government),0,2,1,0,0,3,0,0,0,0,0,0,3
GOA,2006,Service (Private),0,20,18,11,0,49,0,3,1,0,0,4,53
GOA,2006,Public Sector Undertaking,0,0,0,0,0,0,0,0,0,0,0,0,0
GOA,2006,Student,1,7,0,0,0,8,4,8,0,0,0,12,20
GOA,2006,Unemployed,0,19,22,8,2,51,0,10,2,0,0,12,63
GOA,2006,Self-employed (Business activity),0,2,2,5,0,9,0,0,0,0,0,0,9
GOA,2006,Professional Activity,0,0,0,0,0,0,0,0,0,0,0,0,0
GOA,2006,Farming/Agriculture Activity,0,0,5,0,0,5,0,0,0,0,0,0,5
GOA,2006,Others (Please Specify),0,1,5,4,3,13,0,1,0,0,0,1,14
GOA,2006,Retired Person,0,0,0,2,6,8,0,0,0,0,0,0,8
GOA,2006,Others (Please Specify),0,9,16,10,2,37,2,6,3,0,1,12,49
GOA,2006,Total,1,60,69,40,13,183,6,40,22,13,11,92,275
GOA,2006,Total Salaried,0,22,19,11,0,52,0,3,1,0,0,4,56
GOA,2006,Total Self-employed,0,3,12,9,3,27,0,1,0,0,0,1,28
GUJARAT,2006,House Wife,0,0,0,0,0,0,0,651,469,219,57,1396,1396
GUJARAT,2006,Service (Government),0,8,22,14,1,45,0,5,3,1,0,9,54
GUJARAT,2006,Service (Private),0,141,215,102,3,461,0,37,25,8,0,70,531
GUJARAT,2006,Public Sector Undertaking,0,13,17,10,1,41,0,10,4,1,0,15,56
GUJARAT,2006,Student,24,100,13,0,0,137,17,85,1,0,0,103,240
GUJARAT,2006,Unemployed,0,162,154,86,8,410,0,19,22,5,0,46,456
GUJARAT,2006,Self-employed (Business activity),0,73,108,68,8,257,0,1,5,0,0,6,263
GUJARAT,2006,Professional Activity,0,126,141,87,16,370,2,10,12,5,0,29,399
GUJARAT,2006,Farming/Agriculture Activity,0,101,175,116,19,411,3,24,29,14,6,76,487
GUJARAT,2006,Others (Please Specify),2,165,176,110,24,477,3,48,23,9,3,86,563
GUJARAT,2006,Retired Person,0,2,1,24,86,113,0,0,0,7,50,57,170
GUJARAT,2006,Others (Please Specify),4,95,112,77,38,326,3,35,21,29,6,94,420
GUJARAT,2006,Total,30,986,1134,694,204,3048,28,925,614,298,122,1987,5035
GUJARAT,2006,Total Salaried,0,162,254,126,5,547,0,52,32,10,0,94,641
GUJARAT,2006,Total Self-employed,2,465,600,381,67,1515,8,83,69,28,9,197,1712
HARYANA,2006,House Wife,0,0,0,0,0,0,2,152,110,40,15,319,319
HARYANA,2006,Service (Government),0,13,28,8,0,49,0,5,5,0,0,10,59
HARYANA,2006,Service (Private),0,129,127,58,7,321,0,12,23,15,4,54,375
HARYANA,2006,Public Sector Undertaking,0,14,50,14,0,78,0,16,5,0,0,21,99
HARYANA,2006,Student,8,75,3,0,0,86,10,30,0,0,0,40,126
HARYANA,2006,Unemployed,1,81,105,51,5,243,0,5,7,2,1,15,258
HARYANA,2006,Self-employed (Business activity),0,17,33,25,14,89,0,4,8,0,0,12,101
HARYANA,2006,Professional Activity,0,10,8,6,0,24,0,2,0,0,0,2,26
HARYANA,2006,Farming/Agriculture Activity,0,48,78,35,20,181,0,6,2,1,0,9,190
HARYANA,2006,Others (Please Specify),2,88,75,40,13,218,0,2,5,5,3,15,233
HARYANA,2006,Retired Person,1,20,18,10,5,54,0,1,0,0,0,1,55
HARYANA,2006,Others (Please Specify),13,115,176,91,28,423,9,17,12,8,6,52,475
HARYANA,2006,Total,25,610,701,338,92,1766,21,252,177,71,29,550,2316
HARYANA,2006,Total Salaried,0,156,205,80,7,448,0,33,33,15,4,85,533
HARYANA,2006,Total Self-employed,2,163,194,106,47,512,0,14,15,6,3,38,550
HIMACHAL PRADESH,2006,House Wife,0,0,0,0,0,0,0,31,22,21,4,78,78
HIMACHAL PRADESH,2006,Service (Government),0,7,8,6,0,21,0,0,0,1,0,1,22
HIMACHAL PRADESH,2006,Service (Private),0,12,19,15,1,47,0,6,1,3,0,10,57
HIMACHAL PRADESH,2006,Public Sector Undertaking,0,10,24,4,2,40,0,1,0,0,0,1,41
HIMACHAL PRADESH,2006,Student,4,14,2,0,0,20,1,18,1,0,0,20,40
HIMACHAL PRADESH,2006,Unemployed,0,10,13,8,1,32,0,0,0,0,0,0,32
HIMACHAL PRADESH,2006,Self-employed (Business activity),0,3,7,3,4,17,0,0,0,0,0,0,17
HIMACHAL PRADESH,2006,Professional Activity,0,0,3,1,0,4,0,0,0,0,0,0,4
HIMACHAL PRADESH,2006,Farming/Agriculture Activity,0,7,11,3,1,22,0,0,0,0,0,0,22
HIMACHAL PRADESH,2006,Others (Please Specify),0,2,0,0,0,2,0,0,0,0,0,0,2
HIMACHAL PRADESH,2006,Retired Person,0,0,0,0,1,1,0,0,0,0,0,0,1
HIMACHAL PRADESH,2006,Others (Please Specify),0,25,34,25,11,95,0,11,19,12,4,46,141
HIMACHAL PRADESH,2006,Total,4,90,121,65,21,301,1,67,43,37,8,156,457
HIMACHAL PRADESH,2006,Total Salaried,0,29,51,25,3,108,0,7,1,4,0,12,120
HIMACHAL PRADESH,2006,Total Self-employed,0,12,21,7,5,45,0,0,0,0,0,0,45
JAMMU & KASHMIR,2006,House Wife,0,0,0,0,0,0,0,20,20,2,0,42,42
JAMMU & KASHMIR,2006,Service (Government),0,11,9,4,0,24,0,2,1,0,0,3,27
JAMMU & KASHMIR,2006,Service (Private),0,2,2,3,1,8,0,2,1,1,0,4,12
JAMMU & KASHMIR,2006,Public Sector Undertaking,0,1,0,1,0,2,0,0,0,0,0,0,2
JAMMU & KASHMIR,2006,Student,0,7,0,0,0,7,0,15,0,0,0,15,22
JAMMU & KASHMIR,2006,Unemployed,0,15,11,0,0,26,0,6,1,1,0,8,34
JAMMU & KASHMIR,2006,Self-employed (Business activity),0,1,1,0,0,2,0,0,0,0,0,0,2
JAMMU & KASHMIR,2006,Professional Activity,0,0,0,0,0,0,0,5,0,0,0,5,5
JAMMU & KASHMIR,2006,Farming/Agriculture Activity,1,10,12,6,1,30,0,2,1,1,0,4,34
JAMMU & KASHMIR,2006,Others (Please Specify),0,6,6,7,1,20,0,8,5,4,0,17,37
JAMMU & KASHMIR,2006,Retired Person,0,0,0,0,2,2,0,0,0,0,0,0,2
JAMMU & KASHMIR,2006,Others (Please Specify),0,11,15,4,1,31,0,8,4,0,0,12,43
JAMMU & KASHMIR,2006,Total,1,64,56,25,6,152,0,68,33,9,0,110,262
JAMMU & KASHMIR,2006,Total Salaried,0,14,11,8,1,34,0,4,2,1,0,7,41
JAMMU & KASHMIR,2006,Total Self-employed,1,17,19,13,2,52,0,15,6,5,0,26,78
JHARKHAND,2006,House Wife,0,0,0,0,0,0,1,94,70,23,2,190,190
JHARKHAND,2006,Service (Government),0,5,5,10,0,20,0,0,6,0,0,6,26
JHARKHAND,2006,Service (Private),0,20,12,8,0,40,0,2,5,1,0,8,48
JHARKHAND,2006,Public Sector Undertaking,0,1,0,0,0,1,0,0,0,0,0,0,1
JHARKHAND,2006,Student,10,58,1,2,0,71,5,35,0,0,0,40,111
JHARKHAND,2006,Unemployed,0,31,37,12,1,81,1,6,7,0,0,14,95
JHARKHAND,2006,Self-employed (Business activity),0,12,4,2,0,18,0,1,0,1,0,2,20
JHARKHAND,2006,Professional Activity,0,5,24,5,0,34,0,0,0,0,0,0,34
JHARKHAND,2006,Farming/Agriculture Activity,0,19,53,30,1,103,0,0,0,0,0,0,103
JHARKHAND,2006,Others (Please Specify),4,21,18,7,3,53,2,2,0,0,0,4,57
JHARKHAND,2006,Retired Person,0,2,1,0,6,9,0,0,0,0,0,0,9
JHARKHAND,2006,Others (Please Specify),7,16,38,19,11,91,6,18,32,13,2,71,162
JHARKHAND,2006,Total,21,190,193,95,22,521,15,158,120,38,4,335,856
JHARKHAND,2006,Total Salaried,0,26,17,18,0,61,0,2,11,1,0,14,75
JHARKHAND,2006,Total Self-employed,4,57,99,44,4,208,2,3,0,1,0,6,214
KARNATAKA,2006,House Wife,0,0,0,0,0,0,0,697,649,369,136,1851,1851
KARNATAKA,2006,Service (Government),0,68,71,75,0,214,0,11,6,7,0,24,238
KARNATAKA,2006,Service (Private),2,285,362,343,46,1038,0,65,48,28,3,144,1182
KARNATAKA,2006,Public Sector Undertaking,0,47,41,43,5,136,0,16,9,8,1,34,170
KARNATAKA,2006,Student,25,173,15,14,3,230,38,174,5,0,0,217,447
KARNATAKA,2006,Unemployed,0,162,146,59,31,398,0,53,14,16,7,90,488
KARNATAKA,2006,Self-employed (Business activity),2,133,140,101,20,396,1,15,22,4,2,44,440
KARNATAKA,2006,Professional Activity,12,64,76,44,14,210,1,4,4,2,2,13,223
KARNATAKA,2006,Farming/Agriculture Activity,2,348,576,395,129,1450,5,90,97,56,22,270,1720
KARNATAKA,2006,Others (Please Specify),14,377,622,480,206,1699,6,145,109,72,29,361,2060
KARNATAKA,2006,Retired Person,0,0,1,6,21,28,0,0,0,0,1,1,29
KARNATAKA,2006,Others (Please Specify),94,650,790,465,250,2249,80,483,362,128,62,1115,3364
KARNATAKA,2006,Total,151,2307,2840,2025,725,8048,131,1753,1325,690,265,4164,12212
KARNATAKA,2006,Total Salaried,2,400,474,461,51,1388,0,92,63,43,4,202,1590
KARNATAKA,2006,Total Self-employed,30,922,1414,1020,369,3755,13,254,232,134,55,688,4443
KERALA,2006,House Wife,0,0,0,0,0,0,0,289,404,388,269,1350,1350
KERALA,2006,Service (Government),0,3,31,41,0,75,0,2,5,7,0,14,89
KERALA,2006,Service (Private),0,75,148,134,13,370,0,27,27,7,1,62,432
KERALA,2006,Public Sector Undertaking,0,3,29,22,4,58,0,4,7,7,2,20,78
KERALA,2006,Student,45,71,0,0,0,116,53,102,0,0,0,155,271
KERALA,2006,Unemployed,1,210,348,283,157,999,0,101,54,29,34,218,1217
KERALA,2006,Self-employed (Business activity),0,41,138,156,38,373,0,3,0,1,0,4,377
KERALA,2006,Professional Activity,0,43,82,69,16,210,0,8,7,5,0,20,230
KERALA,2006,Farming/Agriculture Activity,0,86,273,420,249,1028,0,9,26,37,24,96,1124
KERALA,2006,Others (Please Specify),5,389,685,710,524,2313,6,103,86,79,83,357,2670
KERALA,2006,Retired Person,0,0,8,38,65,111,0,0,0,5,12,17,128
KERALA,2006,Others (Please Specify),3,145,249,326,207,930,1,34,24,37,34,130,1060
KERALA,2006,Total,54,1066,1991,2199,1273,6583,60,682,640,602,459,2443,9026
KERALA,2006,Total Salaried,0,81,208,197,17,503,0,33,39,21,3,96,599
KERALA,2006,Total Self-employed,5,559,1178,1355,827,3924,6,123,119,122,107,477,4401
MADHYA PRADESH,2006,House Wife,0,0,0,0,0,0,13,1026,595,184,83,1901,1901
MADHYA PRADESH,2006,Service (Government),1,18,22,27,0,68,0,20,8,0,0,28,96
MADHYA PRADESH,2006,Service (Private),2,64,72,51,9,198,0,49,15,4,1,69,267
MADHYA PRADESH,2006,Public Sector Undertaking,2,37,45,17,4,105,2,14,4,4,0,24,129
MADHYA PRADESH,2006,Student,36,140,12,5,5,198,36,111,15,5,0,167,365
MADHYA PRADESH,2006,Unemployed,2,124,76,52,20,274,0,9,6,7,0,22,296
MADHYA PRADESH,2006,Self-employed (Business activity),3,46,84,46,20,199,0,6,2,0,0,8,207
MADHYA PRADESH,2006,Professional Activity,0,62,58,25,8,153,0,3,5,2,2,12,165
MADHYA PRADESH,2006,Farming/Agriculture Activity,20,349,448,241,120,1178,5,110,62,18,2,197,1375
MADHYA PRADESH,2006,Others (Please Specify),14,198,244,148,71,675,12,103,61,18,14,208,883
MADHYA PRADESH,2006,Retired Person,0,0,0,1,8,9,0,0,0,0,0,0,9
MADHYA PRADESH,2006,Others (Please Specify),16,129,166,101,34,446,15,108,117,43,13,296,742
MADHYA PRADESH,2006,Total,96,1167,1227,714,299,3503,83,1559,890,285,115,2932,6435
MADHYA PRADESH,2006,Total Salaried,5,119,139,95,13,371,2,83,27,8,1,121,492
MADHYA PRADESH,2006,Total Self-employed,37,655,834,460,219,2205,17,222,130,38,18,425,2630
MAHARASHTRA,2006,House Wife,0,0,0,0,0,0,1,1911,1067,409,265,3653,3653
MAHARASHTRA,2006,Service (Government),0,95,202,135,0,432,0,19,25,6,0,50,482
MAHARASHTRA,2006,Service (Private),0,400,536,271,34,1241,0,64,27,11,2,104,1345
MAHARASHTRA,2006,Public Sector Undertaking,0,37,78,40,5,160,0,5,6,1,0,12,172
MAHARASHTRA,2006,Student,54,389,1,0,0,444,70,368,0,0,0,438,882
MAHARASHTRA,2006,Unemployed,4,388,341,108,31,872,2,52,12,6,0,72,944
MAHARASHTRA,2006,Self-employed (Business activity),0,148,203,98,23,472,0,8,10,0,1,19,491
MAHARASHTRA,2006,Professional Activity,0,156,287,159,51,653,0,25,23,7,1,56,709
MAHARASHTRA,2006,Farming/Agriculture Activity,7,942,1589,1032,541,4111,3,142,113,57,27,342,4453
MAHARASHTRA,2006,Others (Please Specify),3,463,712,409,170,1757,6,82,77,28,21,214,1971
MAHARASHTRA,2006,Retired Person,0,0,1,25,106,132,0,0,0,0,8,8,140
MAHARASHTRA,2006,Others (Please Specify),0,70,92,49,25,236,3,7,6,0,0,16,252
MAHARASHTRA,2006,Total,68,3088,4042,2326,986,10510,85,2683,1366,525,325,4984,15494
MAHARASHTRA,2006,Total Salaried,0,532,816,446,39,1833,0,88,58,18,2,166,1999
MAHARASHTRA,2006,Total Self-employed,10,1709,2791,1698,785,6993,9,257,223,92,50,631,7624
MANIPUR,2006,House Wife,0,0,0,0,0,0,0,2,1,0,0,3,3
MANIPUR,2006,Service (Government),0,3,8,2,0,13,0,0,0,0,0,0,13
MANIPUR,2006,Service (Private),0,0,0,0,0,0,0,0,0,0,0,0,0
MANIPUR,2006,Public Sector Undertaking,0,0,0,0,0,0,0,0,0,0,0,0,0
MANIPUR,2006,Student,0,4,0,0,0,4,0,9,0,0,0,9,13
MANIPUR,2006,Unemployed,0,0,2,2,1,5,0,0,0,0,0,0,5
MANIPUR,2006,Self-employed (Business activity),0,0,0,0,0,0,0,0,0,0,0,0,0
MANIPUR,2006,Professional Activity,0,0,0,0,0,0,0,0,0,0,0,0,0
MANIPUR,2006,Farming/Agriculture Activity,0,0,0,0,0,0,0,0,0,0,0,0,0
MANIPUR,2006,Others (Please Specify),0,0,0,1,0,1,0,0,0,0,0,0,1
MANIPUR,2006,Retired Person,0,0,0,0,0,0,0,0,0,0,0,0,0
MANIPUR,2006,Others (Please Specify),0,0,1,0,0,1,0,0,0,0,0,0,1
MANIPUR,2006,Total,0,7,11,5,1,24,0,11,1,0,0,12,36
MANIPUR,2006,Total Salaried,0,3,8,2,0,13,0,0,0,0,0,0,13
MANIPUR,2006,Total Self-employed,0,0,0,1,0,1,0,0,0,0,0,0,1
MEGHALAYA,2006,House Wife,0,0,0,0,0,0,0,6,5,0,0,11,11
MEGHALAYA,2006,Service (Government),0,3,5,0,0,8,0,0,0,0,0,0,8
MEGHALAYA,2006,Service (Private),0,1,2,2,0,5,0,0,0,0,0,0,5
MEGHALAYA,2006,Public Sector Undertaking,0,0,1,0,0,1,0,0,0,0,0,0,1
MEGHALAYA,2006,Student,1,3,0,0,0,4,1,5,0,0,0,6,10
MEGHALAYA,2006,Unemployed,0,9,1,0,0,10,0,2,0,0,0,2,12
MEGHALAYA,2006,Self-employed (Business activity),0,15,3,0,0,18,0,0,0,0,0,0,18
MEGHALAYA,2006,Professional Activity,0,0,0,0,0,0,0,0,0,0,0,0,0
MEGHALAYA,2006,Farming/Agriculture Activity,0,1,1,1,0,3,0,0,0,0,0,0,3
MEGHALAYA,2006,Others (Please Specify),0,5,5,1,3,14,0,3,0,0,0,3,17
MEGHALAYA,2006,Retired Person,0,0,0,0,0,0,0,0,0,0,0,0,0
MEGHALAYA,2006,Others (Please Specify),0,3,1,1,1,6,0,1,0,0,0,1,7
MEGHALAYA,2006,Total,1,40,19,5,4,69,1,17,5,0,0,23,92
MEGHALAYA,2006,Total Salaried,0,4,8,2,0,14,0,0,0,0,0,0,14
MEGHALAYA,2006,Total Self-employed,0,21,9,2,3,35,0,3,0,0,0,3,38
MIZORAM,2006,House Wife,0,0,0,0,0,0,0,1,0,3,0,4,4
MIZORAM,2006,Service (Government),0,2,2,1,0,5,0,0,0,0,0,0,5
MIZORAM,2006,Service (Private),0,3,0,0,0,3,0,0,0,0,0,0,3
MIZORAM,2006,Public Sector Undertaking,0,3,0,0,0,3,0,0,0,0,0,0,3
MIZORAM,2006,Student,0,2,2,0,0,4,0,0,0,0,0,0,4
MIZORAM,2006,Unemployed,0,5,0,1,0,6,0,0,0,0,0,0,6
MIZORAM,2006,Self-employed (Business activity),0,0,0,0,0,0,0,0,0,0,0,0,0
MIZORAM,2006,Professional Activity,0,0,0,0,0,0,0,0,0,0,0,0,0
MIZORAM,2006,Farming/Agriculture Activity,0,0,1,0,0,1,0,0,0,0,0,0,1
MIZORAM,2006,Others (Please Specify),0,2,0,1,2,5,0,0,0,0,0,0,5
MIZORAM,2006,Retired Person,0,0,0,0,0,0,0,0,0,0,0,0,0
MIZORAM,2006,Others (Please Specify),0,14,17,0,2,33,0,4,2,0,0,6,39
MIZORAM,2006,Total,0,31,22,3,4,60,0,5,2,3,0,10,70
MIZORAM,2006,Total Salaried,0,8,2,1,0,11,0,0,0,0,0,0,11
MIZORAM,2006,Total Self-employed,0,2,1,1,2,6,0,0,0,0,0,0,6
NAGALAND,2006,House Wife,0,0,0,0,0,0,0,0,4,1,0,5,5
NAGALAND,2006,Service (Government),0,3,2,0,0,5,0,0,0,0,0,0,5
NAGALAND,2006,Service (Private),0,0,0,0,0,0,0,0,0,0,0,0,0
NAGALAND,2006,Public Sector Undertaking,0,0,0,0,0,0,0,0,0,0,0,0,0
NAGALAND,2006,Student,0,1,1,0,0,2,0,0,0,0,0,0,2
NAGALAND,2006,Unemployed,1,4,2,0,0,7,0,0,0,0,0,0,7
NAGALAND,2006,Self-employed (Business activity),0,0,0,1,0,1,0,0,0,0,0,0,1
NAGALAND,2006,Professional Activity,0,0,0,0,0,0,0,0,0,0,0,0,0
NAGALAND,2006,Farming/Agriculture Activity,0,0,0,1,0,1,0,1,0,0,0,1,2
NAGALAND,2006,Others (Please Specify),0,1,1,1,0,3,0,2,0,0,0,2,5
NAGALAND,2006,Retired Person,0,0,0,0,0,0,0,0,0,0,0,0,0
NAGALAND,2006,Others (Please Specify),0,0,0,0,0,0,0,1,0,0,0,1,1
NAGALAND,2006,Total,1,9,6,3,0,19,0,4,4,1,0,9,28
NAGALAND,2006,Total Salaried,0,3,2,0,0,5,0,0,0,0,0,0,5
NAGALAND,2006,Total Self-employed,0,1,1,3,0,5,0,3,0,0,0,3,8
ODISHA,2006,House Wife,0,0,0,0,0,0,0,254,191,64,22,531,531
ODISHA,2006,Service (Government),0,6,8,4,0,18,0,4,1,0,0,5,23
ODISHA,2006,Service (Private),0,45,51,30,7,133,0,37,32,23,0,92,225
ODISHA,2006,Public Sector Undertaking,0,8,16,8,0,32,0,8,9,0,0,17,49
ODISHA,2006,Student,18,80,14,0,0,112,29,98,32,0,0,159,271
ODISHA,2006,Unemployed,0,128,136,32,11,307,0,57,33,10,0,100,407
ODISHA,2006,Self-employed (Business activity),0,58,118,66,16,258,1,13,10,10,0,34,292
ODISHA,2006,Professional Activity,2,23,29,26,3,83,1,12,2,2,0,17,100
ODISHA,2006,Farming/Agriculture Activity,2,76,79,53,31,241,0,7,12,15,8,42,283
ODISHA,2006,Others (Please Specify),11,202,270,184,85,752,19,147,156,84,29,435,1187
ODISHA,2006,Retired Person,0,0,0,2,16,18,0,0,0,0,1,1,19
ODISHA,2006,Others (Please Specify),10,115,149,88,57,419,9,110,87,39,14,259,678
ODISHA,2006,Total,43,741,870,493,226,2373,59,747,565,247,74,1692,4065
ODISHA,2006,Total Salaried,0,59,75,42,7,183,0,49,42,23,0,114,297
ODISHA,2006,Total Self-employed,15,359,496,329,135,1334,21,179,180,111,37,528,1862
PUNJAB,2006,House Wife,0,0,0,0,0,0,1,49,45,15,0,110,110
PUNJAB,2006,Service (Government),0,5,7,4,0,16,0,0,0,0,0,0,16
PUNJAB,2006,Service (Private),0,23,25,7,1,56,0,3,1,0,0,4,60
PUNJAB,2006,Public Sector Undertaking,0,1,2,2,0,5,0,1,0,0,0,1,6
PUNJAB,2006,Student,2,15,1,0,0,18,2,11,0,0,0,13,31
PUNJAB,2006,Unemployed,0,29,22,8,7,66,0,2,0,0,0,2,68
PUNJAB,2006,Self-employed (Business activity),0,6,10,6,1,23,0,0,0,0,0,0,23
PUNJAB,2006,Professional Activity,0,18,10,12,7,47,0,0,0,0,0,0,47
PUNJAB,2006,Farming/Agriculture Activity,0,27,28,22,8,85,0,0,0,0,0,0,85
PUNJAB,2006,Others (Please Specify),3,38,47,28,5,121,1,6,2,0,0,9,130
PUNJAB,2006,Retired Person,0,0,0,0,1,1,0,0,0,0,0,0,1
PUNJAB,2006,Others (Please Specify),6,54,59,35,18,172,12,7,1,1,2,23,195
PUNJAB,2006,Total,11,216,211,124,48,610,16,79,49,16,2,162,772
PUNJAB,2006,Total Salaried,0,29,34,13,1,77,0,4,1,0,0,5,82
PUNJAB,2006,Total Self-employed,3,89,95,68,21,276,1,6,2,0,0,9,285
RAJASTHAN,2006,House Wife,0,0,0,0,0,0,9,487,415,151,31,1093,1093
RAJASTHAN,2006,Service (Government),0,5,21,14,0,40,0,0,0,0,0,0,40
RAJASTHAN,2006,Service (Private),0,119,153,65,1,338,0,6,5,0,0,11,349
RAJASTHAN,2006,Public Sector Undertaking,0,13,11,5,0,29,0,2,2,0,0,4,33
RAJASTHAN,2006,Student,15,53,2,0,0,70,15,49,0,0,0,64,134
RAJASTHAN,2006,Unemployed,0,59,23,14,1,97,0,0,0,0,0,0,97
RAJASTHAN,2006,Self-employed (Business activity),0,58,78,32,3,171,0,5,0,0,0,5,176
RAJASTHAN,2006,Professional Activity,0,8,8,3,0,19,0,0,0,0,0,0,19
RAJASTHAN,2006,Farming/Agriculture Activity,2,85,147,101,21,356,0,16,18,4,1,39,395
RAJASTHAN,2006,Others (Please Specify),2,228,306,136,33,705,6,26,13,9,1,55,760
RAJASTHAN,2006,Retired Person,0,0,0,2,0,2,0,0,1,0,0,1,3
RAJASTHAN,2006,Others (Please Specify),40,288,423,257,75,1083,16,18,15,22,10,81,1164
RAJASTHAN,2006,Total,59,916,1172,629,134,2910,46,609,469,186,43,1353,4263
RAJASTHAN,2006,Total Salaried,0,137,185,84,1,407,0,8,7,0,0,15,422
RAJASTHAN,2006,Total Self-employed,4,379,539,272,57,1251,6,47,31,13,2,99,1350
SIKKIM,2006,House Wife,0,0,0,0,0,0,0,0,10,1,4,15,15
SIKKIM,2006,Service (Government),0,4,0,0,0,4,0,0,0,0,0,0,4
SIKKIM,2006,Service (Private),0,6,5,2,0,13,0,0,1,0,0,1,14
SIKKIM,2006,Public Sector Undertaking,0,0,0,0,0,0,0,0,0,0,0,0,0
SIKKIM,2006,Student,4,20,0,0,0,24,3,10,2,0,0,15,39
SIKKIM,2006,Unemployed,0,0,10,8,0,18,0,0,0,0,0,0,18
SIKKIM,2006,Self-employed (Business activity),0,0,3,0,0,3,0,0,0,0,0,0,3
SIKKIM,2006,Professional Activity,0,0,0,0,0,0,0,0,0,0,0,0,0
SIKKIM,2006,Farming/Agriculture Activity,0,10,13,4,0,27,0,8,0,0,0,8,35
SIKKIM,2006,Others (Please Specify),0,9,0,0,0,9,0,8,0,0,0,8,17
SIKKIM,2006,Retired Person,0,0,0,0,0,0,0,0,0,0,0,0,0
SIKKIM,2006,Others (Please Specify),0,0,0,0,0,0,0,0,0,0,0,0,0
SIKKIM,2006,Total,4,49,31,14,0,98,3,26,13,1,4,47,145
SIKKIM,2006,Total Salaried,0,10,5,2,0,17,0,0,1,0,0,1,18
SIKKIM,2006,Total Self-employed,0,19,16,4,0,39,0,16,0,0,0,16,55
TAMIL NADU,2006,House Wife,0,0,0,0,0,0,0,830,947,451,126,2354,2354
TAMIL NADU,2006,Service (Government),0,20,89,45,1,155,0,10,8,7,5,30,185
TAMIL NADU,2006,Service (Private),0,279,449,291,73,1092,0,462,101,58,7,628,1720
TAMIL NADU,2006,Public Sector Undertaking,0,49,107,60,29,245,0,15,11,59,1,86,331
TAMIL NADU,2006,Student,26,65,8,0,0,99,36,84,7,0,0,127,226
TAMIL NADU,2006,Unemployed,0,364,116,170,96,746,0,240,122,86,33,481,1227
TAMIL NADU,2006,Self-employed (Business activity),0,135,779,174,30,1118,0,8,76,3,0,87,1205
TAMIL NADU,2006,Professional Activity,0,0,0,0,0,0,0,0,0,0,0,0,0
TAMIL NADU,2006,Farming/Agriculture Activity,0,78,147,82,35,342,0,23,40,19,2,84,426
TAMIL NADU,2006,Others (Please Specify),0,757,700,822,281,2560,0,224,180,107,70,581,3141
TAMIL NADU,2006,Retired Person,0,0,0,10,77,87,0,0,0,0,15,15,102
TAMIL NADU,2006,Others (Please Specify),0,249,402,281,133,1065,44,99,129,80,47,399,1464
TAMIL NADU,2006,Total,26,1996,2797,1935,755,7509,80,1995,1621,870,306,4872,12381
TAMIL NADU,2006,Total Salaried,0,348,645,396,103,1492,0,487,120,124,13,744,2236
TAMIL NADU,2006,Total Self-employed,0,970,1626,1078,346,4020,0,255,296,129,72,752,4772
TRIPURA,2006,House Wife,0,0,0,0,0,0,0,72,48,10,3,133,133
TRIPURA,2006,Service (Government),0,1,5,4,0,10,0,0,0,0,0,0,10
TRIPURA,2006,Service (Private),0,2,3,2,0,7,0,0,0,0,0,0,7
TRIPURA,2006,Public Sector Undertaking,0,2,2,2,0,6,0,0,0,0,0,0,6
TRIPURA,2006,Student,4,27,12,0,0,43,7,31,3,0,0,41,84
TRIPURA,2006,Unemployed,0,19,23,3,0,45,0,13,4,0,0,17,62
TRIPURA,2006,Self-employed (Business activity),0,2,7,5,4,18,0,0,0,0,0,0,18
TRIPURA,2006,Professional Activity,0,3,4,0,0,7,0,0,0,0,0,0,7
TRIPURA,2006,Farming/Agriculture Activity,0,0,5,2,0,7,0,0,0,0,0,0,7
TRIPURA,2006,Others (Please Specify),2,7,22,10,6,47,0,3,2,1,0,6,53
TRIPURA,2006,Retired Person,0,0,0,0,0,0,0,0,0,0,0,0,0
TRIPURA,2006,Others (Please Specify),5,82,84,50,17,238,4,49,61,23,3,140,378
TRIPURA,2006,Total,11,145,167,78,27,428,11,168,118,34,6,337,765
TRIPURA,2006,Total Salaried,0,5,10,8,0,23,0,0,0,0,0,0,23
TRIPURA,2006,Total Self-employed,2,12,38,17,10,79,0,3,2,1,0,6,85
UTTAR PRADESH,2006,House Wife,0,0,0,0,0,0,8,446,186,39,31,710,710
UTTAR PRADESH,2006,Service (Government),0,52,34,20,9,115,0,13,8,8,3,32,147
UTTAR PRADESH,2006,Service (Private),2,79,53,18,3,155,0,27,28,3,0,58,213
UTTAR PRADESH,2006,Public Sector Undertaking,0,9,15,4,0,28,0,13,5,1,0,19,47
UTTAR PRADESH,2006,Student,14,88,0,0,0,102,5,62,2,0,0,69,171
UTTAR PRADESH,2006,Unemployed,1,58,116,17,9,201,0,24,14,1,1,40,241
UTTAR PRADESH,2006,Self-employed (Business activity),0,44,40,36,29,149,0,7,8,3,2,20,169
UTTAR PRADESH,2006,Professional Activity,0,33,20,14,3,70,0,6,3,8,0,17,87
UTTAR PRADESH,2006,Farming/Agriculture Activity,1,125,150,49,21,346,6,27,22,6,4,65,411
UTTAR PRADESH,2006,Others (Please Specify),36,125,102,63,20,346,24,69,71,25,9,198,544
UTTAR PRADESH,2006,Retired Person,0,0,0,4,3,7,0,0,0,0,0,0,7
UTTAR PRADESH,2006,Others (Please Specify),11,16,143,51,21,242,11,43,15,26,15,110,352
UTTAR PRADESH,2006,Total,65,629,673,276,118,1761,54,737,362,120,65,1338,3099
UTTAR PRADESH,2006,Total Salaried,2,140,102,42,12,298,0,53,41,12,3,109,407
UTTAR PRADESH,2006,Total Self-employed,37,327,312,162,73,911,30,109,104,42,15,300,1211
UTTARAKHAND,2006,House Wife,0,0,0,0,0,0,0,43,33,8,2,86,86
UTTARAKHAND,2006,Service (Government),0,4,7,2,0,13,0,0,0,1,0,1,14
UTTARAKHAND,2006,Service (Private),0,4,9,4,1,18,0,3,4,1,1,9,27
UTTARAKHAND,2006,Public Sector Undertaking,0,1,3,2,0,6,0,3,2,1,0,6,12
UTTARAKHAND,2006,Student,0,4,0,0,0,4,1,6,3,0,0,10,14
UTTARAKHAND,2006,Unemployed,0,6,6,5,2,19,0,2,2,1,0,5,24
UTTARAKHAND,2006,Self-employed (Business activity),0,5,8,6,2,21,0,2,0,0,0,2,23
UTTARAKHAND,2006,Professional Activity,0,0,4,2,0,6,0,2,1,0,0,3,9
UTTARAKHAND,2006,Farming/Agriculture Activity,0,10,12,10,1,33,0,9,8,1,0,18,51
UTTARAKHAND,2006,Others (Please Specify),0,3,4,5,3,15,1,1,0,0,0,2,17
UTTARAKHAND,2006,Retired Person,0,0,0,0,4,4,0,0,0,0,0,0,4
UTTARAKHAND,2006,Others (Please Specify),0,14,17,3,0,34,3,6,2,0,0,11,45
UTTARAKHAND,2006,Total,0,51,70,39,13,173,5,77,55,13,3,153,326
UTTARAKHAND,2006,Total Salaried,0,9,19,8,1,37,0,6,6,3,1,16,53
UTTARAKHAND,2006,Total Self-employed,0,18,28,23,6,75,1,14,9,1,0,25,100
WEST BENGAL,2006,House Wife,0,0,0,0,0,0,0,2263,1584,1111,62,5020,5020
WEST BENGAL,2006,Service (Government),0,20,81,62,0,163,0,8,16,12,0,36,199
WEST BENGAL,2006,Service (Private),0,93,339,256,0,688,0,36,65,29,0,130,818
WEST BENGAL,2006,Public Sector Undertaking,0,265,388,123,0,776,0,33,25,21,0,79,855
WEST BENGAL,2006,Student,146,491,2,0,0,639,184,317,1,0,0,502,1141
WEST BENGAL,2006,Unemployed,0,928,639,0,0,1567,0,144,37,0,0,181,1748
WEST BENGAL,2006,Self-employed (Business activity),0,338,688,335,39,1400,0,10,33,8,0,51,1451
WEST BENGAL,2006,Professional Activity,0,182,242,279,35,738,0,23,12,3,0,38,776
WEST BENGAL,2006,Farming/Agriculture Activity,0,196,455,256,56,963,0,85,105,31,5,226,1189
WEST BENGAL,2006,Others (Please Specify),0,521,627,562,113,1823,0,78,34,18,158,288,2111
WEST BENGAL,2006,Retired Person,0,0,0,0,297,297,0,0,0,0,46,46,343
WEST BENGAL,2006,Others (Please Specify),4,3,14,20,25,66,0,1,1,1,5,8,74
WEST BENGAL,2006,Total,150,3037,3475,1893,565,9120,184,2998,1913,1234,276,6605,15725
WEST BENGAL,2006,Total Salaried,0,378,808,441,0,1627,0,77,106,62,0,245,1872
WEST BENGAL,2006,Total Self-employed,0,1237,2012,1432,243,4924,0,196,184,60,163,603,5527
TOTAL (STATES),2006,House Wife,0,0,0,0,0,0,40,11044,8215,3991,1281,24571,24571
TOTAL (STATES),2006,Service (Government),5,424,783,547,12,1771,0,120,124,54,8,306,2077
TOTAL (STATES),2006,Service (Private),6,2013,2940,1885,221,7065,0,879,453,200,19,1551,8616
TOTAL (STATES),2006,Public Sector Undertaking,2,600,923,418,56,1999,2,151,110,106,4,373,2372
TOTAL (STATES),2006,Student,553,2345,107,25,8,3038,615,1917,83,5,0,2620,5658
TOTAL (STATES),2006,Unemployed,10,3084,2551,1032,386,7063,5,788,364,166,76,1399,8462
TOTAL (STATES),2006,Self-employed (Business activity),5,1586,3031,1516,316,6454,2,139,208,65,9,423,6877
TOTAL (STATES),2006,Professional Activity,16,851,1358,971,208,3404,5,112,77,35,6,235,3639
TOTAL (STATES),2006,Farming/Agriculture Activity,56,3496,5678,3650,1593,14473,58,921,845,426,140,2390,16863
TOTAL (STATES),2006,Others (Please Specify),177,4574,5793,4386,1802,16732,180,1456,1048,582,542,3808,20540
TOTAL (STATES),2006,Retired Person,1,27,34,135,749,946,0,1,6,12,135,154,1100
TOTAL (STATES),2006,Others (Please Specify),345,3162,4063,2516,1172,11258,332,1445,1148,570,287,3782,15040
TOTAL (STATES),2006,Total,1176,22162,27261,17081,6523,74203,1239,18973,12681,6212,2507,41612,115815
TOTAL (STATES),2006,Total Salaried,13,3037,4646,2850,289,10835,2,1150,687,360,31,2230,13065
TOTAL (STATES),2006,Total Self-employed,254,10507,15860,10523,3919,41063,245,2628,2178,1108,697,6856,47919
A & N ISLANDS,2006,House Wife,0,0,0,0,0,0,0,18,10,3,2,33,33
A & N ISLANDS,2006,Service (Government),0,3,4,4,0,11,0,0,0,0,0,0,11
A & N ISLANDS,2006,Service (Private),0,10,28,18,6,62,0,1,0,0,0,1,63
A & N ISLANDS,2006,Public Sector Undertaking,0,0,0,0,0,0,0,0,0,0,0,0,0
A & N ISLANDS,2006,Student,1,0,0,0,0,1,1,2,0,0,0,3,4
A & N ISLANDS,2006,Unemployed,0,2,0,0,0,2,0,0,0,0,0,0,2
A & N ISLANDS,2006,Self-employed (Business activity),0,2,0,2,0,4,0,0,0,0,0,0,4
A & N ISLANDS,2006,Professional Activity,0,0,0,0,0,0,0,0,0,0,0,0,0
A & N ISLANDS,2006,Farming/Agriculture Activity,0,2,2,1,1,6,0,0,0,0,0,0,6
A & N ISLANDS,2006,Others (Please Specify),0,0,0,0,0,0,0,0,0,0,0,0,0
A & N ISLANDS,2006,Retired Person,0,0,0,0,0,0,0,0,0,0,0,0,0
A & N ISLANDS,2006,Others (Please Specify),3,2,0,0,5,10,0,0,0,0,0,0,10
A & N ISLANDS,2006,Total,4,21,34,25,12,96,1,21,10,3,2,37,133
A & N ISLANDS,2006,Total Salaried,0,13,32,22,6,73,0,1,0,0,0,1,74
A & N ISLANDS,2006,Total Self-employed,0,4,2,3,1,10,0,0,0,0,0,0,10
CHANDIGARH,2006,House Wife,0,0,0,0,0,0,0,3,6,1,1,11,11
CHANDIGARH,2006,Service (Government),0,2,3,2,0,7,0,0,0,0,0,0,7
CHANDIGARH,2006,Service (Private),0,5,8,0,0,13,0,2,0,0,0,2,15
CHANDIGARH,2006,Public Sector Undertaking,0,0,0,0,0,0,0,0,0,0,0,0,0
CHANDIGARH,2006,Student,0,11,0,0,0,11,2,7,0,0,0,9,20
CHANDIGARH,2006,Unemployed,0,7,15,1,0,23,0,2,0,0,0,2,25
CHANDIGARH,2006,Self-employed (Business activity),0,0,0,0,1,1,0,0,0,0,0,0,1
CHANDIGARH,2006,Professional Activity,0,0,0,0,0,0,0,0,0,0,0,0,0
CHANDIGARH,2006,Farming/Agriculture Activity,0,1,0,0,0,1,0,0,0,0,0,0,1
CHANDIGARH,2006,Others (Please Specify),0,0,0,0,0,0,0,0,0,0,0,0,0
CHANDIGARH,2006,Retired Person,0,0,0,0,0,0,0,0,0,0,0,0,0
CHANDIGARH,2006,Others (Please Specify),0,0,0,0,0,0,0,0,0,0,0,0,0
CHANDIGARH,2006,Total,0,26,26,3,1,56,2,14,6,1,1,24,80
CHANDIGARH,2006,Total Salaried,0,7,11,2,0,20,0,2,0,0,0,2,22
CHANDIGARH,2006,Total Self-employed,0,1,0,0,1,2,0,0,0,0,0,0,2
D & N HAVELI,2006,House Wife,0,0,0,0,0,0,0,7,6,2,2,17,17
D & N HAVELI,2006,Service (Government),0,0,0,0,0,0,0,0,0,0,0,0,0
D & N HAVELI,2006,Service (Private),0,2,0,0,1,3,0,0,0,0,0,0,3
D & N HAVELI,2006,Public Sector Undertaking,0,0,0,0,0,0,0,0,0,0,0,0,0
D & N HAVELI,2006,Student,0,2,0,0,0,2,0,0,0,0,0,0,2
D & N HAVELI,2006,Unemployed,0,3,2,0,0,5,1,1,0,0,0,2,7
D & N HAVELI,2006,Self-employed (Business activity),0,0,1,0,0,1,0,0,0,0,0,0,1
D & N HAVELI,2006,Professional Activity,0,0,0,0,0,0,0,0,0,0,0,0,0
D & N HAVELI,2006,Farming/Agriculture Activity,0,1,2,3,6,12,0,0,0,0,0,0,12
D & N HAVELI,2006,Others (Please Specify),0,0,0,0,0,0,0,0,0,0,0,0,0
D & N HAVELI,2006,Retired Person,0,0,0,0,0,0,0,0,0,0,0,0,0
D & N HAVELI,2006,Others (Please Specify),0,0,0,0,0,0,0,0,0,0,0,0,0
D & N HAVELI,2006,Total,0,8,5,3,7,23,1,8,6,2,2,19,42
D & N HAVELI,2006,Total Salaried,0,2,0,0,1,3,0,0,0,0,0,0,3
D & N HAVELI,2006,Total Self-employed,0,1,3,3,6,13,0,0,0,0,0,0,13
DAMAN & DIU,2006,House Wife,0,0,0,0,0,0,0,3,0,0,0,3,3
DAMAN & DIU,2006,Service (Government),0,0,0,0,0,0,0,0,0,0,0,0,0
DAMAN & DIU,2006,Service (Private),0,6,2,0,0,8,0,0,0,0,0,0,8
DAMAN & DIU,2006,Public Sector Undertaking,0,0,0,0,0,0,0,0,0,0,0,0,0
DAMAN & DIU,2006,Student,0,1,0,0,0,1,1,1,0,0,0,2,3
DAMAN & DIU,2006,Unemployed,0,0,0,0,0,0,0,0,0,0,0,0,0
DAMAN & DIU,2006,Self-employed (Business activity),0,0,1,0,0,1,0,0,0,0,0,0,1
DAMAN & DIU,2006,Professional Activity,0,0,0,0,0,0,0,0,0,0,0,0,0
DAMAN & DIU,2006,Farming/Agriculture Activity,0,0,0,0,0,0,0,0,0,0,0,0,0
DAMAN & DIU,2006,Others (Please Specify),0,0,2,0,0,2,0,0,0,0,0,0,2
DAMAN & DIU,2006,Retired Person,0,0,0,0,0,0,0,0,0,0,0,0,0
DAMAN & DIU,2006,Others (Please Specify),0,0,0,1,1,2,2,0,1,0,0,3,5
DAMAN & DIU,2006,Total,0,7,5,1,1,14,3,4,1,0,0,8,22
DAMAN & DIU,2006,Total Salaried,0,6,2,0,0,8,0,0,0,0,0,0,8
DAMAN & DIU,2006,Total Self-employed,0,0,3,0,0,3,0,0,0,0,0,0,3
DELHI (UT),2006,House Wife,0,0,0,0,0,0,0,194,111,24,2,331,331
DELHI (UT),2006,Service (Government),0,4,15,8,0,27,0,1,3,0,0,4,31
DELHI (UT),2006,Service (Private),0,116,94,37,1,248,0,15,2,0,0,17,265
DELHI (UT),2006,Public Sector Undertaking,0,10,11,1,0,22,1,2,0,0,0,3,25
DELHI (UT),2006,Student,3,52,0,0,0,55,9,53,1,0,0,63,118
DELHI (UT),2006,Unemployed,1,150,90,33,3,277,1,32,5,0,2,40,317
DELHI (UT),2006,Self-employed (Business activity),0,7,13,1,1,22,0,6,1,0,0,7,29
DELHI (UT),2006,Professional Activity,0,1,1,2,0,4,0,0,0,0,0,0,4
DELHI (UT),2006,Farming/Agriculture Activity,0,0,3,0,0,3,0,0,0,0,0,0,3
DELHI (UT),2006,Others (Please Specify),4,69,82,44,12,211,2,21,23,2,0,48,259
DELHI (UT),2006,Retired Person,0,9,5,2,1,17,0,0,0,0,0,0,17
DELHI (UT),2006,Others (Please Specify),1,31,26,11,5,74,3,11,2,2,1,19,93
DELHI (UT),2006,Total,9,449,340,139,23,960,16,335,148,28,5,532,1492
DELHI (UT),2006,Total Salaried,0,130,120,46,1,297,1,18,5,0,0,24,321
DELHI (UT),2006,Total Self-employed,4,77,99,47,13,240,2,27,24,2,0,55,295
LAKSHADWEEP,2006,House Wife,0,0,0,0,0,0,0,1,0,0,0,1,1
LAKSHADWEEP,2006,Service (Government),0,0,1,0,0,1,0,0,0,0,0,0,1
LAKSHADWEEP,2006,Service (Private),0,0,0,0,0,0,0,0,0,0,0,0,0
LAKSHADWEEP,2006,Public Sector Undertaking,0,0,0,0,0,0,0,0,0,0,0,0,0
LAKSHADWEEP,2006,Student,0,0,0,0,0,0,0,0,0,0,0,0,0
LAKSHADWEEP,2006,Unemployed,0,0,0,0,0,0,0,0,0,0,0,0,0
LAKSHADWEEP,2006,Self-employed (Business activity),0,0,0,0,0,0,0,0,0,0,0,0,0
LAKSHADWEEP,2006,Professional Activity,0,0,0,0,0,0,0,0,0,0,0,0,0
LAKSHADWEEP,2006,Farming/Agriculture Activity,0,0,0,0,0,0,0,0,0,0,0,0,0
LAKSHADWEEP,2006,Others (Please Specify),0,0,0,0,0,0,0,0,0,0,0,0,0
LAKSHADWEEP,2006,Retired Person,0,0,0,0,0,0,0,0,0,0,0,0,0
LAKSHADWEEP,2006,Others (Please Specify),0,0,0,0,0,0,0,0,0,0,0,0,0
LAKSHADWEEP,2006,Total,0,0,1,0,0,1,0,1,0,0,0,1,2
LAKSHADWEEP,2006,Total Salaried,0,0,1,0,0,1,0,0,0,0,0,0,1
LAKSHADWEEP,2006,Total Self-employed,0,0,0,0,0,0,0,0,0,0,0,0,0
PUDUCHERRY,2006,House Wife,0,0,0,0,0,0,0,47,31,10,8,96,96
PUDUCHERRY,2006,Service (Government),0,1,9,7,0,17,0,1,2,0,0,3,20
PUDUCHERRY,2006,Service (Private),0,18,29,15,2,64,0,5,2,0,0,7,71
PUDUCHERRY,2006,Public Sector Undertaking,0,0,1,2,1,4,0,0,0,0,0,0,4
PUDUCHERRY,2006,Student,5,10,0,0,0,15,8,29,0,0,0,37,52
PUDUCHERRY,2006,Unemployed,0,14,8,9,14,45,0,20,1,2,5,28,73
PUDUCHERRY,2006,Self-employed (Business activity),0,4,10,6,1,21,0,0,0,0,0,0,21
PUDUCHERRY,2006,Professional Activity,0,0,0,0,0,0,0,0,0,0,0,0,0
PUDUCHERRY,2006,Farming/Agriculture Activity,0,35,76,50,8,169,0,1,2,3,0,6,175
PUDUCHERRY,2006,Others (Please Specify),0,0,1,0,0,1,0,0,0,0,0,0,1
PUDUCHERRY,2006,Retired Person,0,0,0,0,2,2,0,0,0,0,0,0,2
PUDUCHERRY,2006,Others (Please Specify),0,2,3,4,2,11,0,0,0,0,0,0,11
PUDUCHERRY,2006,Total,5,84,137,93,30,349,8,103,38,15,13,177,526
PUDUCHERRY,2006,Total Salaried,0,19,39,24,3,85,0,6,4,0,0,10,95
PUDUCHERRY,2006,Total Self-employed,0,39,87,56,9,191,0,1,2,3,0,6,197
TOTAL (UTs),2006,House Wife,0,0,0,0,0,0,0,273,164,40,15,492,492
TOTAL (UTs),2006,Service (Government),0,10,32,21,0,63,0,2,5,0,0,7,70
TOTAL (UTs),2006,Service (Private),0,157,161,70,10,398,0,23,4,0,0,27,425
TOTAL (UTs),2006,Public Sector Undertaking,0,10,12,3,1,26,1,2,0,0,0,3,29
TOTAL (UTs),2006,Student,9,76,0,0,0,85,21,92,1,0,0,114,199
TOTAL (UTs),2006,Unemployed,1,176,115,43,17,352,2,55,6,2,7,72,424
TOTAL (UTs),2006,Self-employed (Business activity),0,13,25,9,3,50,0,6,1,0,0,7,57
TOTAL (UTs),2006,Professional Activity,0,1,1,2,0,4,0,0,0,0,0,0,4
TOTAL (UTs),2006,Farming/Agriculture Activity,0,39,83,54,15,191,0,1,2,3,0,6,197
TOTAL (UTs),2006,Others (Please Specify),4,69,85,44,12,214,2,21,23,2,0,48,262
TOTAL (UTs),2006,Retired Person,0,9,5,2,3,19,0,0,0,0,0,0,19
TOTAL (UTs),2006,Others (Please Specify),4,35,29,16,13,97,5,11,3,2,1,22,119
TOTAL (UTs),2006,Total,18,595,548,264,74,1499,31,486,209,49,23,798,2297
TOTAL (UTs),2006,Total Salaried,0,177,205,94,11,487,1,27,9,0,0,37,524
TOTAL (UTs),2006,Total Self-employed,4,122,194,109,30,459,2,28,26,5,0,61,520
TOTAL (ALL INDIA),2006,House Wife,0,0,0,0,0,0,40,11317,8379,4031,1296,25063,25063
TOTAL (ALL INDIA),2006,Service (Government),5,434,815,568,12,1834,0,122,129,54,8,313,2147
TOTAL (ALL INDIA),2006,Service (Private),6,2170,3101,1955,231,7463,0,902,457,200,19,1578,9041
TOTAL (ALL INDIA),2006,Public Sector Undertaking,2,610,935,421,57,2025,3,153,110,106,4,376,2401
TOTAL (ALL INDIA),2006,Student,562,2421,107,25,8,3123,636,2009,84,5,0,2734,5857
TOTAL (ALL INDIA),2006,Unemployed,11,3260,2666,1075,403,7415,7,843,370,168,83,1471,8886
TOTAL (ALL INDIA),2006,Self-employed (Business activity),5,1599,3056,1525,319,6504,2,145,209,65,9,430,6934
TOTAL (ALL INDIA),2006,Professional Activity,16,852,1359,973,208,3408,5,112,77,35,6,235,3643
TOTAL (ALL INDIA),2006,Farming/Agriculture Activity,56,3535,5761,3704,1608,14664,58,922,847,429,140,2396,17060
TOTAL (ALL INDIA),2006,Others (Please Specify),181,4643,5878,4430,1814,16946,182,1477,1071,584,542,3856,20802
TOTAL (ALL INDIA),2006,Retired Person,1,36,39,137,752,965,0,1,6,12,135,154,1119
TOTAL (ALL INDIA),2006,Others (Please Specify),349,3197,4092,2532,1185,11355,337,1456,1151,572,288,3804,15159
TOTAL (ALL INDIA),2006,Total,1194,22757,27809,17345,6597,75702,1270,19459,12890,6261,2530,42410,118112
TOTAL (ALL INDIA),2006,Total Salaried,13,3214,4851,2944,300,11322,3,1177,696,360,31,2267,13589
TOTAL (ALL INDIA),2006,Total Self-employed,258,10629,16054,10632,3949,41522,247,2656,2204,1113,697,6917,48439
