STATE/UT,Year,CAUSE,Male upto 14 years,Male 15-29 years,Male 30-44 years,Male 45-59 years,Male 60 years and above,Total Male,Female upto 14 years,Female 15-29 years,Female 30-44 years,Female 45-59 years,Female 60 years and above,Total Female,Grand Total
ANDHRA PRADESH,2007,House Wife,0,0,0,0,0,0,0,1105,811,405,159,2480,2480
ANDHRA PRADESH,2007,Service (Government),0,71,86,63,0,220,1,26,19,9,0,55,275
ANDHRA PRADESH,2007,Service (Private),6,239,490,266,102,1103,3,41,105,72,49,270,1373
ANDHRA PRADESH,2007,Public Sector Undertaking,0,46,99,62,3,210,4,8,13,4,0,29,239
ANDHRA PRADESH,2007,Student,63,327,27,3,0,420,80,193,6,0,0,279,699
ANDHRA PRADESH,2007,Unemployed,0,120,146,74,0,340,7,43,10,3,0,63,403
ANDHRA PRADESH,2007,Self-employed (Business activity),0,262,374,249,40,925,0,16,16,22,1,55,980
ANDHRA PRADESH,2007,Professional Activity,2,110,151,109,49,421,7,31,17,3,0,58,479
ANDHRA PRADESH,2007,Farming/Agriculture Activity,5,325,620,421,137,1508,20,113,90,53,13,289,1797
ANDHRA PRADESH,2007,Others (Please Specify),9,636,913,563,341,2462,32,283,166,126,61,668,3130
ANDHRA PRADESH,2007,Retired Person,0,1,7,4,55,67,0,0,0,6,5,11,78
ANDHRA PRADESH,2007,Others (Please Specify),36,799,747,490,201,2273,40,280,197,101,58,676,2949
ANDHRA PRADESH,2007,Total,121,2936,3660,2304,928,9949,194,2139,1450,804,346,4933,14882
ANDHRA PRADESH,2007,Total Salaried,6,356,675,391,105,1533,8,75,137,85,49,354,1887
ANDHRA PRADESH,2007,Total Self-employed,16,1333,2058,1342,567,5316,59,443,289,204,75,1070,6386
ARUNACHAL PRADESH,2007,House Wife,0,0,0,0,0,0,0,2,8,0,0,10,10
ARUNACHAL PRADESH,2007,Service (Government),0,0,5,4,0,9,0,0,0,0,0,0,9
ARUNACHAL PRADESH,2007,Service (Private),0,10,5,2,1,18,0,1,0,0,0,1,19
ARUNACHAL PRADESH,2007,Public Sector Undertaking,0,0,0,0,0,0,0,0,0,0,0,0,0
ARUNACHAL PRADESH,2007,Student,1,2,0,0,0,3,2,6,0,0,0,8,11
ARUNACHAL PRADESH,2007,Unemployed,1,11,12,1,0,25,0,1,1,0,0,2,27
ARUNACHAL PRADESH,2007,Self-employed (Business activity),0,1,1,2,0,4,0,0,0,0,0,0,4
ARUNACHAL PRADESH,2007,Professional Activity,0,1,0,0,0,1,0,0,0,0,0,0,1
ARUNACHAL PRADESH,2007,Farming/Agriculture Activity,0,4,9,1,0,14,0,1,0,0,0,1,15
ARUNACHAL PRADESH,2007,Others (Please Specify),0,6,10,0,0,16,1,3,0,1,0,5,21
ARUNACHAL PRADESH,2007,Retired Person,0,0,0,0,2,2,0,0,0,0,0,0,2
ARUNACHAL PRADESH,2007,Others (Please Specify),0,4,2,0,0,6,2,0,1,1,0,4,10
ARUNACHAL PRADESH,2007,Total,2,39,44,10,3,98,5,14,10,2,0,31,129
ARUNACHAL PRADESH,2007,Total Salaried,0,10,10,6,1,27,0,1,0,0,0,1,28
ARUNACHAL PRADESH,2007,Total Self-employed,0,12,20,3,0,35,1,4,0,1,0,6,41
ASSAM,2007,House Wife,0,0,0,0,0,0,0,188,214,95,19,516,516
ASSAM,2007,Service (Government),0,6,7,2,0,15,0,0,2,0,0,2,17
ASSAM,2007,Service (Private),0,9,11,10,0,30,0,7,3,2,0,12,42
ASSAM,2007,Public Sector Undertaking,0,13,52,8,1,74,0,9,8,2,0,19,93
ASSAM,2007,Student,29,90,0,0,0,119,23,62,3,1,1,90,209
ASSAM,2007,Unemployed,0,7,2,15,6,30,0,5,1,0,0,6,36
ASSAM,2007,Self-employed (Business activity),0,105,182,88,2,377,1,35,13,2,0,51,428
ASSAM,2007,Professional Activity,0,30,86,34,0,150,0,0,0,0,0,0,150
ASSAM,2007,Farming/Agriculture Activity,0,90,111,67,8,276,0,0,2,0,0,2,278
ASSAM,2007,Others (Please Specify),1,300,279,233,24,837,5,61,49,9,8,132,969
ASSAM,2007,Retired Person,0,0,0,0,7,7,0,0,0,0,0,0,7
ASSAM,2007,Others (Please Specify),8,54,69,50,20,201,4,60,36,9,7,116,317
ASSAM,2007,Total,38,704,799,507,68,2116,33,427,331,120,35,946,3062
ASSAM,2007,Total Salaried,0,28,70,20,1,119,0,16,13,4,0,33,152
ASSAM,2007,Total Self-employed,1,525,658,422,34,1640,6,96,64,11,8,185,1825
BIHAR,2007,House Wife,0,0,0,0,0,0,0,63,73,29,6,171,171
BIHAR,2007,Service (Government),0,2,2,4,0,8,0,0,0,0,0,0,8
BIHAR,2007,Service (Private),0,12,9,15,0,36,0,0,0,0,0,0,36
BIHAR,2007,Public Sector Undertaking,0,4,5,8,2,19,0,0,0,0,0,0,19
BIHAR,2007,Student,14,34,7,1,0,56,26,32,1,0,0,59,115
BIHAR,2007,Unemployed,0,36,12,14,3,65,0,9,10,0,0,19,84
BIHAR,2007,Self-employed (Business activity),0,2,1,4,1,8,0,2,1,0,0,3,11
BIHAR,2007,Professional Activity,1,1,0,1,0,3,0,0,0,0,0,0,3
BIHAR,2007,Farming/Agriculture Activity,1,29,27,19,2,78,0,0,8,0,0,8,86
BIHAR,2007,Others (Please Specify),1,50,34,25,11,121,3,35,7,14,8,67,188
BIHAR,2007,Retired Person,0,0,0,1,2,3,0,0,0,0,0,0,3
BIHAR,2007,Others (Please Specify),16,42,49,23,7,137,15,55,17,8,9,104,241
BIHAR,2007,Total,33,212,146,115,28,534,44,196,117,51,23,431,965
BIHAR,2007,Total Salaried,0,18,16,27,2,63,0,0,0,0,0,0,63
BIHAR,2007,Total Self-employed,3,82,62,49,14,210,3,37,16,14,8,78,288
CHHATTISGARH,2007,House Wife,0,0,0,0,0,0,3,423,270,106,46,848,848
CHHATTISGARH,2007,Service (Government),0,9,12,13,0,34,0,1,3,0,0,4,38
CHHATTISGARH,2007,Service (Private),0,74,83,51,5,213,0,9,9,2,0,20,233
CHHATTISGARH,2007,Public Sector Undertaking,0,8,11,3,0,22,0,1,1,0,0,2,24
CHHATTISGARH,2007,Student,32,94,46,0,0,172,26,78,3,0,0,107,279
CHHATTISGARH,2007,Unemployed,0,119,43,11,4,177,1,9,4,0,0,14,191
CHHATTISGARH,2007,Self-employed (Business activity),0,36,64,24,8,132,0,1,2,0,0,3,135
CHHATTISGARH,2007,Professional Activity,0,31,43,18,11,103,0,2,2,1,1,6,109
CHHATTISGARH,2007,Farming/Agriculture Activity,2,359,458,310,135,1264,5,136,96,78,14,329,1593
CHHATTISGARH,2007,Others (Please Specify),2,131,151,139,87,510,4,43,65,28,14,154,664
CHHATTISGARH,2007,Retired Person,0,0,0,1,1,2,0,0,0,0,0,0,2
CHHATTISGARH,2007,Others (Please Specify),42,186,212,118,69,627,20,28,21,17,10,96,723
CHHATTISGARH,2007,Total,78,1047,1123,688,320,3256,59,731,476,232,85,1583,4839
CHHATTISGARH,2007,Total Salaried,0,91,106,67,5,269,0,11,13,2,0,26,295
CHHATTISGARH,2007,Total Self-employed,4,557,716,491,241,2009,9,182,165,107,29,492,2501
GOA,2007,House Wife,0,0,0,0,0,0,0,24,20,11,4,59,59
GOA,2007,Service (Government),0,0,2,1,0,3,0,0,1,2,0,3,6
GOA,2007,Service (Private),0,19,23,11,2,55,0,7,1,1,0,9,64
GOA,2007,Public Sector Undertaking,0,0,0,0,0,0,0,0,0,0,0,0,0
GOA,2007,Student,1,10,3,0,0,14,1,3,0,0,0,4,18
GOA,2007,Unemployed,0,16,29,15,7,67,0,12,2,0,0,14,81
GOA,2007,Self-employed (Business activity),0,3,7,4,2,16,0,0,0,0,0,0,16
GOA,2007,Professional Activity,0,1,0,0,0,1,0,0,0,0,0,0,1
GOA,2007,Farming/Agriculture Activity,0,0,0,0,0,0,0,0,0,0,0,0,0
GOA,2007,Others (Please Specify),0,2,1,0,1,4,0,0,0,0,0,0,4
GOA,2007,Retired Person,0,0,0,4,6,10,0,0,0,0,0,0,10
GOA,2007,Others (Please Specify),0,3,4,1,0,8,1,1,1,0,0,3,11
GOA,2007,Total,1,54,69,36,18,178,2,47,25,14,4,92,270
GOA,2007,Total Salaried,0,19,25,12,2,58,0,7,2,3,0,12,70
GOA,2007,Total Self-employed,0,6,8,4,3,21,0,0,0,0,0,0,21
GUJARAT,2007,House Wife,0,0,0,0,0,0,2,729,540,235,107,1613,1613
GUJARAT,2007,Service (Government),0,29,37,19,0,85,0,8,7,4,1,20,105
GUJARAT,2007,Service (Private),0,190,215,105,6,516,1,26,19,8,1,55,571
GUJARAT,2007,Public Sector Undertaking,0,37,59,42,2,140,0,7,7,1,0,15,155
GUJARAT,2007,Student,23,123,6,3,0,155,26,102,17,3,0,148,303
GUJARAT,2007,Unemployed,1,179,182,73,8,443,1,23,22,9,2,57,500
GUJARAT,2007,Self-employed (Business activity),0,69,110,80,11,270,0,4,2,0,0,6,276
GUJARAT,2007,Professional Activity,0,179,173,79,23,454,0,16,15,5,1,37,491
GUJARAT,2007,Farming/Agriculture Activity,0,60,128,81,20,289,0,12,8,5,3,28,317
GUJARAT,2007,Others (Please Specify),2,195,232,101,24,554,0,48,26,11,7,92,646
GUJARAT,2007,Retired Person,0,20,23,34,98,175,0,7,0,14,28,49,224
GUJARAT,2007,Others (Please Specify),7,108,101,56,22,294,5,30,25,16,9,85,379
GUJARAT,2007,Total,33,1189,1266,673,214,3375,35,1012,688,311,159,2205,5580
GUJARAT,2007,Total Salaried,0,256,311,166,8,741,1,41,33,13,2,90,831
GUJARAT,2007,Total Self-employed,2,503,643,341,78,1567,0,80,51,21,11,163,1730
HARYANA,2007,House Wife,0,0,0,0,0,0,0,193,110,37,16,356,356
HARYANA,2007,Service (Government),0,18,25,20,1,64,0,12,3,0,0,15,79
HARYANA,2007,Service (Private),0,99,95,28,2,224,0,18,4,0,0,22,246
HARYANA,2007,Public Sector Undertaking,0,29,42,4,0,75,0,5,6,1,0,12,87
HARYANA,2007,Student,8,68,4,0,0,80,4,34,3,1,0,42,122
HARYANA,2007,Unemployed,2,111,108,32,6,259,0,5,12,6,0,23,282
HARYANA,2007,Self-employed (Business activity),0,24,30,23,9,86,0,0,1,1,0,2,88
HARYANA,2007,Professional Activity,0,5,23,29,0,57,0,0,0,0,0,0,57
HARYANA,2007,Farming/Agriculture Activity,0,68,63,37,11,179,0,0,0,0,0,0,179
HARYANA,2007,Others (Please Specify),1,50,37,24,9,121,1,10,23,6,2,42,163
HARYANA,2007,Retired Person,0,13,26,16,18,73,0,1,0,0,1,2,75
HARYANA,2007,Others (Please Specify),17,175,267,127,48,634,3,35,10,13,4,65,699
HARYANA,2007,Total,28,660,720,340,104,1852,8,313,172,65,23,581,2433
HARYANA,2007,Total Salaried,0,146,162,52,3,363,0,35,13,1,0,49,412
HARYANA,2007,Total Self-employed,1,147,153,113,29,443,1,10,24,7,2,44,487
HIMACHAL PRADESH,2007,House Wife,0,0,0,0,0,0,0,31,16,5,4,56,56
HIMACHAL PRADESH,2007,Service (Government),0,2,7,2,0,11,0,0,0,0,0,0,11
HIMACHAL PRADESH,2007,Service (Private),0,18,21,6,1,46,0,1,2,1,0,4,50
HIMACHAL PRADESH,2007,Public Sector Undertaking,0,4,3,4,1,12,0,1,2,0,0,3,15
HIMACHAL PRADESH,2007,Student,2,11,0,0,0,13,0,20,2,0,0,22,35
HIMACHAL PRADESH,2007,Unemployed,0,12,7,3,1,23,0,2,2,0,0,4,27
HIMACHAL PRADESH,2007,Self-employed (Business activity),0,6,10,7,2,25,0,1,2,0,0,3,28
HIMACHAL PRADESH,2007,Professional Activity,0,2,4,1,1,8,0,0,1,1,0,2,10
HIMACHAL PRADESH,2007,Farming/Agriculture Activity,0,0,11,3,0,14,0,0,1,0,0,1,15
HIMACHAL PRADESH,2007,Others (Please Specify),0,20,17,9,20,66,0,5,7,3,8,23,89
HIMACHAL PRADESH,2007,Retired Person,0,0,0,0,1,1,0,0,0,0,0,0,1
HIMACHAL PRADESH,2007,Others (Please Specify),0,17,18,3,1,39,0,11,11,1,3,26,65
HIMACHAL PRADESH,2007,Total,2,92,98,38,28,258,0,72,46,11,15,144,402
HIMACHAL PRADESH,2007,Total Salaried,0,24,31,12,2,69,0,2,4,1,0,7,76
HIMACHAL PRADESH,2007,Total Self-employed,0,28,42,20,23,113,0,6,11,4,8,29,142
JAMMU & KASHMIR,2007,House Wife,0,0,0,0,0,0,0,26,21,4,2,53,53
JAMMU & KASHMIR,2007,Service (Government),0,5,6,1,0,12,0,1,1,0,0,2,14
JAMMU & KASHMIR,2007,Service (Private),0,2,5,3,0,10,0,1,0,0,0,1,11
JAMMU & KASHMIR,2007,Public Sector Undertaking,0,4,1,0,0,5,0,2,0,0,0,2,7
JAMMU & KASHMIR,2007,Student,0,13,1,0,0,14,0,10,0,0,0,10,24
JAMMU & KASHMIR,2007,Unemployed,0,16,5,4,0,25,0,3,0,0,0,3,28
JAMMU & KASHMIR,2007,Self-employed (Business activity),0,1,1,1,0,3,0,0,0,0,0,0,3
JAMMU & KASHMIR,2007,Professional Activity,0,2,1,0,0,3,0,0,0,0,0,0,3
JAMMU & KASHMIR,2007,Farming/Agriculture Activity,0,9,10,9,3,31,0,1,1,0,0,2,33
JAMMU & KASHMIR,2007,Others (Please Specify),0,4,11,0,1,16,0,1,0,0,0,1,17
JAMMU & KASHMIR,2007,Retired Person,0,0,1,1,2,4,0,0,0,0,0,0,4
JAMMU & KASHMIR,2007,Others (Please Specify),0,9,15,4,2,30,0,6,1,0,0,7,37
JAMMU & KASHMIR,2007,Total,0,65,57,23,8,153,0,51,24,4,2,81,234
JAMMU & KASHMIR,2007,Total Salaried,0,11,12,4,0,27,0,4,1,0,0,5,32
JAMMU & KASHMIR,2007,Total Self-employed,0,16,23,10,4,53,0,2,1,0,0,3,56
JHARKHAND,2007,House Wife,0,0,0,0,0,0,3,87,77,30,8,205,205
JHARKHAND,2007,Service (Government),0,6,5,6,2,19,0,0,0,1,0,1,20
JHARKHAND,2007,Service (Private),4,28,36,9,3,80,0,0,4,0,0,4,84
JHARKHAND,2007,Public Sector Undertaking,0,0,0,0,0,0,0,0,0,0,0,0,0
JHARKHAND,2007,Student,24,33,10,0,0,67,10,23,2,0,0,35,102
JHARKHAND,2007,Unemployed,0,40,26,12,1,79,0,8,8,0,0,16,95
JHARKHAND,2007,Self-employed (Business activity),1,15,19,14,0,49,0,0,3,1,0,4,53
JHARKHAND,2007,Professional Activity,0,2,27,10,1,40,0,0,2,0,0,2,42
JHARKHAND,2007,Farming/Agriculture Activity,0,28,40,28,5,101,1,7,3,1,0,12,113
JHARKHAND,2007,Others (Please Specify),0,22,24,21,5,72,1,22,18,6,2,49,121
JHARKHAND,2007,Retired Person,0,0,1,0,18,19,0,0,0,0,0,0,19
JHARKHAND,2007,Others (Please Specify),17,87,128,97,25,354,7,31,18,15,10,81,435
JHARKHAND,2007,Total,46,261,316,197,60,880,22,178,135,54,20,409,1289
JHARKHAND,2007,Total Salaried,4,34,41,15,5,99,0,0,4,1,0,5,104
JHARKHAND,2007,Total Self-employed,1,67,110,73,11,262,2,29,26,8,2,67,329
KARNATAKA,2007,House Wife,0,0,0,0,0,0,1,656,611,382,152,1802,1802
KARNATAKA,2007,Service (Government),0,58,53,67,1,179,0,11,9,5,3,28,207
KARNATAKA,2007,Service (Private),0,273,332,248,49,902,1,114,36,18,5,174,1076
KARNATAKA,2007,Public Sector Undertaking,0,54,68,36,18,176,0,9,9,9,0,27,203
KARNATAKA,2007,Student,51,177,18,0,0,246,58,193,10,0,0,261,507
KARNATAKA,2007,Unemployed,0,137,185,106,22,450,6,63,21,11,1,102,552
KARNATAKA,2007,Self-employed (Business activity),0,102,176,123,20,421,0,26,24,11,2,63,484
KARNATAKA,2007,Professional Activity,0,37,82,58,10,187,0,3,4,0,0,7,194
KARNATAKA,2007,Farming/Agriculture Activity,0,311,655,595,211,1772,7,112,125,91,28,363,2135
KARNATAKA,2007,Others (Please Specify),18,514,763,670,168,2133,16,158,220,133,14,541,2674
KARNATAKA,2007,Retired Person,0,0,1,10,36,47,0,0,0,0,4,4,51
KARNATAKA,2007,Others (Please Specify),40,491,651,506,191,1879,38,178,166,93,65,540,2419
KARNATAKA,2007,Total,109,2154,2984,2419,726,8392,127,1523,1235,753,274,3912,12304
KARNATAKA,2007,Total Salaried,0,385,453,351,68,1257,1,134,54,32,8,229,1486
KARNATAKA,2007,Total Self-employed,18,964,1676,1446,409,4513,23,299,373,235,44,974,5487
KERALA,2007,House Wife,0,0,0,0,0,0,0,289,394,433,210,1326,1326
KERALA,2007,Service (Government),0,2,34,52,0,88,0,0,5,6,0,11,99
KERALA,2007,Service (Private),0,34,209,135,12,390,0,21,33,24,0,78,468
KERALA,2007,Public Sector Undertaking,0,3,32,50,6,91,0,2,5,6,0,13,104
KERALA,2007,Student,33,82,0,0,0,115,34,124,2,0,0,160,275
KERALA,2007,Unemployed,0,209,325,135,3,672,0,72,66,28,8,174,846
KERALA,2007,Self-employed (Business activity),0,51,136,200,39,426,0,0,1,6,0,7,433
KERALA,2007,Professional Activity,0,38,79,69,8,194,0,4,3,4,1,12,206
KERALA,2007,Farming/Agriculture Activity,0,102,290,508,258,1158,0,13,21,25,15,74,1232
KERALA,2007,Others (Please Specify),0,396,662,677,413,2148,4,65,95,76,85,325,2473
KERALA,2007,Retired Person,0,0,0,20,68,88,0,0,0,0,6,6,94
KERALA,2007,Others (Please Specify),15,180,302,427,294,1218,5,20,56,39,68,188,1406
KERALA,2007,Total,48,1097,2069,2273,1101,6588,43,610,681,647,393,2374,8962
KERALA,2007,Total Salaried,0,39,275,237,18,569,0,23,43,36,0,102,671
KERALA,2007,Total Self-employed,0,587,1167,1454,718,3926,4,82,120,111,101,418,4344
MADHYA PRADESH,2007,House Wife,0,0,0,0,0,0,17,1128,511,165,86,1907,1907
MADHYA PRADESH,2007,Service (Government),0,20,18,31,1,70,0,8,6,1,2,17,87
MADHYA PRADESH,2007,Service (Private),11,63,53,35,7,169,1,45,25,8,1,80,249
MADHYA PRADESH,2007,Public Sector Undertaking,0,65,47,26,1,139,1,44,11,9,0,65,204
MADHYA PRADESH,2007,Student,34,155,2,0,0,191,32,98,0,1,4,135,326
MADHYA PRADESH,2007,Unemployed,2,124,81,37,14,258,0,21,7,0,0,28,286
MADHYA PRADESH,2007,Self-employed (Business activity),0,110,116,73,13,312,0,33,17,2,1,53,365
MADHYA PRADESH,2007,Professional Activity,0,75,62,33,12,182,0,11,1,0,0,12,194
MADHYA PRADESH,2007,Farming/Agriculture Activity,26,335,376,223,105,1065,8,104,67,15,4,198,1263
MADHYA PRADESH,2007,Others (Please Specify),3,242,217,129,66,657,35,128,55,13,14,245,902
MADHYA PRADESH,2007,Retired Person,0,2,9,5,4,20,2,0,0,0,0,2,22
MADHYA PRADESH,2007,Others (Please Specify),17,122,145,84,39,407,16,53,26,15,7,117,524
MADHYA PRADESH,2007,Total,93,1313,1126,676,262,3470,112,1673,726,229,119,2859,6329
MADHYA PRADESH,2007,Total Salaried,11,148,118,92,9,378,2,97,42,18,3,162,540
MADHYA PRADESH,2007,Total Self-employed,29,762,771,458,196,2216,43,276,140,30,19,508,2724
MAHARASHTRA,2007,House Wife,0,0,0,0,0,0,4,1880,1031,410,238,3563,3563
MAHARASHTRA,2007,Service (Government),0,41,90,78,2,211,0,11,3,1,0,15,226
MAHARASHTRA,2007,Service (Private),0,444,616,356,36,1452,0,80,47,11,0,138,1590
MAHARASHTRA,2007,Public Sector Undertaking,0,31,44,37,3,115,0,11,4,5,0,20,135
MAHARASHTRA,2007,Student,41,355,8,0,0,404,69,319,1,0,0,389,793
MAHARASHTRA,2007,Unemployed,0,429,355,162,32,978,0,51,7,2,1,61,1039
MAHARASHTRA,2007,Self-employed (Business activity),0,108,194,104,28,434,0,3,6,1,0,10,444
MAHARASHTRA,2007,Professional Activity,0,168,291,165,57,681,0,27,18,12,9,66,747
MAHARASHTRA,2007,Farming/Agriculture Activity,0,908,1498,1038,524,3968,0,131,73,37,29,270,4238
MAHARASHTRA,2007,Others (Please Specify),0,533,797,453,216,1999,1,103,63,32,12,211,2210
MAHARASHTRA,2007,Retired Person,0,0,1,27,118,146,0,0,7,3,7,17,163
MAHARASHTRA,2007,Others (Please Specify),1,5,14,5,7,32,0,2,1,1,0,4,36
MAHARASHTRA,2007,Total,42,3022,3908,2425,1023,10420,74,2618,1261,515,296,4764,15184
MAHARASHTRA,2007,Total Salaried,0,516,750,471,41,1778,0,102,54,17,0,173,1951
MAHARASHTRA,2007,Total Self-employed,0,1717,2780,1760,825,7082,1,264,160,82,50,557,7639
MANIPUR,2007,House Wife,0,0,0,0,0,0,0,3,5,1,0,9,9
MANIPUR,2007,Service (Government),0,0,8,2,0,10,0,0,0,0,0,0,10
MANIPUR,2007,Service (Private),0,0,0,0,0,0,0,0,0,0,0,0,0
MANIPUR,2007,Public Sector Undertaking,0,0,0,0,0,0,0,0,0,0,0,0,0
MANIPUR,2007,Student,1,4,0,0,0,5,0,1,0,0,0,1,6
MANIPUR,2007,Unemployed,0,2,6,1,0,9,0,0,1,0,0,1,10
MANIPUR,2007,Self-employed (Business activity),0,0,0,0,0,0,0,0,0,0,0,0,0
MANIPUR,2007,Professional Activity,0,0,0,0,0,0,0,0,0,0,0,0,0
MANIPUR,2007,Farming/Agriculture Activity,0,0,0,0,0,0,0,0,0,0,0,0,0
MANIPUR,2007,Others (Please Specify),0,0,2,0,0,2,0,0,0,0,0,0,2
MANIPUR,2007,Retired Person,0,0,0,0,0,0,0,0,0,0,0,0,0
MANIPUR,2007,Others (Please Specify),0,1,1,0,0,2,0,0,0,0,0,0,2
MANIPUR,2007,Total,1,7,17,3,0,28,0,4,6,1,0,11,39
MANIPUR,2007,Total Salaried,0,0,8,2,0,10,0,0,0,0,0,0,10
MANIPUR,2007,Total Self-employed,0,0,2,0,0,2,0,0,0,0,0,0,2
MEGHALAYA,2007,House Wife,0,0,0,0,0,0,0,2,4,0,0,6,6
MEGHALAYA,2007,Service (Government),0,3,2,1,0,6,0,1,0,0,0,1,7
MEGHALAYA,2007,Service (Private),0,0,0,0,0,0,0,0,0,0,0,0,0
MEGHALAYA,2007,Public Sector Undertaking,0,0,0,1,0,1,0,0,0,0,0,0,1
MEGHALAYA,2007,Student,1,9,0,0,0,10,0,5,2,0,0,7,17
MEGHALAYA,2007,Unemployed,0,3,6,0,1,10,0,2,0,0,0,2,12
MEGHALAYA,2007,Self-employed (Business activity),0,4,4,1,0,9,0,0,0,0,0,0,9
MEGHALAYA,2007,Professional Activity,0,0,0,0,0,0,0,0,0,0,0,0,0
MEGHALAYA,2007,Farming/Agriculture Activity,0,7,4,1,2,14,0,2,2,0,0,4,18
MEGHALAYA,2007,Others (Please Specify),0,0,3,3,0,6,0,0,1,0,0,1,7
MEGHALAYA,2007,Retired Person,0,0,0,0,0,0,0,0,0,0,0,0,0
MEGHALAYA,2007,Others (Please Specify),0,2,2,0,0,4,0,3,3,0,0,6,10
MEGHALAYA,2007,Total,1,28,21,7,3,60,0,15,12,0,0,27,87
MEGHALAYA,2007,Total Salaried,0,3,2,2,0,7,0,1,0,0,0,1,8
MEGHALAYA,2007,Total Self-employed,0,11,11,5,2,29,0,2,3,0,0,5,34
MIZORAM,2007,House Wife,0,0,0,0,0,0,0,0,1,2,0,3,3
MIZORAM,2007,Service (Government),0,0,0,0,0,0,0,0,0,0,0,0,0
MIZORAM,2007,Service (Private),0,0,0,0,0,0,0,0,0,0,0,0,0
MIZORAM,2007,Public Sector Undertaking,0,0,0,0,0,0,0,0,0,0,0,0,0
MIZORAM,2007,Student,0,0,0,0,0,0,0,0,0,0,0,0,0
MIZORAM,2007,Unemployed,0,0,0,0,0,0,0,0,0,0,0,0,0
MIZORAM,2007,Self-employed (Business activity),0,0,0,0,0,0,0,0,0,0,0,0,0
MIZORAM,2007,Professional Activity,0,0,0,0,0,0,0,0,0,0,0,0,0
MIZORAM,2007,Farming/Agriculture Activity,0,0,0,0,0,0,0,0,0,0,0,0,0
MIZORAM,2007,Others (Please Specify),0,0,0,0,0,0,0,0,0,0,0,0,0
MIZORAM,2007,Retired Person,0,0,0,0,0,0,0,0,0,0,0,0,0
MIZORAM,2007,Others (Please Specify),1,9,8,2,2,22,0,1,2,0,0,3,25
MIZORAM,2007,Total,1,9,8,2,2,22,0,1,3,2,0,6,28
MIZORAM,2007,Total Salaried,0,0,0,0,0,0,0,0,0,0,0,0,0
MIZORAM,2007,Total Self-employed,0,0,0,0,0,0,0,0,0,0,0,0,0
NAGALAND,2007,House Wife,0,0,0,0,0,0,0,1,4,0,0,5,5
NAGALAND,2007,Service (Government),0,1,0,4,0,5,0,0,0,0,0,0,5
NAGALAND,2007,Service (Private),0,0,0,0,0,0,0,0,0,0,0,0,0
NAGALAND,2007,Public Sector Undertaking,0,0,0,0,0,0,0,0,0,0,0,0,0
NAGALAND,2007,Student,0,0,0,0,0,0,0,0,0,0,0,0,0
NAGALAND,2007,Unemployed,0,0,2,0,0,2,0,0,0,0,0,0,2
NAGALAND,2007,Self-employed (Business activity),0,0,0,0,0,0,0,0,0,0,0,0,0
NAGALAND,2007,Professional Activity,0,0,0,0,0,0,0,0,0,0,0,0,0
NAGALAND,2007,Farming/Agriculture Activity,0,0,0,0,0,0,0,0,0,0,0,0,0
NAGALAND,2007,Others (Please Specify),0,1,3,0,0,4,0,1,0,0,0,1,5
NAGALAND,2007,Retired Person,0,0,0,0,0,0,0,0,0,0,0,0,0
NAGALAND,2007,Others (Please Specify),0,2,3,1,0,6,0,1,0,0,0,1,7
NAGALAND,2007,Total,0,4,8,5,0,17,0,3,4,0,0,7,24
NAGALAND,2007,Total Salaried,0,1,0,4,0,5,0,0,0,0,0,0,5
NAGALAND,2007,Total Self-employed,0,1,3,0,0,4,0,1,0,0,0,1,5
ODISHA,2007,House Wife,0,0,0,0,0,0,0,322,212,66,14,614,614
ODISHA,2007,Service (Government),0,6,8,12,0,26,0,1,5,0,0,6,32
ODISHA,2007,Service (Private),0,82,82,48,2,214,0,26,31,29,3,89,303
ODISHA,2007,Public Sector Undertaking,0,34,48,26,4,112,0,17,3,8,0,28,140
ODISHA,2007,Student,26,109,0,0,0,135,24,75,0,0,0,99,234
ODISHA,2007,Unemployed,12,98,62,40,12,224,5,93,73,5,1,177,401
ODISHA,2007,Self-employed (Business activity),0,75,161,77,23,336,0,6,4,2,0,12,348
ODISHA,2007,Professional Activity,0,29,29,21,3,82,0,6,16,3,0,25,107
ODISHA,2007,Farming/Agriculture Activity,2,42,61,48,17,170,3,17,21,16,13,70,240
ODISHA,2007,Others (Please Specify),26,209,226,142,81,684,30,201,97,46,18,392,1076
ODISHA,2007,Retired Person,0,0,0,6,25,31,0,0,0,0,5,5,36
ODISHA,2007,Others (Please Specify),11,92,171,121,79,474,8,114,94,68,19,303,777
ODISHA,2007,Total,77,776,848,541,246,2488,70,878,556,243,73,1820,4308
ODISHA,2007,Total Salaried,0,122,138,86,6,352,0,44,39,37,3,123,475
ODISHA,2007,Total Self-employed,28,355,477,288,124,1272,33,230,138,67,31,499,1771
PUNJAB,2007,House Wife,0,0,0,0,0,0,0,62,53,13,4,132,132
PUNJAB,2007,Service (Government),0,9,9,9,0,27,0,1,1,1,0,3,30
PUNJAB,2007,Service (Private),0,22,28,13,0,63,0,3,0,0,0,3,66
PUNJAB,2007,Public Sector Undertaking,0,0,0,0,0,0,0,0,0,0,0,0,0
PUNJAB,2007,Student,2,12,1,0,0,15,6,9,0,0,0,15,30
PUNJAB,2007,Unemployed,0,22,7,7,6,42,0,7,2,0,0,9,51
PUNJAB,2007,Self-employed (Business activity),0,9,17,12,4,42,0,0,0,0,0,0,42
PUNJAB,2007,Professional Activity,0,9,9,4,1,23,0,1,0,0,0,1,24
PUNJAB,2007,Farming/Agriculture Activity,0,21,32,19,14,86,0,0,1,1,0,2,88
PUNJAB,2007,Others (Please Specify),0,68,53,32,17,170,2,12,0,0,0,14,184
PUNJAB,2007,Retired Person,0,0,0,4,2,6,0,0,0,0,0,0,6
PUNJAB,2007,Others (Please Specify),3,64,60,17,14,158,5,17,12,2,0,36,194
PUNJAB,2007,Total,5,236,216,117,58,632,13,112,69,17,4,215,847
PUNJAB,2007,Total Salaried,0,31,37,22,0,90,0,4,1,1,0,6,96
PUNJAB,2007,Total Self-employed,0,107,111,67,36,321,2,13,1,1,0,17,338
RAJASTHAN,2007,House Wife,0,0,0,0,0,0,9,398,410,177,29,1023,1023
RAJASTHAN,2007,Service (Government),0,5,22,12,0,39,0,10,17,1,1,29,68
RAJASTHAN,2007,Service (Private),6,102,150,82,1,341,0,9,1,0,0,10,351
RAJASTHAN,2007,Public Sector Undertaking,0,11,7,6,0,24,0,5,0,0,0,5,29
RAJASTHAN,2007,Student,28,86,1,0,0,115,13,47,10,0,0,70,185
RAJASTHAN,2007,Unemployed,1,48,86,20,2,157,0,1,2,2,0,5,162
RAJASTHAN,2007,Self-employed (Business activity),0,72,120,84,3,279,0,0,0,0,0,0,279
RAJASTHAN,2007,Professional Activity,0,18,16,2,0,36,0,0,3,0,0,3,39
RAJASTHAN,2007,Farming/Agriculture Activity,2,153,229,176,29,589,0,9,9,10,1,29,618
RAJASTHAN,2007,Others (Please Specify),5,254,334,128,36,757,0,25,9,7,0,41,798
RAJASTHAN,2007,Retired Person,0,0,0,0,0,0,0,0,0,0,0,0,0
RAJASTHAN,2007,Others (Please Specify),36,314,216,195,56,817,14,40,5,5,4,68,885
RAJASTHAN,2007,Total,78,1063,1181,705,127,3154,36,544,466,202,35,1283,4437
RAJASTHAN,2007,Total Salaried,6,118,179,100,1,404,0,24,18,1,1,44,448
RAJASTHAN,2007,Total Self-employed,7,497,699,390,68,1661,0,34,21,17,1,73,1734
SIKKIM,2007,House Wife,0,0,0,0,0,0,0,6,0,0,0,6,6
SIKKIM,2007,Service (Government),0,0,0,0,0,0,0,0,0,0,0,0,0
SIKKIM,2007,Service (Private),0,3,3,3,0,9,0,3,0,0,0,3,12
SIKKIM,2007,Public Sector Undertaking,0,0,0,0,0,0,0,1,0,0,0,1,1
SIKKIM,2007,Student,2,3,0,0,0,5,0,0,0,0,0,0,5
SIKKIM,2007,Unemployed,0,9,0,0,0,9,0,2,0,0,0,2,11
SIKKIM,2007,Self-employed (Business activity),0,0,0,0,0,0,0,0,0,0,0,0,0
SIKKIM,2007,Professional Activity,0,0,0,0,0,0,0,0,0,0,0,0,0
SIKKIM,2007,Farming/Agriculture Activity,0,0,8,7,0,15,0,2,4,0,0,6,21
SIKKIM,2007,Others (Please Specify),3,18,5,2,2,30,1,3,0,3,0,7,37
SIKKIM,2007,Retired Person,0,0,0,0,0,0,0,0,0,0,0,0,0
SIKKIM,2007,Others (Please Specify),0,8,8,0,0,16,6,2,4,1,0,13,29
SIKKIM,2007,Total,5,41,24,12,2,84,7,19,8,4,0,38,122
SIKKIM,2007,Total Salaried,0,3,3,3,0,9,0,4,0,0,0,4,13
SIKKIM,2007,Total Self-employed,3,18,13,9,2,45,1,5,4,3,0,13,58
TAMIL NADU,2007,House Wife,0,0,0,0,0,0,0,873,996,474,133,2476,2476
TAMIL NADU,2007,Service (Government),0,23,103,52,1,179,0,10,9,8,5,32,211
TAMIL NADU,2007,Service (Private),0,323,519,337,84,1263,0,486,106,61,7,660,1923
TAMIL NADU,2007,Public Sector Undertaking,0,57,124,69,33,283,0,19,11,59,1,90,373
TAMIL NADU,2007,Student,30,76,6,1,2,115,38,89,7,0,0,134,249
TAMIL NADU,2007,Unemployed,0,421,134,197,111,863,0,253,128,90,35,506,1369
TAMIL NADU,2007,Self-employed (Business activity),0,156,901,201,35,1293,0,9,80,3,0,92,1385
TAMIL NADU,2007,Professional Activity,0,0,0,0,0,0,0,0,0,0,0,0,0
TAMIL NADU,2007,Farming/Agriculture Activity,0,90,170,95,41,396,0,25,42,19,2,88,484
TAMIL NADU,2007,Others (Please Specify),0,876,810,951,325,2962,0,235,189,113,74,611,3573
TAMIL NADU,2007,Retired Person,0,0,0,12,89,101,0,0,0,0,16,16,117
TAMIL NADU,2007,Others (Please Specify),0,289,470,322,151,1232,45,103,134,91,46,419,1651
TAMIL NADU,2007,Total,30,2311,3237,2237,872,8687,83,2102,1702,918,319,5124,13811
TAMIL NADU,2007,Total Salaried,0,403,746,458,118,1725,0,515,126,128,13,782,2507
TAMIL NADU,2007,Total Self-employed,0,1122,1881,1247,401,4651,0,269,311,135,76,791,5442
TRIPURA,2007,House Wife,0,0,0,0,0,0,0,49,31,9,4,93,93
TRIPURA,2007,Service (Government),0,3,23,2,0,28,0,3,2,0,0,5,33
TRIPURA,2007,Service (Private),0,2,6,0,0,8,0,0,0,0,0,0,8
TRIPURA,2007,Public Sector Undertaking,0,0,0,0,0,0,0,0,0,0,0,0,0
TRIPURA,2007,Student,14,22,0,0,0,36,16,18,0,0,0,34,70
TRIPURA,2007,Unemployed,0,12,20,9,0,41,0,2,1,0,0,3,44
TRIPURA,2007,Self-employed (Business activity),0,14,28,18,3,63,0,0,0,0,0,0,63
TRIPURA,2007,Professional Activity,0,0,0,0,0,0,0,0,0,0,0,0,0
TRIPURA,2007,Farming/Agriculture Activity,0,0,0,0,0,0,0,0,0,0,0,0,0
TRIPURA,2007,Others (Please Specify),8,58,43,51,7,167,0,30,44,26,1,101,268
TRIPURA,2007,Retired Person,0,1,0,1,0,2,0,0,0,0,0,0,2
TRIPURA,2007,Others (Please Specify),4,36,21,13,0,74,6,14,22,6,2,50,124
TRIPURA,2007,Total,26,148,141,94,10,419,22,116,100,41,7,286,705
TRIPURA,2007,Total Salaried,0,5,29,2,0,36,0,3,2,0,0,5,41
TRIPURA,2007,Total Self-employed,8,72,71,69,10,230,0,30,44,26,1,101,331
UTTAR PRADESH,2007,House Wife,0,0,0,0,0,0,10,560,312,67,25,974,974
UTTAR PRADESH,2007,Service (Government),0,15,15,9,0,39,0,6,4,1,3,14,53
UTTAR PRADESH,2007,Service (Private),3,72,83,28,5,191,0,26,12,4,1,43,234
UTTAR PRADESH,2007,Public Sector Undertaking,0,10,11,9,3,33,1,8,4,0,0,13,46
UTTAR PRADESH,2007,Student,18,123,7,0,0,148,20,96,8,0,2,126,274
UTTAR PRADESH,2007,Unemployed,5,129,122,49,12,317,1,34,8,2,5,50,367
UTTAR PRADESH,2007,Self-employed (Business activity),0,38,47,46,5,136,0,12,5,0,2,19,155
UTTAR PRADESH,2007,Professional Activity,1,17,31,26,14,89,2,9,0,2,0,13,102
UTTAR PRADESH,2007,Farming/Agriculture Activity,3,84,125,123,54,389,5,29,27,20,16,97,486
UTTAR PRADESH,2007,Others (Please Specify),10,161,132,135,75,513,15,163,109,23,26,336,849
UTTAR PRADESH,2007,Retired Person,0,0,0,2,3,5,0,0,0,0,1,1,6
UTTAR PRADESH,2007,Others (Please Specify),10,46,55,38,45,194,15,47,68,37,20,187,381
UTTAR PRADESH,2007,Total,50,695,628,465,216,2054,69,990,557,156,101,1873,3927
UTTAR PRADESH,2007,Total Salaried,3,97,109,46,8,263,1,40,20,5,4,70,333
UTTAR PRADESH,2007,Total Self-employed,14,300,335,330,148,1127,22,213,141,45,44,465,1592
UTTARAKHAND,2007,House Wife,0,0,0,0,0,0,0,40,19,6,2,67,67
UTTARAKHAND,2007,Service (Government),0,1,4,0,0,5,0,2,0,0,0,2,7
UTTARAKHAND,2007,Service (Private),0,8,14,4,0,26,0,3,2,0,0,5,31
UTTARAKHAND,2007,Public Sector Undertaking,0,2,10,1,0,13,0,3,3,0,0,6,19
UTTARAKHAND,2007,Student,1,5,2,0,0,8,3,4,0,0,0,7,15
UTTARAKHAND,2007,Unemployed,1,8,8,3,0,20,1,2,3,0,0,6,26
UTTARAKHAND,2007,Self-employed (Business activity),0,6,4,0,0,10,0,0,2,0,0,2,12
UTTARAKHAND,2007,Professional Activity,0,0,3,1,0,4,0,1,0,0,0,1,5
UTTARAKHAND,2007,Farming/Agriculture Activity,0,7,9,2,0,18,0,6,2,2,0,10,28
UTTARAKHAND,2007,Others (Please Specify),0,5,1,2,0,8,2,2,1,0,0,5,13
UTTARAKHAND,2007,Retired Person,0,0,0,0,0,0,0,0,0,0,0,0,0
UTTARAKHAND,2007,Others (Please Specify),0,11,5,1,1,18,2,0,3,0,2,7,25
UTTARAKHAND,2007,Total,2,53,60,14,1,130,8,63,35,8,4,118,248
UTTARAKHAND,2007,Total Salaried,0,11,28,5,0,44,0,8,5,0,0,13,57
UTTARAKHAND,2007,Total Self-employed,0,18,17,5,0,40,2,9,5,2,0,18,58
WEST BENGAL,2007,House Wife,0,0,0,0,0,0,0,1541,1296,451,74,3362,3362
WEST BENGAL,2007,Service (Government),0,23,48,43,2,116,0,3,8,13,0,24,140
WEST BENGAL,2007,Service (Private),0,136,225,207,11,579,0,23,63,17,0,103,682
WEST BENGAL,2007,Public Sector Undertaking,0,130,327,192,6,655,0,42,24,18,0,84,739
WEST BENGAL,2007,Student,112,532,5,0,0,649,110,369,10,0,0,489,1138
WEST BENGAL,2007,Unemployed,3,321,348,129,4,805,10,137,183,32,0,362,1167
WEST BENGAL,2007,Self-employed (Business activity),0,312,506,316,24,1158,0,8,25,6,0,39,1197
WEST BENGAL,2007,Professional Activity,0,22,118,122,1,263,0,2,1,0,0,3,266
WEST BENGAL,2007,Farming/Agriculture Activity,5,188,432,185,68,878,0,68,98,40,18,224,1102
WEST BENGAL,2007,Others (Please Specify),61,562,824,449,183,2079,38,249,289,258,50,884,2963
WEST BENGAL,2007,Retired Person,0,0,0,0,95,95,0,0,0,0,16,16,111
WEST BENGAL,2007,Others (Please Specify),36,420,373,297,102,1228,44,288,181,178,74,765,1993
WEST BENGAL,2007,Total,217,2646,3206,1940,496,8505,202,2730,2178,1013,232,6355,14860
WEST BENGAL,2007,Total Salaried,0,289,600,442,19,1350,0,68,95,48,0,211,1561
WEST BENGAL,2007,Total Self-employed,66,1084,1880,1072,276,4378,38,327,413,304,68,1150,5528
TOTAL (STATES),2007,House Wife,0,0,0,0,0,0,49,10681,8050,3613,1342,23735,23735
TOTAL (STATES),2007,Service (Government),0,358,631,509,10,1508,1,115,105,53,15,289,1797
TOTAL (STATES),2007,Service (Private),30,2264,3313,2002,329,7938,6,950,503,258,67,1784,9722
TOTAL (STATES),2007,Public Sector Undertaking,0,542,990,584,83,2199,6,194,111,122,1,434,2633
TOTAL (STATES),2007,Student,591,2555,154,8,2,3310,621,2010,87,6,7,2731,6041
TOTAL (STATES),2007,Unemployed,28,2639,2319,1149,255,6390,32,860,574,190,53,1709,8099
TOTAL (STATES),2007,Self-employed (Business activity),1,1581,3209,1751,272,6814,1,156,204,57,6,424,7238
TOTAL (STATES),2007,Professional Activity,4,777,1228,782,191,2982,9,113,83,31,12,248,3230
TOTAL (STATES),2007,Farming/Agriculture Activity,46,3220,5366,3996,1644,14272,49,788,701,413,156,2107,16379
TOTAL (STATES),2007,Others (Please Specify),150,5313,6584,4939,2112,19098,191,1886,1533,934,404,4948,24046
TOTAL (STATES),2007,Retired Person,0,37,69,148,650,904,2,8,7,23,89,129,1033
TOTAL (STATES),2007,Others (Please Specify),317,3576,4117,2998,1376,12384,301,1420,1115,717,417,3970,16354
TOTAL (STATES),2007,Total,1167,22862,27980,18866,6924,77799,1268,19181,13073,6417,2569,42508,120307
TOTAL (STATES),2007,Total Salaried,30,3164,4934,3095,422,11645,13,1259,719,433,83,2507,14152
TOTAL (STATES),2007,Total Self-employed,201,10891,16387,11468,4219,43166,250,2943,2521,1435,578,7727,50893
A & N ISLANDS,2007,House Wife,0,0,0,0,0,0,0,10,10,8,2,30,30
A & N ISLANDS,2007,Service (Government),0,1,4,4,0,9,0,1,0,0,0,1,10
A & N ISLANDS,2007,Service (Private),0,17,12,8,2,39,0,1,0,0,0,1,40
A & N ISLANDS,2007,Public Sector Undertaking,0,0,0,0,0,0,0,0,0,0,0,0,0
A & N ISLANDS,2007,Student,0,4,0,0,0,4,4,9,0,0,0,13,17
A & N ISLANDS,2007,Unemployed,0,9,1,1,1,12,0,0,0,0,0,0,12
A & N ISLANDS,2007,Self-employed (Business activity),0,0,0,0,0,0,0,0,0,0,0,0,0
A & N ISLANDS,2007,Professional Activity,0,0,0,0,0,0,0,0,0,0,0,0,0
A & N ISLANDS,2007,Farming/Agriculture Activity,0,4,3,5,4,16,0,0,0,0,0,0,16
A & N ISLANDS,2007,Others (Please Specify),0,0,2,4,1,7,0,0,0,0,0,0,7
A & N ISLANDS,2007,Retired Person,0,0,0,1,2,3,0,0,0,0,0,0,3
A & N ISLANDS,2007,Others (Please Specify),0,1,4,4,1,10,2,9,0,0,0,11,21
A & N ISLANDS,2007,Total,0,36,26,27,11,100,6,30,10,8,2,56,156
A & N ISLANDS,2007,Total Salaried,0,18,16,12,2,48,0,2,0,0,0,2,50
A & N ISLANDS,2007,Total Self-employed,0,4,5,9,5,23,0,0,0,0,0,0,23
CHANDIGARH,2007,House Wife,0,0,0,0,0,0,0,10,8,1,2,21,21
CHANDIGARH,2007,Service (Government),0,0,3,1,0,4,0,1,0,0,0,1,5
CHANDIGARH,2007,Service (Private),0,3,10,4,0,17,0,0,0,0,0,0,17
CHANDIGARH,2007,Public Sector Undertaking,0,0,0,0,0,0,0,0,0,0,0,0,0
CHANDIGARH,2007,Student,2,13,0,0,0,15,0,0,0,0,0,0,15
CHANDIGARH,2007,Unemployed,0,6,2,2,0,10,0,0,0,0,0,0,10
CHANDIGARH,2007,Self-employed (Business activity),0,0,2,1,0,3,0,0,0,0,0,0,3
CHANDIGARH,2007,Professional Activity,0,0,0,0,0,0,0,0,0,0,0,0,0
CHANDIGARH,2007,Farming/Agriculture Activity,0,0,0,0,0,0,0,0,0,0,0,0,0
CHANDIGARH,2007,Others (Please Specify),0,2,3,0,0,5,0,0,0,0,0,0,5
CHANDIGARH,2007,Retired Person,0,0,0,0,2,2,0,0,0,0,0,0,2
CHANDIGARH,2007,Others (Please Specify),0,2,1,0,1,4,0,0,0,0,0,0,4
CHANDIGARH,2007,Total,2,26,21,8,3,60,0,11,8,1,2,22,82
CHANDIGARH,2007,Total Salaried,0,3,13,5,0,21,0,1,0,0,0,1,22
CHANDIGARH,2007,Total Self-employed,0,2,5,1,0,8,0,0,0,0,0,0,8
D & N HAVELI,2007,House Wife,0,0,0,0,0,0,0,15,8,4,1,28,28
D & N HAVELI,2007,Service (Government),0,0,0,0,0,0,0,0,0,0,0,0,0
D & N HAVELI,2007,Service (Private),0,4,4,0,0,8,0,0,0,0,0,0,8
D & N HAVELI,2007,Public Sector Undertaking,0,0,0,0,0,0,0,0,0,0,0,0,0
D & N HAVELI,2007,Student,0,3,0,0,0,3,0,4,0,0,0,4,7
D & N HAVELI,2007,Unemployed,0,2,3,2,0,7,0,0,0,0,0,0,7
D & N HAVELI,2007,Self-employed (Business activity),0,0,1,1,0,2,0,0,0,0,0,0,2
D & N HAVELI,2007,Professional Activity,0,0,0,0,0,0,0,0,0,0,0,0,0
D & N HAVELI,2007,Farming/Agriculture Activity,0,4,6,4,3,17,0,0,0,0,0,0,17
D & N HAVELI,2007,Others (Please Specify),0,0,0,0,0,0,0,0,0,0,0,0,0
D & N HAVELI,2007,Retired Person,0,0,0,0,5,5,0,0,0,0,0,0,5
D & N HAVELI,2007,Others (Please Specify),0,2,0,0,0,2,0,0,0,0,0,0,2
D & N HAVELI,2007,Total,0,15,14,7,8,44,0,19,8,4,1,32,76
D & N HAVELI,2007,Total Salaried,0,4,4,0,0,8,0,0,0,0,0,0,8
D & N HAVELI,2007,Total Self-employed,0,4,7,5,3,19,0,0,0,0,0,0,19
DAMAN & DIU,2007,House Wife,0,0,0,0,0,0,0,3,2,0,0,5,5
DAMAN & DIU,2007,Service (Government),0,0,0,2,0,2,0,0,0,0,0,0,2
DAMAN & DIU,2007,Service (Private),0,3,1,0,0,4,0,1,0,0,0,1,5
DAMAN & DIU,2007,Public Sector Undertaking,0,0,0,0,0,0,0,0,0,0,0,0,0
DAMAN & DIU,2007,Student,0,0,0,0,0,0,0,0,0,0,0,0,0
DAMAN & DIU,2007,Unemployed,0,0,0,0,0,0,0,0,0,0,0,0,0
DAMAN & DIU,2007,Self-employed (Business activity),0,0,0,0,0,0,0,0,0,0,0,0,0
DAMAN & DIU,2007,Professional Activity,0,0,0,0,0,0,0,0,0,0,0,0,0
DAMAN & DIU,2007,Farming/Agriculture Activity,0,0,0,0,0,0,0,0,0,0,0,0,0
DAMAN & DIU,2007,Others (Please Specify),0,0,0,0,0,0,0,0,0,0,0,0,0
DAMAN & DIU,2007,Retired Person,0,0,0,0,0,0,0,0,0,0,0,0,0
DAMAN & DIU,2007,Others (Please Specify),0,0,0,0,0,0,0,3,0,0,0,3,3
DAMAN & DIU,2007,Total,0,3,1,2,0,6,0,7,2,0,0,9,15
DAMAN & DIU,2007,Total Salaried,0,3,1,2,0,6,0,1,0,0,0,1,7
DAMAN & DIU,2007,Total Self-employed,0,0,0,0,0,0,0,0,0,0,0,0,0
DELHI (UT),2007,House Wife,0,0,0,0,0,0,0,158,86,12,7,263,263
DELHI (UT),2007,Service (Government),0,6,15,3,0,24,0,3,1,0,0,4,28
DELHI (UT),2007,Service (Private),1,100,90,25,3,219,0,22,6,1,0,29,248
DELHI (UT),2007,Public Sector Undertaking,0,4,5,3,0,12,0,2,0,0,0,2,14
DELHI (UT),2007,Student,9,61,5,0,0,75,7,53,0,0,0,60,135
DELHI (UT),2007,Unemployed,1,108,70,18,5,202,0,44,6,0,0,50,252
DELHI (UT),2007,Self-employed (Business activity),0,9,2,5,1,17,0,0,0,0,0,0,17
DELHI (UT),2007,Professional Activity,0,3,0,1,0,4,0,1,0,0,0,1,5
DELHI (UT),2007,Farming/Agriculture Activity,0,5,10,7,1,23,0,0,0,0,0,0,23
DELHI (UT),2007,Others (Please Specify),0,50,71,22,6,149,0,25,7,0,0,32,181
DELHI (UT),2007,Retired Person,0,0,0,0,5,5,0,0,0,0,0,0,5
DELHI (UT),2007,Others (Please Specify),2,85,107,31,11,236,8,38,22,5,1,74,310
DELHI (UT),2007,Total,13,431,375,115,32,966,15,346,128,18,8,515,1481
DELHI (UT),2007,Total Salaried,1,110,110,31,3,255,0,27,7,1,0,35,290
DELHI (UT),2007,Total Self-employed,0,67,83,35,8,193,0,26,7,0,0,33,226
LAKSHADWEEP,2007,House Wife,0,0,0,0,0,0,0,0,0,2,0,2,2
LAKSHADWEEP,2007,Service (Government),0,0,1,0,0,1,0,0,0,0,0,0,1
LAKSHADWEEP,2007,Service (Private),0,0,0,0,0,0,0,0,0,0,0,0,0
LAKSHADWEEP,2007,Public Sector Undertaking,0,0,0,0,0,0,0,0,0,0,0,0,0
LAKSHADWEEP,2007,Student,0,0,0,0,0,0,0,0,0,0,0,0,0
LAKSHADWEEP,2007,Unemployed,0,0,0,0,0,0,0,0,0,0,0,0,0
LAKSHADWEEP,2007,Self-employed (Business activity),0,0,0,0,0,0,0,0,0,0,0,0,0
LAKSHADWEEP,2007,Professional Activity,0,0,0,0,0,0,0,0,0,0,0,0,0
LAKSHADWEEP,2007,Farming/Agriculture Activity,0,0,0,0,0,0,0,0,0,0,0,0,0
LAKSHADWEEP,2007,Others (Please Specify),0,0,0,0,0,0,0,0,0,0,0,0,0
LAKSHADWEEP,2007,Retired Person,0,0,0,0,0,0,0,0,0,0,0,0,0
LAKSHADWEEP,2007,Others (Please Specify),0,0,0,0,0,0,0,0,0,0,0,0,0
LAKSHADWEEP,2007,Total,0,0,1,0,0,1,0,0,0,2,0,2,3
LAKSHADWEEP,2007,Total Salaried,0,0,1,0,0,1,0,0,0,0,0,0,1
LAKSHADWEEP,2007,Total Self-employed,0,0,0,0,0,0,0,0,0,0,0,0,0
PUDUCHERRY,2007,House Wife,0,0,0,0,0,0,0,48,20,4,6,78,78
PUDUCHERRY,2007,Service (Government),0,0,4,6,0,10,0,3,1,0,0,4,14
PUDUCHERRY,2007,Service (Private),0,6,10,4,0,20,0,3,4,1,0,8,28
PUDUCHERRY,2007,Public Sector Undertaking,0,0,0,0,0,0,0,0,0,0,0,0,0
PUDUCHERRY,2007,Student,1,8,0,0,0,9,5,14,4,0,1,24,33
PUDUCHERRY,2007,Unemployed,0,22,28,9,9,68,0,39,17,2,5,63,131
PUDUCHERRY,2007,Self-employed (Business activity),0,2,6,10,2,20,0,0,0,0,0,0,20
PUDUCHERRY,2007,Professional Activity,0,0,0,0,0,0,0,0,0,0,0,0,0
PUDUCHERRY,2007,Farming/Agriculture Activity,0,33,82,54,12,181,0,9,6,1,0,16,197
PUDUCHERRY,2007,Others (Please Specify),0,0,0,0,0,0,1,4,0,0,0,5,5
PUDUCHERRY,2007,Retired Person,0,0,0,0,0,0,0,0,0,0,0,0,0
PUDUCHERRY,2007,Others (Please Specify),1,2,3,5,0,11,0,0,0,0,0,0,11
PUDUCHERRY,2007,Total,2,73,133,88,23,319,6,120,52,8,12,198,517
PUDUCHERRY,2007,Total Salaried,0,6,14,10,0,30,0,6,5,1,0,12,42
PUDUCHERRY,2007,Total Self-employed,0,35,88,64,14,201,1,13,6,1,0,21,222
TOTAL (UTs),2007,House Wife,0,0,0,0,0,0,0,244,134,31,18,427,427
TOTAL (UTs),2007,Service (Government),0,7,27,16,0,50,0,8,2,0,0,10,60
TOTAL (UTs),2007,Service (Private),1,133,127,41,5,307,0,27,10,2,0,39,346
TOTAL (UTs),2007,Public Sector Undertaking,0,4,5,3,0,12,0,2,0,0,0,2,14
TOTAL (UTs),2007,Student,12,89,5,0,0,106,16,80,4,0,1,101,207
TOTAL (UTs),2007,Unemployed,1,147,104,32,15,299,0,83,23,2,5,113,412
TOTAL (UTs),2007,Self-employed (Business activity),0,11,11,17,3,42,0,0,0,0,0,0,42
TOTAL (UTs),2007,Professional Activity,0,3,0,1,0,4,0,1,0,0,0,1,5
TOTAL (UTs),2007,Farming/Agriculture Activity,0,46,101,70,20,237,0,9,6,1,0,16,253
TOTAL (UTs),2007,Others (Please Specify),0,52,76,26,7,161,1,29,7,0,0,37,198
TOTAL (UTs),2007,Retired Person,0,0,0,1,14,15,0,0,0,0,0,0,15
TOTAL (UTs),2007,Others (Please Specify),3,92,115,40,13,263,10,50,22,5,1,88,351
TOTAL (UTs),2007,Total,17,584,571,247,77,1496,27,533,208,41,25,834,2330
TOTAL (UTs),2007,Total Salaried,1,144,159,60,5,369,0,37,12,2,0,51,420
TOTAL (UTs),2007,Total Self-employed,0,112,188,114,30,444,1,39,13,1,0,54,498
TOTAL (ALL INDIA),2007,House Wife,0,0,0,0,0,0,49,10925,8184,3644,1360,24162,24162
TOTAL (ALL INDIA),2007,Service (Government),0,365,658,525,10,1558,1,123,107,53,15,299,1857
TOTAL (ALL INDIA),2007,Service (Private),31,2397,3440,2043,334,8245,6,977,513,260,67,1823,10068
TOTAL (ALL INDIA),2007,Public Sector Undertaking,0,546,995,587,83,2211,6,196,111,122,1,436,2647
TOTAL (ALL INDIA),2007,Student,603,2644,159,8,2,3416,637,2090,91,6,8,2832,6248
TOTAL (ALL INDIA),2007,Unemployed,29,2786,2423,1181,270,6689,32,943,597,192,58,1822,8511
TOTAL (ALL INDIA),2007,Self-employed (Business activity),1,1592,3220,1768,275,6856,1,156,204,57,6,424,7280
TOTAL (ALL INDIA),2007,Professional Activity,4,780,1228,783,191,2986,9,114,83,31,12,249,3235
TOTAL (ALL INDIA),2007,Farming/Agriculture Activity,46,3266,5467,4066,1664,14509,49,797,707,414,156,2123,16632
TOTAL (ALL INDIA),2007,Others (Please Specify),150,5365,6660,4965,2119,19259,192,1915,1540,934,404,4985,24244
TOTAL (ALL INDIA),2007,Retired Person,0,37,69,149,664,919,2,8,7,23,89,129,1048
TOTAL (ALL INDIA),2007,Others (Please Specify),320,3668,4232,3038,1389,12647,311,1470,1137,722,418,4058,16705
TOTAL (ALL INDIA),2007,Total,1184,23446,28551,19113,7001,79295,1295,19714,13281,6458,2594,43342,122637
TOTAL (ALL INDIA),2007,Total Salaried,31,3308,5093,3155,427,12014,13,1296,731,435,83,2558,14572
TOTAL (ALL INDIA),2007,Total Self-employed,201,11003,16575,11582,4249,43610,251,2982,2534,1436,578,7781,51391
