STATE/UT,Year,CAUSE,Male upto 14 years,Male 15-29 years,Male 30-44 years,Male 45-59 years,Male 60 years and above,Total Male,Female upto 14 years,Female 15-29 years,Female 30-44 years,Female 45-59 years,Female 60 years and above,Total Female,Grand Total
ANDHRA PRADESH,2008,House Wife,0,0,0,0,0,0,0,984,1012,381,139,2516,2516
ANDHRA PRADESH,2008,Service (Government),0,17,108,121,0,246,0,7,37,15,0,59,305
ANDHRA PRADESH,2008,Service (Private),0,239,420,217,92,968,0,68,75,31,15,189,1157
ANDHRA PRADESH,2008,Public Sector Undertaking,4,123,155,181,68,531,0,34,33,21,22,110,641
ANDHRA PRADESH,2008,Student,37,233,19,5,0,294,44,133,9,1,0,187,481
ANDHRA PRADESH,2008,Unemployed,0,185,164,170,0,519,0,7,20,25,0,52,571
ANDHRA PRADESH,2008,Self-employed (Business activity),0,194,458,218,65,935,0,11,17,0,2,30,965
ANDHRA PRADESH,2008,Professional Activity,2,60,202,157,38,459,0,25,4,0,4,33,492
ANDHRA PRADESH,2008,Farming/Agriculture Activity,2,436,628,505,176,1747,6,142,91,84,35,358,2105
ANDHRA PRADESH,2008,Others (Please Specify),7,561,815,427,146,1956,34,270,140,95,41,580,2536
ANDHRA PRADESH,2008,Retired Person,0,0,21,7,24,52,0,0,5,2,8,15,67
ANDHRA PRADESH,2008,Others (Please Specify),39,666,679,469,161,2014,38,201,141,83,41,504,2518
ANDHRA PRADESH,2008,Total,91,2714,3669,2477,770,9721,122,1882,1584,738,307,4633,14354
ANDHRA PRADESH,2008,Total Salaried,4,379,683,519,160,1745,0,109,145,67,37,358,2103
ANDHRA PRADESH,2008,Total Self-employed,11,1251,2103,1307,425,5097,40,448,252,179,82,1001,6098
ARUNACHAL PRADESH,2008,House Wife,0,0,0,0,0,0,0,6,7,1,0,14,14
ARUNACHAL PRADESH,2008,Service (Government),0,10,14,1,0,25,0,0,1,0,0,1,26
ARUNACHAL PRADESH,2008,Service (Private),0,3,2,0,0,5,0,0,3,0,0,3,8
ARUNACHAL PRADESH,2008,Public Sector Undertaking,0,0,0,0,0,0,0,0,0,0,0,0,0
ARUNACHAL PRADESH,2008,Student,1,1,0,0,0,2,0,3,0,0,0,3,5
ARUNACHAL PRADESH,2008,Unemployed,0,4,6,1,0,11,0,0,1,0,0,1,12
ARUNACHAL PRADESH,2008,Self-employed (Business activity),0,0,0,0,0,0,0,0,0,0,0,0,0
ARUNACHAL PRADESH,2008,Professional Activity,0,0,0,0,0,0,0,0,0,0,0,0,0
ARUNACHAL PRADESH,2008,Farming/Agriculture Activity,0,6,1,5,0,12,0,0,0,0,0,0,12
ARUNACHAL PRADESH,2008,Others (Please Specify),0,19,1,0,0,20,0,10,1,0,0,11,31
ARUNACHAL PRADESH,2008,Retired Person,0,0,0,0,0,0,0,0,0,0,0,0,0
ARUNACHAL PRADESH,2008,Others (Please Specify),1,0,1,0,0,2,0,0,0,0,0,0,2
ARUNACHAL PRADESH,2008,Total,2,43,25,7,0,77,0,19,13,1,0,33,110
ARUNACHAL PRADESH,2008,Total Salaried,0,13,16,1,0,30,0,0,4,0,0,4,34
ARUNACHAL PRADESH,2008,Total Self-employed,0,25,2,5,0,32,0,10,1,0,0,11,43
ASSAM,2008,House Wife,0,0,0,0,0,0,0,226,247,89,11,573,573
ASSAM,2008,Service (Government),0,2,13,4,0,19,0,2,0,0,0,2,21
ASSAM,2008,Service (Private),0,16,26,10,0,52,0,12,6,3,0,21,73
ASSAM,2008,Public Sector Undertaking,0,5,28,13,0,46,0,5,1,1,0,7,53
ASSAM,2008,Student,21,108,0,0,0,129,12,65,0,0,0,77,206
ASSAM,2008,Unemployed,0,15,3,19,0,37,0,7,0,0,0,7,44
ASSAM,2008,Self-employed (Business activity),0,117,171,86,1,375,0,35,8,10,1,54,429
ASSAM,2008,Professional Activity,0,33,66,32,2,133,0,0,4,0,0,4,137
ASSAM,2008,Farming/Agriculture Activity,0,70,61,55,6,192,0,5,0,0,0,5,197
ASSAM,2008,Others (Please Specify),2,241,314,156,28,741,1,72,37,9,4,123,864
ASSAM,2008,Retired Person,0,0,0,0,4,4,0,0,0,0,1,1,5
ASSAM,2008,Others (Please Specify),5,109,90,23,15,242,4,74,57,8,2,145,387
ASSAM,2008,Total,28,716,772,398,56,1970,17,503,360,120,19,1019,2989
ASSAM,2008,Total Salaried,0,23,67,27,0,117,0,19,7,4,0,30,147
ASSAM,2008,Total Self-employed,2,461,612,329,37,1441,1,112,49,19,5,186,1627
BIHAR,2008,House Wife,0,0,0,0,0,0,0,66,88,18,2,174,174
BIHAR,2008,Service (Government),0,3,2,2,1,8,0,0,0,0,0,0,8
BIHAR,2008,Service (Private),0,7,8,15,1,31,0,1,2,1,0,4,35
BIHAR,2008,Public Sector Undertaking,0,10,2,1,0,13,0,9,1,0,0,10,23
BIHAR,2008,Student,9,26,7,0,0,42,3,13,0,0,0,16,58
BIHAR,2008,Unemployed,2,24,17,6,0,49,1,3,0,0,0,4,53
BIHAR,2008,Self-employed (Business activity),0,8,7,0,0,15,0,0,0,0,0,0,15
BIHAR,2008,Professional Activity,0,1,3,1,0,5,0,0,0,0,0,0,5
BIHAR,2008,Farming/Agriculture Activity,0,15,21,21,5,62,0,4,1,0,0,5,67
BIHAR,2008,Others (Please Specify),2,10,13,12,19,56,8,7,26,4,10,55,111
BIHAR,2008,Retired Person,0,0,0,0,9,9,0,0,0,0,6,6,15
BIHAR,2008,Others (Please Specify),22,114,122,39,22,319,21,62,27,17,5,132,451
BIHAR,2008,Total,35,218,202,97,57,609,33,165,145,40,23,406,1015
BIHAR,2008,Total Salaried,0,20,12,18,2,52,0,10,3,1,0,14,66
BIHAR,2008,Total Self-employed,2,34,44,34,24,138,8,11,27,4,10,60,198
CHHATTISGARH,2008,House Wife,0,0,0,0,0,0,2,499,275,125,36,937,937
CHHATTISGARH,2008,Service (Government),0,9,17,13,0,39,0,6,0,0,0,6,45
CHHATTISGARH,2008,Service (Private),0,71,77,29,6,183,0,9,6,3,0,18,201
CHHATTISGARH,2008,Public Sector Undertaking,0,1,6,3,0,10,0,0,0,0,0,0,10
CHHATTISGARH,2008,Student,37,162,2,1,0,202,35,130,3,0,0,168,370
CHHATTISGARH,2008,Unemployed,0,86,65,16,0,167,0,6,2,2,0,10,177
CHHATTISGARH,2008,Self-employed (Business activity),0,51,63,33,6,153,0,4,0,0,0,4,157
CHHATTISGARH,2008,Professional Activity,0,27,26,19,8,80,0,0,11,2,0,13,93
CHHATTISGARH,2008,Farming/Agriculture Activity,9,436,576,346,124,1491,20,101,107,46,8,282,1773
CHHATTISGARH,2008,Others (Please Specify),13,213,242,149,45,662,11,82,45,17,9,164,826
CHHATTISGARH,2008,Retired Person,0,0,0,2,0,2,0,0,0,0,0,0,2
CHHATTISGARH,2008,Others (Please Specify),6,69,82,74,28,259,14,17,29,23,12,95,354
CHHATTISGARH,2008,Total,65,1125,1156,685,217,3248,82,854,478,218,65,1697,4945
CHHATTISGARH,2008,Total Salaried,0,81,100,45,6,232,0,15,6,3,0,24,256
CHHATTISGARH,2008,Total Self-employed,22,727,907,547,183,2386,31,187,163,65,17,463,2849
GOA,2008,House Wife,0,0,0,0,0,0,0,25,19,10,11,65,65
GOA,2008,Service (Government),0,0,3,0,0,3,0,1,0,0,0,1,4
GOA,2008,Service (Private),0,23,25,7,1,56,0,5,2,0,0,7,63
GOA,2008,Public Sector Undertaking,0,0,0,0,0,0,0,0,0,0,0,0,0
GOA,2008,Student,0,5,0,0,0,5,2,5,0,0,0,7,12
GOA,2008,Unemployed,0,18,22,12,2,54,1,13,3,0,0,17,71
GOA,2008,Self-employed (Business activity),0,1,7,3,0,11,0,0,1,0,0,1,12
GOA,2008,Professional Activity,0,0,1,0,0,1,0,0,0,0,0,0,1
GOA,2008,Farming/Agriculture Activity,0,0,2,2,2,6,0,0,0,0,0,0,6
GOA,2008,Others (Please Specify),0,1,3,0,4,8,0,1,0,0,0,1,9
GOA,2008,Retired Person,0,0,0,0,2,2,0,0,0,0,0,0,2
GOA,2008,Others (Please Specify),0,7,21,5,4,37,0,4,1,0,0,5,42
GOA,2008,Total,0,55,84,29,15,183,3,54,26,10,11,104,287
GOA,2008,Total Salaried,0,23,28,7,1,59,0,6,2,0,0,8,67
GOA,2008,Total Self-employed,0,2,13,5,6,26,0,1,1,0,0,2,28
GUJARAT,2008,House Wife,0,0,0,0,0,0,3,751,622,255,113,1744,1744
GUJARAT,2008,Service (Government),0,9,30,18,0,57,0,2,3,0,0,5,62
GUJARAT,2008,Service (Private),0,178,244,119,3,544,0,25,30,9,0,64,608
GUJARAT,2008,Public Sector Undertaking,0,23,55,22,2,102,0,16,7,2,0,25,127
GUJARAT,2008,Student,13,131,9,2,0,155,18,122,7,2,0,149,304
GUJARAT,2008,Unemployed,1,206,219,76,11,513,4,28,8,4,1,45,558
GUJARAT,2008,Self-employed (Business activity),0,75,124,78,10,287,0,0,3,0,0,3,290
GUJARAT,2008,Professional Activity,0,155,161,85,19,420,0,4,4,0,0,8,428
GUJARAT,2008,Farming/Agriculture Activity,0,115,182,92,52,441,1,21,19,38,6,85,526
GUJARAT,2008,Others (Please Specify),2,225,241,133,26,627,2,50,42,9,7,110,737
GUJARAT,2008,Retired Person,0,3,1,48,90,142,0,0,0,11,34,45,187
GUJARAT,2008,Others (Please Specify),9,130,156,114,38,447,11,71,41,17,7,147,594
GUJARAT,2008,Total,25,1250,1422,787,251,3735,39,1090,786,347,168,2430,6165
GUJARAT,2008,Total Salaried,0,210,329,159,5,703,0,43,40,11,0,94,797
GUJARAT,2008,Total Self-employed,2,570,708,388,107,1775,3,75,68,47,13,206,1981
HARYANA,2008,House Wife,0,0,0,0,0,0,0,159,135,52,20,366,366
HARYANA,2008,Service (Government),0,29,40,14,7,90,0,3,0,0,0,3,93
HARYANA,2008,Service (Private),0,95,101,38,5,239,0,9,2,0,0,11,250
HARYANA,2008,Public Sector Undertaking,0,41,33,11,7,92,0,3,1,0,0,4,96
HARYANA,2008,Student,10,78,3,1,0,92,15,28,0,0,0,43,135
HARYANA,2008,Unemployed,0,47,75,30,7,159,0,6,12,5,1,24,183
HARYANA,2008,Self-employed (Business activity),0,15,16,7,0,38,0,3,0,0,0,3,41
HARYANA,2008,Professional Activity,0,12,28,9,1,50,0,0,0,0,0,0,50
HARYANA,2008,Farming/Agriculture Activity,0,34,62,36,18,150,0,0,0,0,0,0,150
HARYANA,2008,Others (Please Specify),0,42,57,18,6,123,0,9,8,4,0,21,144
HARYANA,2008,Retired Person,0,1,0,0,7,8,0,2,0,2,0,4,12
HARYANA,2008,Others (Please Specify),37,293,359,158,86,933,24,52,97,22,8,203,1136
HARYANA,2008,Total,47,687,774,322,144,1974,39,274,255,85,29,682,2656
HARYANA,2008,Total Salaried,0,165,174,63,19,421,0,15,3,0,0,18,439
HARYANA,2008,Total Self-employed,0,103,163,70,25,361,0,12,8,4,0,24,385
HIMACHAL PRADESH,2008,House Wife,0,0,0,0,0,0,0,38,29,11,9,87,87
HIMACHAL PRADESH,2008,Service (Government),0,6,5,8,0,19,0,1,0,1,0,2,21
HIMACHAL PRADESH,2008,Service (Private),0,20,10,8,1,39,0,3,5,1,1,10,49
HIMACHAL PRADESH,2008,Public Sector Undertaking,0,6,5,4,1,16,0,4,1,2,0,7,23
HIMACHAL PRADESH,2008,Student,3,17,0,0,0,20,5,10,0,1,0,16,36
HIMACHAL PRADESH,2008,Unemployed,0,16,11,2,0,29,0,9,0,0,0,9,38
HIMACHAL PRADESH,2008,Self-employed (Business activity),0,5,13,8,5,31,0,0,1,0,0,1,32
HIMACHAL PRADESH,2008,Professional Activity,0,3,3,3,0,9,0,1,2,1,1,5,14
HIMACHAL PRADESH,2008,Farming/Agriculture Activity,3,36,42,46,23,150,3,14,10,4,7,38,188
HIMACHAL PRADESH,2008,Others (Please Specify),0,22,16,22,6,66,2,10,4,2,0,18,84
HIMACHAL PRADESH,2008,Retired Person,0,0,0,1,2,3,0,0,0,0,0,0,3
HIMACHAL PRADESH,2008,Others (Please Specify),0,9,10,14,2,35,0,13,5,2,0,20,55
HIMACHAL PRADESH,2008,Total,6,140,115,116,40,417,10,103,57,25,18,213,630
HIMACHAL PRADESH,2008,Total Salaried,0,32,20,20,2,74,0,8,6,4,1,19,93
HIMACHAL PRADESH,2008,Total Self-employed,3,66,74,79,34,256,5,25,17,7,8,62,318
JAMMU & KASHMIR,2008,House Wife,0,0,0,0,0,0,0,38,36,1,0,75,75
JAMMU & KASHMIR,2008,Service (Government),0,4,12,9,0,25,0,1,2,0,0,3,28
JAMMU & KASHMIR,2008,Service (Private),0,5,11,6,0,22,0,2,3,0,0,5,27
JAMMU & KASHMIR,2008,Public Sector Undertaking,0,1,5,13,1,20,0,1,0,0,0,1,21
JAMMU & KASHMIR,2008,Student,0,7,0,0,0,7,1,8,0,0,0,9,16
JAMMU & KASHMIR,2008,Unemployed,0,16,19,1,1,37,0,12,2,0,0,14,51
JAMMU & KASHMIR,2008,Self-employed (Business activity),0,0,3,2,1,6,0,0,0,0,0,0,6
JAMMU & KASHMIR,2008,Professional Activity,0,0,1,2,1,4,0,0,0,0,0,0,4
JAMMU & KASHMIR,2008,Farming/Agriculture Activity,0,2,1,1,0,4,0,2,0,0,0,2,6
JAMMU & KASHMIR,2008,Others (Please Specify),0,11,6,3,3,23,0,9,3,0,0,12,35
JAMMU & KASHMIR,2008,Retired Person,0,0,0,0,6,6,0,0,0,0,0,0,6
JAMMU & KASHMIR,2008,Others (Please Specify),1,10,5,4,3,23,0,7,5,0,0,12,35
JAMMU & KASHMIR,2008,Total,1,56,63,41,16,177,1,80,51,1,0,133,310
JAMMU & KASHMIR,2008,Total Salaried,0,10,28,28,1,67,0,4,5,0,0,9,76
JAMMU & KASHMIR,2008,Total Self-employed,0,13,11,8,5,37,0,11,3,0,0,14,51
JHARKHAND,2008,House Wife,0,0,0,0,0,0,1,58,67,41,3,170,170
JHARKHAND,2008,Service (Government),0,2,7,3,0,12,0,0,0,1,0,1,13
JHARKHAND,2008,Service (Private),0,8,19,4,0,31,0,0,4,0,0,4,35
JHARKHAND,2008,Public Sector Undertaking,0,5,7,2,0,14,0,0,0,0,0,0,14
JHARKHAND,2008,Student,8,52,1,0,0,61,13,26,1,0,0,40,101
JHARKHAND,2008,Unemployed,0,17,18,10,5,50,1,3,6,0,0,10,60
JHARKHAND,2008,Self-employed (Business activity),0,4,18,10,0,32,0,3,0,0,0,3,35
JHARKHAND,2008,Professional Activity,0,1,32,10,0,43,5,0,0,0,0,5,48
JHARKHAND,2008,Farming/Agriculture Activity,3,17,18,23,3,64,2,2,2,1,0,7,71
JHARKHAND,2008,Others (Please Specify),8,25,42,25,6,106,1,2,11,0,1,15,121
JHARKHAND,2008,Retired Person,0,0,0,0,4,4,0,0,0,0,0,0,4
JHARKHAND,2008,Others (Please Specify),1,40,76,47,21,185,8,19,17,7,3,54,239
JHARKHAND,2008,Total,20,171,238,134,39,602,31,113,108,50,7,309,911
JHARKHAND,2008,Total Salaried,0,15,33,9,0,57,0,0,4,1,0,5,62
JHARKHAND,2008,Total Self-employed,11,47,110,68,9,245,8,7,13,1,1,30,275
KARNATAKA,2008,House Wife,0,0,0,0,0,0,3,658,587,291,114,1653,1653
KARNATAKA,2008,Service (Government),0,53,57,84,2,196,0,21,19,7,6,53,249
KARNATAKA,2008,Service (Private),0,279,417,311,47,1054,5,120,50,15,22,212,1266
KARNATAKA,2008,Public Sector Undertaking,0,60,77,75,23,235,1,46,6,10,6,69,304
KARNATAKA,2008,Student,24,180,19,18,2,243,25,176,11,0,0,212,455
KARNATAKA,2008,Unemployed,0,146,153,78,24,401,2,45,35,11,0,93,494
KARNATAKA,2008,Self-employed (Business activity),0,149,248,115,32,544,0,13,14,9,4,40,584
KARNATAKA,2008,Professional Activity,0,30,31,52,5,118,0,16,3,2,1,22,140
KARNATAKA,2008,Farming/Agriculture Activity,0,255,570,435,179,1439,0,99,120,59,20,298,1737
KARNATAKA,2008,Others (Please Specify),11,395,664,577,267,1914,16,161,117,101,65,460,2374
KARNATAKA,2008,Retired Person,0,0,4,12,35,51,0,1,0,1,4,6,57
KARNATAKA,2008,Others (Please Specify),19,651,630,546,175,2021,28,301,299,184,76,888,2909
KARNATAKA,2008,Total,54,2198,2870,2303,791,8216,80,1657,1261,690,318,4006,12222
KARNATAKA,2008,Total Salaried,0,392,551,470,72,1485,6,187,75,32,34,334,1819
KARNATAKA,2008,Total Self-employed,11,829,1513,1179,483,4015,16,289,254,171,90,820,4835
KERALA,2008,House Wife,0,0,0,0,0,0,0,258,435,376,251,1320,1320
KERALA,2008,Service (Government),0,3,27,36,1,67,0,1,7,5,0,13,80
KERALA,2008,Service (Private),0,52,176,147,14,389,0,23,28,25,1,77,466
KERALA,2008,Public Sector Undertaking,0,4,35,37,0,76,0,3,4,3,0,10,86
KERALA,2008,Student,25,66,0,0,0,91,38,157,0,0,0,195,286
KERALA,2008,Unemployed,0,180,294,131,63,668,0,71,46,35,11,163,831
KERALA,2008,Self-employed (Business activity),0,36,110,173,55,374,0,1,2,6,0,9,383
KERALA,2008,Professional Activity,0,32,57,48,11,148,0,2,5,3,0,10,158
KERALA,2008,Farming/Agriculture Activity,0,71,219,294,184,768,0,8,11,23,10,52,820
KERALA,2008,Others (Please Specify),0,328,574,607,320,1829,1,95,99,90,47,332,2161
KERALA,2008,Retired Person,0,0,1,23,76,100,0,0,0,1,8,9,109
KERALA,2008,Others (Please Specify),1,244,555,505,315,1620,3,47,55,70,74,249,1869
KERALA,2008,Total,26,1016,2048,2001,1039,6130,42,666,692,637,402,2439,8569
KERALA,2008,Total Salaried,0,59,238,220,15,532,0,27,39,33,1,100,632
KERALA,2008,Total Self-employed,0,467,960,1122,570,3119,1,106,117,122,57,403,3522
MADHYA PRADESH,2008,House Wife,0,0,0,0,0,0,6,1204,593,215,55,2073,2073
MADHYA PRADESH,2008,Service (Government),0,60,66,56,0,182,0,22,26,0,0,48,230
MADHYA PRADESH,2008,Service (Private),2,132,142,55,6,337,0,26,69,5,0,100,437
MADHYA PRADESH,2008,Public Sector Undertaking,0,69,73,73,13,228,0,3,6,0,0,9,237
MADHYA PRADESH,2008,Student,29,180,26,6,0,241,50,128,1,0,0,179,420
MADHYA PRADESH,2008,Unemployed,1,146,78,48,5,278,0,38,15,0,0,53,331
MADHYA PRADESH,2008,Self-employed (Business activity),1,103,148,43,12,307,0,14,8,2,0,24,331
MADHYA PRADESH,2008,Professional Activity,2,62,86,48,4,202,0,19,10,4,0,33,235
MADHYA PRADESH,2008,Farming/Agriculture Activity,6,437,389,204,136,1172,2,106,68,21,10,207,1379
MADHYA PRADESH,2008,Others (Please Specify),21,250,308,206,160,945,10,154,87,37,23,311,1256
MADHYA PRADESH,2008,Retired Person,0,3,2,0,13,18,0,0,0,0,0,0,18
MADHYA PRADESH,2008,Others (Please Specify),13,150,183,76,33,455,12,119,62,21,13,227,682
MADHYA PRADESH,2008,Total,75,1592,1501,815,382,4365,80,1833,945,305,101,3264,7629
MADHYA PRADESH,2008,Total Salaried,2,261,281,184,19,747,0,51,101,5,0,157,904
MADHYA PRADESH,2008,Total Self-employed,30,852,931,501,312,2626,12,293,173,64,33,575,3201
MAHARASHTRA,2008,House Wife,0,0,0,0,0,0,7,1744,1017,369,247,3384,3384
MAHARASHTRA,2008,Service (Government),0,28,61,58,0,147,0,6,4,0,0,10,157
MAHARASHTRA,2008,Service (Private),0,476,693,360,31,1560,0,65,23,5,0,93,1653
MAHARASHTRA,2008,Public Sector Undertaking,0,59,66,44,9,178,1,13,4,0,0,18,196
MAHARASHTRA,2008,Student,44,355,8,0,0,407,57,290,3,0,0,350,757
MAHARASHTRA,2008,Unemployed,2,353,284,134,23,796,0,56,19,1,1,77,873
MAHARASHTRA,2008,Self-employed (Business activity),0,111,191,125,31,458,0,8,3,0,0,11,469
MAHARASHTRA,2008,Professional Activity,0,136,183,111,51,481,0,27,24,6,2,59,540
MAHARASHTRA,2008,Farming/Agriculture Activity,0,856,1392,935,390,3573,2,89,92,31,15,229,3802
MAHARASHTRA,2008,Others (Please Specify),0,623,778,418,181,2000,1,105,56,43,14,219,2219
MAHARASHTRA,2008,Retired Person,0,0,0,20,100,120,0,0,1,2,10,13,133
MAHARASHTRA,2008,Others (Please Specify),1,39,69,42,18,169,6,9,5,1,1,22,191
MAHARASHTRA,2008,Total,47,3036,3725,2247,834,9889,74,2412,1251,458,290,4485,14374
MAHARASHTRA,2008,Total Salaried,0,563,820,462,40,1885,1,84,31,5,0,121,2006
MAHARASHTRA,2008,Total Self-employed,0,1726,2544,1589,653,6512,3,229,175,80,31,518,7030
MANIPUR,2008,House Wife,0,0,0,0,0,0,0,3,1,1,0,5,5
MANIPUR,2008,Service (Government),0,3,4,0,0,7,0,0,0,0,0,0,7
MANIPUR,2008,Service (Private),0,0,0,0,0,0,0,0,0,0,0,0,0
MANIPUR,2008,Public Sector Undertaking,0,0,0,0,0,0,0,0,0,0,0,0,0
MANIPUR,2008,Student,0,2,0,0,0,2,1,1,0,0,0,2,4
MANIPUR,2008,Unemployed,0,5,2,0,0,7,0,2,1,0,0,3,10
MANIPUR,2008,Self-employed (Business activity),0,0,0,0,0,0,0,0,0,0,0,0,0
MANIPUR,2008,Professional Activity,0,0,0,0,0,0,0,0,0,0,0,0,0
MANIPUR,2008,Farming/Agriculture Activity,0,0,2,0,0,2,0,0,0,0,0,0,2
MANIPUR,2008,Others (Please Specify),0,1,3,0,0,4,0,1,0,0,0,1,5
MANIPUR,2008,Retired Person,0,0,0,0,0,0,0,0,0,0,0,0,0
MANIPUR,2008,Others (Please Specify),0,0,1,0,0,1,0,0,0,0,0,0,1
MANIPUR,2008,Total,0,11,12,0,0,23,1,7,2,1,0,11,34
MANIPUR,2008,Total Salaried,0,3,4,0,0,7,0,0,0,0,0,0,7
MANIPUR,2008,Total Self-employed,0,1,5,0,0,6,0,1,0,0,0,1,7
MEGHALAYA,2008,House Wife,0,0,0,0,0,0,0,3,4,2,0,9,9
MEGHALAYA,2008,Service (Government),0,0,5,2,0,7,0,0,1,0,0,1,8
MEGHALAYA,2008,Service (Private),0,0,1,0,0,1,0,0,0,0,0,0,1
MEGHALAYA,2008,Public Sector Undertaking,0,0,0,0,0,0,0,0,0,0,0,0,0
MEGHALAYA,2008,Student,0,4,1,0,0,5,1,3,0,0,0,4,9
MEGHALAYA,2008,Unemployed,0,7,5,4,0,16,0,2,1,0,1,4,20
MEGHALAYA,2008,Self-employed (Business activity),0,0,0,0,0,0,0,0,0,0,0,0,0
MEGHALAYA,2008,Professional Activity,0,0,0,0,0,0,0,1,0,0,0,1,1
MEGHALAYA,2008,Farming/Agriculture Activity,0,4,3,2,0,9,0,0,0,0,0,0,9
MEGHALAYA,2008,Others (Please Specify),0,4,12,2,1,19,0,1,0,0,1,2,21
MEGHALAYA,2008,Retired Person,0,0,0,0,0,0,0,0,0,0,0,0,0
MEGHALAYA,2008,Others (Please Specify),0,0,0,0,0,0,0,1,6,0,0,7,7
MEGHALAYA,2008,Total,0,19,27,10,1,57,1,11,12,2,2,28,85
MEGHALAYA,2008,Total Salaried,0,0,6,2,0,8,0,0,1,0,0,1,9
MEGHALAYA,2008,Total Self-employed,0,8,15,4,1,28,0,2,0,0,1,3,31
MIZORAM,2008,House Wife,0,0,0,0,0,0,0,0,0,0,0,0,0
MIZORAM,2008,Service (Government),0,0,0,0,0,0,0,0,0,0,0,0,0
MIZORAM,2008,Service (Private),0,0,0,0,0,0,0,0,0,0,0,0,0
MIZORAM,2008,Public Sector Undertaking,0,0,0,0,0,0,0,0,0,0,0,0,0
MIZORAM,2008,Student,0,3,0,0,0,3,0,0,2,0,0,2,5
MIZORAM,2008,Unemployed,0,0,0,0,0,0,0,0,0,0,0,0,0
MIZORAM,2008,Self-employed (Business activity),0,0,3,0,0,3,0,0,0,0,0,0,3
MIZORAM,2008,Professional Activity,0,0,0,0,0,0,0,0,0,0,0,0,0
MIZORAM,2008,Farming/Agriculture Activity,0,0,0,0,0,0,0,0,0,0,0,0,0
MIZORAM,2008,Others (Please Specify),0,0,0,1,0,1,0,0,1,0,0,1,2
MIZORAM,2008,Retired Person,0,0,0,0,0,0,0,0,0,0,0,0,0
MIZORAM,2008,Others (Please Specify),0,9,13,6,0,28,0,2,0,1,0,3,31
MIZORAM,2008,Total,0,12,16,7,0,35,0,2,3,1,0,6,41
MIZORAM,2008,Total Salaried,0,0,0,0,0,0,0,0,0,0,0,0,0
MIZORAM,2008,Total Self-employed,0,0,3,1,0,4,0,0,1,0,0,1,5
NAGALAND,2008,House Wife,0,0,0,0,0,0,0,4,0,0,0,4,4
NAGALAND,2008,Service (Government),0,0,4,0,0,4,0,1,0,0,0,1,5
NAGALAND,2008,Service (Private),0,0,0,0,0,0,0,0,0,0,0,0,0
NAGALAND,2008,Public Sector Undertaking,0,0,0,0,0,0,0,0,0,0,0,0,0
NAGALAND,2008,Student,0,0,0,0,0,0,0,3,0,0,0,3,3
NAGALAND,2008,Unemployed,0,0,0,0,0,0,0,0,0,0,0,0,0
NAGALAND,2008,Self-employed (Business activity),0,0,0,0,0,0,0,0,0,0,0,0,0
NAGALAND,2008,Professional Activity,0,0,0,0,0,0,0,0,0,0,0,0,0
NAGALAND,2008,Farming/Agriculture Activity,0,0,0,2,0,2,0,0,0,0,0,0,2
NAGALAND,2008,Others (Please Specify),0,2,6,2,0,10,0,0,0,0,0,0,10
NAGALAND,2008,Retired Person,0,0,0,0,0,0,0,0,0,0,0,0,0
NAGALAND,2008,Others (Please Specify),0,0,10,6,0,16,0,0,2,0,0,2,18
NAGALAND,2008,Total,0,2,20,10,0,32,0,8,2,0,0,10,42
NAGALAND,2008,Total Salaried,0,0,4,0,0,4,0,1,0,0,0,1,5
NAGALAND,2008,Total Self-employed,0,2,6,4,0,12,0,0,0,0,0,0,12
ODISHA,2008,House Wife,0,0,0,0,0,0,0,250,259,113,57,679,679
ODISHA,2008,Service (Government),0,0,2,7,0,9,0,9,2,2,0,13,22
ODISHA,2008,Service (Private),2,77,117,68,8,272,3,43,35,4,2,87,359
ODISHA,2008,Public Sector Undertaking,0,53,42,11,2,108,0,19,9,0,0,28,136
ODISHA,2008,Student,27,95,9,0,0,131,23,60,3,0,0,86,217
ODISHA,2008,Unemployed,26,201,124,91,8,450,3,71,28,8,0,110,560
ODISHA,2008,Self-employed (Business activity),0,50,121,77,27,275,0,7,2,4,0,13,288
ODISHA,2008,Professional Activity,1,19,84,19,8,131,0,8,6,2,2,18,149
ODISHA,2008,Farming/Agriculture Activity,7,77,101,41,19,245,0,1,10,3,1,15,260
ODISHA,2008,Others (Please Specify),23,367,231,246,114,981,9,134,125,63,29,360,1341
ODISHA,2008,Retired Person,0,0,0,13,23,36,0,0,0,1,6,7,43
ODISHA,2008,Others (Please Specify),28,105,190,140,54,517,17,118,117,59,22,333,850
ODISHA,2008,Total,114,1044,1021,713,263,3155,55,720,596,259,119,1749,4904
ODISHA,2008,Total Salaried,2,130,161,86,10,389,3,71,46,6,2,128,517
ODISHA,2008,Total Self-employed,31,513,537,383,168,1632,9,150,143,72,32,406,2038
PUNJAB,2008,House Wife,0,0,0,0,0,0,1,66,66,15,8,156,156
PUNJAB,2008,Service (Government),0,4,16,9,0,29,0,0,0,0,0,0,29
PUNJAB,2008,Service (Private),0,35,36,12,0,83,0,2,3,0,0,5,88
PUNJAB,2008,Public Sector Undertaking,0,1,1,0,0,2,0,0,0,0,0,0,2
PUNJAB,2008,Student,2,23,0,1,0,26,3,19,0,0,0,22,48
PUNJAB,2008,Unemployed,0,24,20,7,3,54,0,1,0,0,0,1,55
PUNJAB,2008,Self-employed (Business activity),0,26,45,21,13,105,0,0,0,0,0,0,105
PUNJAB,2008,Professional Activity,0,4,4,3,2,13,0,0,0,0,0,0,13
PUNJAB,2008,Farming/Agriculture Activity,1,18,32,9,6,66,0,0,0,0,0,0,66
PUNJAB,2008,Others (Please Specify),3,37,41,36,7,124,1,14,12,3,1,31,155
PUNJAB,2008,Retired Person,0,0,0,0,2,2,0,0,0,0,0,0,2
PUNJAB,2008,Others (Please Specify),2,32,54,32,19,139,5,4,2,0,0,11,150
PUNJAB,2008,Total,8,204,249,130,52,643,10,106,83,18,9,226,869
PUNJAB,2008,Total Salaried,0,40,53,21,0,114,0,2,3,0,0,5,119
PUNJAB,2008,Total Self-employed,4,85,122,69,28,308,1,14,12,3,1,31,339
RAJASTHAN,2008,House Wife,0,0,0,0,0,0,18,360,389,147,44,958,958
RAJASTHAN,2008,Service (Government),0,13,31,18,1,63,0,13,7,6,0,26,89
RAJASTHAN,2008,Service (Private),0,136,206,86,3,431,0,27,5,3,0,35,466
RAJASTHAN,2008,Public Sector Undertaking,0,6,6,4,1,17,0,1,1,0,0,2,19
RAJASTHAN,2008,Student,29,101,43,0,0,173,13,53,3,0,0,69,242
RAJASTHAN,2008,Unemployed,0,81,65,22,8,176,0,15,12,4,0,31,207
RAJASTHAN,2008,Self-employed (Business activity),0,57,109,66,2,234,0,2,3,5,0,10,244
RAJASTHAN,2008,Professional Activity,0,18,24,8,3,53,0,0,0,0,0,0,53
RAJASTHAN,2008,Farming/Agriculture Activity,0,156,287,212,40,695,2,33,56,7,3,101,796
RAJASTHAN,2008,Others (Please Specify),38,336,392,161,45,972,9,80,33,38,4,164,1136
RAJASTHAN,2008,Retired Person,0,5,5,2,1,13,0,0,0,0,0,0,13
RAJASTHAN,2008,Others (Please Specify),51,253,247,169,55,775,26,74,40,20,8,168,943
RAJASTHAN,2008,Total,118,1162,1415,748,159,3602,68,658,549,230,59,1564,5166
RAJASTHAN,2008,Total Salaried,0,155,243,108,5,511,0,41,13,9,0,63,574
RAJASTHAN,2008,Total Self-employed,38,567,812,447,90,1954,11,115,92,50,7,275,2229
SIKKIM,2008,House Wife,0,0,0,0,0,0,0,6,0,1,0,7,7
SIKKIM,2008,Service (Government),0,0,0,0,0,0,0,0,0,0,0,0,0
SIKKIM,2008,Service (Private),0,8,4,6,2,20,0,2,4,2,0,8,28
SIKKIM,2008,Public Sector Undertaking,0,0,0,0,0,0,0,3,1,2,0,6,6
SIKKIM,2008,Student,2,6,0,0,0,8,0,4,0,0,0,4,12
SIKKIM,2008,Unemployed,0,16,11,6,3,36,0,3,6,4,0,13,49
SIKKIM,2008,Self-employed (Business activity),0,0,0,0,0,0,0,0,0,0,0,0,0
SIKKIM,2008,Professional Activity,0,0,0,0,0,0,0,0,0,0,0,0,0
SIKKIM,2008,Farming/Agriculture Activity,0,10,21,17,1,49,0,2,6,0,3,11,60
SIKKIM,2008,Others (Please Specify),0,20,20,16,4,60,0,0,0,0,0,0,60
SIKKIM,2008,Retired Person,0,0,0,0,0,0,0,0,0,0,0,0,0
SIKKIM,2008,Others (Please Specify),0,10,13,20,0,43,0,6,9,4,3,22,65
SIKKIM,2008,Total,2,70,69,65,10,216,0,26,26,13,6,71,287
SIKKIM,2008,Total Salaried,0,8,4,6,2,20,0,5,5,4,0,14,34
SIKKIM,2008,Total Self-employed,0,30,41,33,5,109,0,2,6,0,3,11,120
TAMIL NADU,2008,House Wife,0,0,0,0,0,0,0,841,986,470,133,2430,2430
TAMIL NADU,2008,Service (Government),0,31,153,83,2,269,0,20,11,9,6,46,315
TAMIL NADU,2008,Service (Private),0,357,520,385,71,1333,0,476,120,84,8,688,2021
TAMIL NADU,2008,Public Sector Undertaking,0,75,132,71,3,281,0,31,15,54,7,107,388
TAMIL NADU,2008,Student,30,84,0,0,0,114,43,97,4,0,0,144,258
TAMIL NADU,2008,Unemployed,0,431,134,197,111,873,0,263,145,75,10,493,1366
TAMIL NADU,2008,Self-employed (Business activity),0,196,854,201,35,1286,0,29,95,13,4,141,1427
TAMIL NADU,2008,Professional Activity,0,110,170,95,41,416,0,55,49,28,10,142,558
TAMIL NADU,2008,Farming/Agriculture Activity,0,95,170,95,40,400,0,40,46,24,2,112,512
TAMIL NADU,2008,Others (Please Specify),0,886,710,850,325,2771,0,258,175,123,84,640,3411
TAMIL NADU,2008,Retired Person,0,0,0,12,89,101,0,0,0,0,16,16,117
TAMIL NADU,2008,Others (Please Specify),0,298,422,325,154,1199,40,105,135,84,59,423,1622
TAMIL NADU,2008,Total,30,2563,3265,2314,871,9043,83,2215,1781,964,339,5382,14425
TAMIL NADU,2008,Total Salaried,0,463,805,539,76,1883,0,527,146,147,21,841,2724
TAMIL NADU,2008,Total Self-employed,0,1287,1904,1241,441,4873,0,382,365,188,100,1035,5908
TRIPURA,2008,House Wife,0,0,0,0,0,0,0,56,43,29,2,130,130
TRIPURA,2008,Service (Government),0,3,9,3,0,15,0,0,0,0,0,0,15
TRIPURA,2008,Service (Private),0,4,8,2,0,14,0,0,7,4,0,11,25
TRIPURA,2008,Public Sector Undertaking,0,0,0,2,0,2,0,0,0,0,0,0,2
TRIPURA,2008,Student,9,43,0,0,0,52,13,26,0,0,0,39,91
TRIPURA,2008,Unemployed,0,32,61,27,13,133,0,13,5,0,0,18,151
TRIPURA,2008,Self-employed (Business activity),0,7,8,3,0,18,0,0,0,0,0,0,18
TRIPURA,2008,Professional Activity,0,0,0,0,0,0,0,0,0,0,0,0,0
TRIPURA,2008,Farming/Agriculture Activity,0,10,20,15,0,45,0,0,5,0,0,5,50
TRIPURA,2008,Others (Please Specify),0,25,38,17,12,92,0,19,10,5,0,34,126
TRIPURA,2008,Retired Person,0,0,0,0,0,0,0,0,0,0,0,0,0
TRIPURA,2008,Others (Please Specify),0,28,23,20,0,71,1,29,26,13,4,73,144
TRIPURA,2008,Total,9,152,167,89,25,442,14,143,96,51,6,310,752
TRIPURA,2008,Total Salaried,0,7,17,7,0,31,0,0,7,4,0,11,42
TRIPURA,2008,Total Self-employed,0,42,66,35,12,155,0,19,15,5,0,39,194
UTTAR PRADESH,2008,House Wife,0,0,0,0,0,0,10,618,337,91,49,1105,1105
UTTAR PRADESH,2008,Service (Government),0,8,15,7,0,30,0,9,5,0,0,14,44
UTTAR PRADESH,2008,Service (Private),0,102,84,4,2,192,0,24,12,5,0,41,233
UTTAR PRADESH,2008,Public Sector Undertaking,0,18,19,5,1,43,0,3,4,4,0,11,54
UTTAR PRADESH,2008,Student,27,148,22,1,2,200,25,125,4,0,0,154,354
UTTAR PRADESH,2008,Unemployed,1,101,90,32,15,239,0,25,17,4,1,47,286
UTTAR PRADESH,2008,Self-employed (Business activity),1,29,70,53,28,181,4,5,10,1,2,22,203
UTTAR PRADESH,2008,Professional Activity,0,6,9,6,1,22,0,7,1,1,0,9,31
UTTAR PRADESH,2008,Farming/Agriculture Activity,1,128,267,156,64,616,0,44,59,14,12,129,745
UTTAR PRADESH,2008,Others (Please Specify),19,152,106,101,44,422,25,164,40,17,16,262,684
UTTAR PRADESH,2008,Retired Person,0,0,1,2,3,6,0,0,0,0,0,0,6
UTTAR PRADESH,2008,Others (Please Specify),11,76,75,52,14,228,5,59,30,14,7,115,343
UTTAR PRADESH,2008,Total,60,768,758,419,174,2179,69,1083,519,151,87,1909,4088
UTTAR PRADESH,2008,Total Salaried,0,128,118,16,3,265,0,36,21,9,0,66,331
UTTAR PRADESH,2008,Total Self-employed,21,315,452,316,137,1241,29,220,110,33,30,422,1663
UTTARAKHAND,2008,House Wife,0,0,0,0,0,0,0,32,8,4,0,44,44
UTTARAKHAND,2008,Service (Government),0,4,2,1,0,7,0,0,0,0,0,0,7
UTTARAKHAND,2008,Service (Private),1,7,7,2,0,17,0,3,2,1,0,6,23
UTTARAKHAND,2008,Public Sector Undertaking,0,2,2,1,0,5,0,0,0,1,0,1,6
UTTARAKHAND,2008,Student,0,4,2,0,0,6,2,5,0,0,0,7,13
UTTARAKHAND,2008,Unemployed,0,5,0,0,0,5,0,1,1,0,0,2,7
UTTARAKHAND,2008,Self-employed (Business activity),0,3,2,1,0,6,0,0,0,0,0,0,6
UTTARAKHAND,2008,Professional Activity,0,0,0,0,0,0,0,0,0,0,0,0,0
UTTARAKHAND,2008,Farming/Agriculture Activity,0,6,10,5,0,21,0,4,2,1,0,7,28
UTTARAKHAND,2008,Others (Please Specify),2,2,5,2,2,13,1,12,2,0,0,15,28
UTTARAKHAND,2008,Retired Person,0,0,0,3,0,3,0,0,0,0,0,0,3
UTTARAKHAND,2008,Others (Please Specify),5,4,5,5,2,21,0,4,0,1,0,5,26
UTTARAKHAND,2008,Total,8,37,35,20,4,104,3,61,15,8,0,87,191
UTTARAKHAND,2008,Total Salaried,1,13,11,4,0,29,0,3,2,2,0,7,36
UTTARAKHAND,2008,Total Self-employed,2,11,17,8,2,40,1,16,4,1,0,22,62
WEST BENGAL,2008,House Wife,0,0,0,0,0,0,0,1607,1172,406,59,3244,3244
WEST BENGAL,2008,Service (Government),0,17,62,41,0,120,0,4,7,14,0,25,145
WEST BENGAL,2008,Service (Private),2,122,214,190,7,535,0,29,38,16,0,83,618
WEST BENGAL,2008,Public Sector Undertaking,0,58,275,201,3,537,1,19,43,22,0,85,622
WEST BENGAL,2008,Student,112,430,13,0,0,555,118,262,5,0,0,385,940
WEST BENGAL,2008,Unemployed,9,460,471,166,5,1111,15,152,212,66,1,446,1557
WEST BENGAL,2008,Self-employed (Business activity),0,242,403,210,27,882,0,16,30,6,0,52,934
WEST BENGAL,2008,Professional Activity,0,34,124,74,2,234,0,9,4,0,0,13,247
WEST BENGAL,2008,Farming/Agriculture Activity,0,161,311,159,29,660,0,33,50,12,4,99,759
WEST BENGAL,2008,Others (Please Specify),63,665,525,188,98,1539,25,324,167,106,30,652,2191
WEST BENGAL,2008,Retired Person,0,0,0,0,63,63,0,0,0,0,10,10,73
WEST BENGAL,2008,Others (Please Specify),89,617,929,364,134,2133,82,549,432,254,72,1389,3522
WEST BENGAL,2008,Total,275,2806,3327,1593,368,8369,241,3004,2160,902,176,6483,14852
WEST BENGAL,2008,Total Salaried,2,197,551,432,10,1192,1,52,88,52,0,193,1385
WEST BENGAL,2008,Total Self-employed,63,1102,1363,631,156,3315,25,382,251,124,34,816,4131
TOTAL (STATES),2008,House Wife,0,0,0,0,0,0,51,10560,8434,3514,1363,23922,23922
TOTAL (STATES),2008,Service (Government),0,318,765,598,14,1695,0,129,132,60,12,333,2028
TOTAL (STATES),2008,Service (Private),7,2452,3568,2081,300,8408,8,974,534,217,49,1782,10190
TOTAL (STATES),2008,Public Sector Undertaking,4,620,1024,774,134,2556,3,213,137,122,35,510,3066
TOTAL (STATES),2008,Student,499,2544,184,35,4,3266,560,1952,56,4,0,2572,5838
TOTAL (STATES),2008,Unemployed,42,2822,2411,1286,307,6868,27,852,597,244,27,1747,8615
TOTAL (STATES),2008,Self-employed (Business activity),2,1479,3192,1533,350,6556,4,151,197,56,13,421,6977
TOTAL (STATES),2008,Professional Activity,5,743,1295,782,197,3022,5,174,127,49,20,375,3397
TOTAL (STATES),2008,Farming/Agriculture Activity,32,3451,5388,3713,1497,14081,38,750,755,368,136,2047,16128
TOTAL (STATES),2008,Others (Please Specify),214,5463,6163,4375,1869,18084,157,2044,1241,766,386,4594,22678
TOTAL (STATES),2008,Retired Person,0,12,35,145,553,745,0,3,6,20,103,132,877
TOTAL (STATES),2008,Others (Please Specify),341,3963,5020,3255,1353,13932,345,1947,1640,905,417,5254,19186
TOTAL (STATES),2008,Total,1146,23867,29045,18577,6578,79213,1198,19749,13856,6325,2561,43689,122902
TOTAL (STATES),2008,Total Salaried,11,3390,5357,3453,448,12659,11,1316,803,399,96,2625,15284
TOTAL (STATES),2008,Total Self-employed,253,11136,16038,10403,3913,41743,204,3119,2320,1239,555,7437,49180
A & N ISLANDS,2008,House Wife,0,0,0,0,0,0,0,10,13,5,4,32,32
A & N ISLANDS,2008,Service (Government),0,2,2,3,0,7,0,0,0,0,0,0,7
A & N ISLANDS,2008,Service (Private),0,17,15,8,3,43,0,1,0,0,0,1,44
A & N ISLANDS,2008,Public Sector Undertaking,0,0,0,0,0,0,0,0,0,0,0,0,0
A & N ISLANDS,2008,Student,0,4,0,0,0,4,0,7,0,0,0,7,11
A & N ISLANDS,2008,Unemployed,0,2,1,0,2,5,0,0,0,0,0,0,5
A & N ISLANDS,2008,Self-employed (Business activity),0,0,1,0,0,1,0,0,0,0,0,0,1
A & N ISLANDS,2008,Professional Activity,0,0,0,0,0,0,0,0,0,0,0,0,0
A & N ISLANDS,2008,Farming/Agriculture Activity,0,5,8,6,4,23,0,0,0,0,0,0,23
A & N ISLANDS,2008,Others (Please Specify),0,0,2,1,1,4,0,0,0,0,0,0,4
A & N ISLANDS,2008,Retired Person,0,0,0,1,3,4,0,0,0,0,0,0,4
A & N ISLANDS,2008,Others (Please Specify),0,1,3,2,1,7,0,5,0,0,0,5,12
A & N ISLANDS,2008,Total,0,31,32,21,14,98,0,23,13,5,4,45,143
A & N ISLANDS,2008,Total Salaried,0,19,17,11,3,50,0,1,0,0,0,1,51
A & N ISLANDS,2008,Total Self-employed,0,5,11,7,5,28,0,0,0,0,0,0,28
CHANDIGARH,2008,House Wife,0,0,0,0,0,0,0,8,7,2,0,17,17
CHANDIGARH,2008,Service (Government),0,0,2,1,0,3,0,0,0,0,0,0,3
CHANDIGARH,2008,Service (Private),0,4,7,4,0,15,0,3,0,0,0,3,18
CHANDIGARH,2008,Public Sector Undertaking,0,0,0,0,0,0,0,0,0,0,0,0,0
CHANDIGARH,2008,Student,0,6,0,0,0,6,0,5,0,0,0,5,11
CHANDIGARH,2008,Unemployed,0,10,7,6,0,23,0,0,0,0,0,0,23
CHANDIGARH,2008,Self-employed (Business activity),0,2,3,3,0,8,0,0,0,0,0,0,8
CHANDIGARH,2008,Professional Activity,0,0,0,1,0,1,0,0,0,0,0,0,1
CHANDIGARH,2008,Farming/Agriculture Activity,0,0,0,0,0,0,0,0,0,0,0,0,0
CHANDIGARH,2008,Others (Please Specify),0,0,0,0,0,0,0,0,0,0,0,0,0
CHANDIGARH,2008,Retired Person,0,0,0,1,1,2,0,0,0,0,0,0,2
CHANDIGARH,2008,Others (Please Specify),0,0,0,0,0,0,0,0,0,0,0,0,0
CHANDIGARH,2008,Total,0,22,19,16,1,58,0,16,7,2,0,25,83
CHANDIGARH,2008,Total Salaried,0,4,9,5,0,18,0,3,0,0,0,3,21
CHANDIGARH,2008,Total Self-employed,0,2,3,4,0,9,0,0,0,0,0,0,9
D & N HAVELI,2008,House Wife,0,0,0,0,0,0,0,10,6,6,1,23,23
D & N HAVELI,2008,Service (Government),0,0,0,1,0,1,0,0,0,0,0,0,1
D & N HAVELI,2008,Service (Private),0,8,4,1,0,13,0,4,0,0,0,4,17
D & N HAVELI,2008,Public Sector Undertaking,0,0,0,0,0,0,0,0,0,0,0,0,0
D & N HAVELI,2008,Student,0,0,0,0,0,0,0,1,0,0,0,1,1
D & N HAVELI,2008,Unemployed,0,0,0,0,0,0,0,0,0,0,0,0,0
D & N HAVELI,2008,Self-employed (Business activity),0,0,1,0,0,1,0,0,0,0,0,0,1
D & N HAVELI,2008,Professional Activity,0,0,0,0,0,0,0,0,0,0,0,0,0
D & N HAVELI,2008,Farming/Agriculture Activity,0,1,6,4,1,12,0,0,0,0,0,0,12
D & N HAVELI,2008,Others (Please Specify),0,0,0,0,0,0,0,0,0,0,0,0,0
D & N HAVELI,2008,Retired Person,0,0,0,0,0,0,0,0,0,0,0,0,0
D & N HAVELI,2008,Others (Please Specify),1,2,0,2,0,5,0,0,0,0,0,0,5
D & N HAVELI,2008,Total,1,11,11,8,1,32,0,15,6,6,1,28,60
D & N HAVELI,2008,Total Salaried,0,8,4,2,0,14,0,4,0,0,0,4,18
D & N HAVELI,2008,Total Self-employed,0,1,7,4,1,13,0,0,0,0,0,0,13
DAMAN & DIU,2008,House Wife,0,0,0,0,0,0,0,0,0,0,0,0,0
DAMAN & DIU,2008,Service (Government),0,0,0,1,0,1,0,0,0,0,0,0,1
DAMAN & DIU,2008,Service (Private),0,3,3,2,0,8,0,0,0,0,0,0,8
DAMAN & DIU,2008,Public Sector Undertaking,0,0,0,0,0,0,0,0,0,0,0,0,0
DAMAN & DIU,2008,Student,0,0,0,0,0,0,0,0,0,0,0,0,0
DAMAN & DIU,2008,Unemployed,0,0,0,2,0,2,0,1,0,0,0,1,3
DAMAN & DIU,2008,Self-employed (Business activity),0,0,0,1,0,1,0,0,0,0,0,0,1
DAMAN & DIU,2008,Professional Activity,0,0,0,0,0,0,0,0,0,0,0,0,0
DAMAN & DIU,2008,Farming/Agriculture Activity,0,0,0,0,0,0,0,0,0,0,0,0,0
DAMAN & DIU,2008,Others (Please Specify),0,0,1,0,0,1,0,0,0,0,0,0,1
DAMAN & DIU,2008,Retired Person,0,0,0,0,0,0,0,0,0,0,0,0,0
DAMAN & DIU,2008,Others (Please Specify),0,1,0,0,0,1,0,0,0,1,3,4,5
DAMAN & DIU,2008,Total,0,4,4,6,0,14,0,1,0,1,3,5,19
DAMAN & DIU,2008,Total Salaried,0,3,3,3,0,9,0,0,0,0,0,0,9
DAMAN & DIU,2008,Total Self-employed,0,0,1,1,0,2,0,0,0,0,0,0,2
DELHI (UT),2008,House Wife,0,0,0,0,0,0,0,166,89,19,2,276,276
DELHI (UT),2008,Service (Government),0,2,7,4,0,13,0,0,1,1,0,2,15
DELHI (UT),2008,Service (Private),0,78,82,24,2,186,0,18,7,2,0,27,213
DELHI (UT),2008,Public Sector Undertaking,0,16,12,3,4,35,0,3,0,0,0,3,38
DELHI (UT),2008,Student,13,63,1,0,0,77,13,79,6,0,0,98,175
DELHI (UT),2008,Unemployed,1,99,84,22,5,211,1,36,4,0,0,41,252
DELHI (UT),2008,Self-employed (Business activity),0,7,10,4,0,21,0,0,0,0,0,0,21
DELHI (UT),2008,Professional Activity,0,0,3,3,1,7,0,0,0,0,0,0,7
DELHI (UT),2008,Farming/Agriculture Activity,0,5,5,2,3,15,1,0,0,0,0,1,16
DELHI (UT),2008,Others (Please Specify),2,58,51,27,8,146,1,18,4,2,0,25,171
DELHI (UT),2008,Retired Person,0,0,0,1,1,2,0,0,0,0,0,0,2
DELHI (UT),2008,Others (Please Specify),0,43,31,7,1,82,2,27,4,1,1,35,117
DELHI (UT),2008,Total,16,371,286,97,25,795,18,347,115,25,3,508,1303
DELHI (UT),2008,Total Salaried,0,96,101,31,6,234,0,21,8,3,0,32,266
DELHI (UT),2008,Total Self-employed,2,70,69,36,12,189,2,18,4,2,0,26,215
LAKSHADWEEP,2008,House Wife,0,0,0,0,0,0,0,0,0,0,0,0,0
LAKSHADWEEP,2008,Service (Government),0,0,0,0,0,0,0,0,0,0,0,0,0
LAKSHADWEEP,2008,Service (Private),0,0,0,0,0,0,0,0,0,0,0,0,0
LAKSHADWEEP,2008,Public Sector Undertaking,0,0,0,0,0,0,0,0,0,0,0,0,0
LAKSHADWEEP,2008,Student,0,0,0,0,0,0,0,0,0,0,0,0,0
LAKSHADWEEP,2008,Unemployed,0,0,0,0,0,0,0,0,0,0,0,0,0
LAKSHADWEEP,2008,Self-employed (Business activity),0,0,0,0,0,0,0,0,0,0,0,0,0
LAKSHADWEEP,2008,Professional Activity,0,0,0,0,0,0,0,0,0,0,0,0,0
LAKSHADWEEP,2008,Farming/Agriculture Activity,0,0,0,0,0,0,0,0,0,0,0,0,0
LAKSHADWEEP,2008,Others (Please Specify),0,0,0,0,0,0,0,0,0,0,0,0,0
LAKSHADWEEP,2008,Retired Person,0,0,0,0,0,0,0,0,0,0,0,0,0
LAKSHADWEEP,2008,Others (Please Specify),0,0,0,0,0,0,0,0,0,0,0,0,0
LAKSHADWEEP,2008,Total,0,0,0,0,0,0,0,0,0,0,0,0,0
LAKSHADWEEP,2008,Total Salaried,0,0,0,0,0,0,0,0,0,0,0,0,0
LAKSHADWEEP,2008,Total Self-employed,0,0,0,0,0,0,0,0,0,0,0,0,0
PUDUCHERRY,2008,House Wife,0,0,0,0,0,0,0,45,32,8,12,97,97
PUDUCHERRY,2008,Service (Government),0,3,2,4,0,9,0,2,3,0,1,6,15
PUDUCHERRY,2008,Service (Private),0,2,3,3,1,9,0,2,0,0,0,2,11
PUDUCHERRY,2008,Public Sector Undertaking,0,0,0,0,0,0,0,3,0,0,0,3,3
PUDUCHERRY,2008,Student,2,10,3,0,0,15,0,9,0,0,0,9,24
PUDUCHERRY,2008,Unemployed,0,22,18,9,13,62,0,33,8,0,0,41,103
PUDUCHERRY,2008,Self-employed (Business activity),0,1,3,3,0,7,0,0,0,0,0,0,7
PUDUCHERRY,2008,Professional Activity,0,0,0,0,0,0,0,0,0,0,0,0,0
PUDUCHERRY,2008,Farming/Agriculture Activity,0,2,9,3,0,14,0,2,1,0,0,3,17
PUDUCHERRY,2008,Others (Please Specify),0,47,84,72,12,215,0,9,2,1,0,12,227
PUDUCHERRY,2008,Retired Person,0,1,0,0,0,1,0,0,0,0,0,0,1
PUDUCHERRY,2008,Others (Please Specify),0,2,0,0,0,2,0,0,0,0,0,0,2
PUDUCHERRY,2008,Total,2,90,122,94,26,334,0,105,46,9,13,173,507
PUDUCHERRY,2008,Total Salaried,0,5,5,7,1,18,0,7,3,0,1,11,29
PUDUCHERRY,2008,Total Self-employed,0,50,96,78,12,236,0,11,3,1,0,15,251
TOTAL (UTs),2008,House Wife,0,0,0,0,0,0,0,239,147,40,19,445,445
TOTAL (UTs),2008,Service (Government),0,7,13,14,0,34,0,2,4,1,1,8,42
TOTAL (UTs),2008,Service (Private),0,112,114,42,6,274,0,28,7,2,0,37,311
TOTAL (UTs),2008,Public Sector Undertaking,0,16,12,3,4,35,0,6,0,0,0,6,41
TOTAL (UTs),2008,Student,15,83,4,0,0,102,13,101,6,0,0,120,222
TOTAL (UTs),2008,Unemployed,1,133,110,39,20,303,1,70,12,0,0,83,386
TOTAL (UTs),2008,Self-employed (Business activity),0,10,18,11,0,39,0,0,0,0,0,0,39
TOTAL (UTs),2008,Professional Activity,0,0,3,4,1,8,0,0,0,0,0,0,8
TOTAL (UTs),2008,Farming/Agriculture Activity,0,13,28,15,8,64,1,2,1,0,0,4,68
TOTAL (UTs),2008,Others (Please Specify),2,105,138,100,21,366,1,27,6,3,0,37,403
TOTAL (UTs),2008,Retired Person,0,1,0,3,5,9,0,0,0,0,0,0,9
TOTAL (UTs),2008,Others (Please Specify),1,49,34,11,2,97,2,32,4,2,4,44,141
TOTAL (UTs),2008,Total,19,529,474,242,67,1331,18,507,187,48,24,784,2115
TOTAL (UTs),2008,Total Salaried,0,135,139,59,10,343,0,36,11,3,1,51,394
TOTAL (UTs),2008,Total Self-employed,2,128,187,130,30,477,2,29,7,3,0,41,518
TOTAL (ALL INDIA),2008,House Wife,0,0,0,0,0,0,51,10799,8581,3554,1382,24367,24367
TOTAL (ALL INDIA),2008,Service (Government),0,325,778,612,14,1729,0,131,136,61,13,341,2070
TOTAL (ALL INDIA),2008,Service (Private),7,2564,3682,2123,306,8682,8,1002,541,219,49,1819,10501
TOTAL (ALL INDIA),2008,Public Sector Undertaking,4,636,1036,777,138,2591,3,219,137,122,35,516,3107
TOTAL (ALL INDIA),2008,Student,514,2627,188,35,4,3368,573,2053,62,4,0,2692,6060
TOTAL (ALL INDIA),2008,Unemployed,43,2955,2521,1325,327,7171,28,922,609,244,27,1830,9001
TOTAL (ALL INDIA),2008,Self-employed (Business activity),2,1489,3210,1544,350,6595,4,151,197,56,13,421,7016
TOTAL (ALL INDIA),2008,Professional Activity,5,743,1298,786,198,3030,5,174,127,49,20,375,3405
TOTAL (ALL INDIA),2008,Farming/Agriculture Activity,32,3464,5416,3728,1505,14145,39,752,756,368,136,2051,16196
TOTAL (ALL INDIA),2008,Others (Please Specify),216,5568,6301,4475,1890,18450,158,2071,1247,769,386,4631,23081
TOTAL (ALL INDIA),2008,Retired Person,0,13,35,148,558,754,0,3,6,20,103,132,886
TOTAL (ALL INDIA),2008,Others (Please Specify),342,4012,5054,3266,1355,14029,347,1979,1644,907,421,5298,19327
TOTAL (ALL INDIA),2008,Total,1165,24396,29519,18819,6645,80544,1216,20256,14043,6373,2585,44473,125017
TOTAL (ALL INDIA),2008,Total Salaried,11,3525,5496,3512,458,13002,11,1352,814,402,97,2676,15678
TOTAL (ALL INDIA),2008,Total Self-employed,255,11264,16225,10533,3943,42220,206,3148,2327,1242,555,7478,49698
