STATE/UT,Year,CAUSE,Male upto 14 years,Male 15-29 years,Male 30-44 years,Male 45-59 years,Male 60 years and above,Total Male,Female upto 14 years,Female 15-29 years,Female 30-44 years,Female 45-59 years,Female 60 years and above,Total Female,Grand Total
ANDHRA PRADESH,2010,House Wife,0,0,0,0,0,0,0,1067,879,409,246,2601,2601
ANDHRA PRADESH,2010,Service (Government),0,39,96,52,0,187,0,41,31,0,0,72,259
ANDHRA PRADESH,2010,Service (Private),0,352,361,198,18,929,0,58,36,11,9,114,1043
ANDHRA PRADESH,2010,Public Sector Undertaking,0,156,184,96,49,485,0,9,29,9,0,47,532
ANDHRA PRADESH,2010,Student,41,333,0,0,0,374,62,220,0,0,0,282,656
ANDHRA PRADESH,2010,Unemployed,0,266,208,87,0,561,0,27,48,0,0,75,636
ANDHRA PRADESH,2010,Self-employed (Business activity),0,324,371,192,50,937,0,43,2,10,3,58,995
ANDHRA PRADESH,2010,Professional Activity,0,86,75,37,20,218,0,6,1,2,1,10,228
ANDHRA PRADESH,2010,Farming/Agriculture Activity,4,563,824,573,166,2130,12,165,137,40,41,395,2525
ANDHRA PRADESH,2010,Others (Please Specify),32,963,1216,894,368,3473,29,343,187,112,76,747,4220
ANDHRA PRADESH,2010,Retired Person,0,0,0,9,57,66,0,0,0,11,7,18,84
ANDHRA PRADESH,2010,Others (Please Specify),18,448,527,428,166,1587,27,166,222,74,46,535,2122
ANDHRA PRADESH,2010,Total,95,3530,3862,2566,894,10947,130,2145,1572,678,429,4954,15901
ANDHRA PRADESH,2010,Total Salaried,0,547,641,346,67,1601,0,108,96,20,9,233,1834
ANDHRA PRADESH,2010,Total Self-employed,36,1936,2486,1696,604,6758,41,557,327,164,121,1210,7968
ARUNACHAL PRADESH,2010,House Wife,0,0,0,0,0,0,0,9,7,1,0,17,17
ARUNACHAL PRADESH,2010,Service (Government),0,6,4,1,0,11,0,0,0,0,0,0,11
ARUNACHAL PRADESH,2010,Service (Private),0,3,5,1,0,9,0,0,1,0,0,1,10
ARUNACHAL PRADESH,2010,Public Sector Undertaking,0,0,0,0,0,0,0,0,0,0,0,0,0
ARUNACHAL PRADESH,2010,Student,4,4,0,0,0,8,4,4,0,0,0,8,16
ARUNACHAL PRADESH,2010,Unemployed,0,2,4,0,0,6,0,1,0,0,0,1,7
ARUNACHAL PRADESH,2010,Self-employed (Business activity),0,4,0,0,0,4,0,0,0,0,0,0,4
ARUNACHAL PRADESH,2010,Professional Activity,0,0,0,0,0,0,0,0,0,0,0,0,0
ARUNACHAL PRADESH,2010,Farming/Agriculture Activity,0,7,9,1,1,18,0,0,0,0,0,0,18
ARUNACHAL PRADESH,2010,Others (Please Specify),0,4,4,3,1,12,0,0,0,0,0,0,12
ARUNACHAL PRADESH,2010,Retired Person,0,0,0,0,0,0,0,0,0,0,0,0,0
ARUNACHAL PRADESH,2010,Others (Please Specify),0,17,6,0,0,23,0,12,0,1,0,13,36
ARUNACHAL PRADESH,2010,Total,4,47,32,6,2,91,4,26,8,2,0,40,131
ARUNACHAL PRADESH,2010,Total Salaried,0,9,9,2,0,20,0,0,1,0,0,1,21
ARUNACHAL PRADESH,2010,Total Self-employed,0,15,13,4,2,34,0,0,0,0,0,0,34
ASSAM,2010,House Wife,0,0,0,0,0,0,0,205,146,55,9,415,415
ASSAM,2010,Service (Government),0,2,7,9,0,18,0,1,0,0,0,1,19
ASSAM,2010,Service (Private),0,19,28,10,0,57,0,11,5,0,0,16,73
ASSAM,2010,Public Sector Undertaking,0,19,51,26,2,98,0,2,12,6,0,20,118
ASSAM,2010,Student,20,128,0,0,0,148,14,85,0,0,0,99,247
ASSAM,2010,Unemployed,0,3,28,34,1,66,0,12,2,2,0,16,82
ASSAM,2010,Self-employed (Business activity),0,112,163,95,1,371,0,36,23,11,0,70,441
ASSAM,2010,Professional Activity,0,59,45,29,3,136,0,7,3,0,0,10,146
ASSAM,2010,Farming/Agriculture Activity,0,132,126,82,12,352,0,6,9,1,1,17,369
ASSAM,2010,Others (Please Specify),9,189,219,112,36,565,8,96,83,42,9,238,803
ASSAM,2010,Retired Person,0,0,2,2,6,10,0,0,0,0,0,0,10
ASSAM,2010,Others (Please Specify),5,82,66,43,9,205,10,28,19,5,3,65,270
ASSAM,2010,Total,34,745,735,442,70,2026,32,489,302,122,22,967,2993
ASSAM,2010,Total Salaried,0,40,86,45,2,173,0,14,17,6,0,37,210
ASSAM,2010,Total Self-employed,9,492,553,318,52,1424,8,145,118,54,10,335,1759
BIHAR,2010,House Wife,0,0,0,0,0,0,0,80,89,26,9,204,204
BIHAR,2010,Service (Government),0,6,5,2,0,13,0,2,6,0,0,8,21
BIHAR,2010,Service (Private),0,23,12,5,1,41,2,2,3,1,0,8,49
BIHAR,2010,Public Sector Undertaking,0,2,0,0,0,2,0,0,0,0,0,0,2
BIHAR,2010,Student,12,21,6,0,0,39,14,13,8,0,0,35,74
BIHAR,2010,Unemployed,0,36,28,9,0,73,3,3,6,3,0,15,88
BIHAR,2010,Self-employed (Business activity),0,4,6,2,0,12,0,2,2,0,0,4,16
BIHAR,2010,Professional Activity,0,2,2,1,0,5,0,0,0,0,0,0,5
BIHAR,2010,Farming/Agriculture Activity,0,27,39,20,5,91,0,3,1,0,0,4,95
BIHAR,2010,Others (Please Specify),12,49,108,80,15,264,7,17,25,2,0,51,315
BIHAR,2010,Retired Person,0,0,0,0,1,1,0,0,0,0,2,2,3
BIHAR,2010,Others (Please Specify),16,58,66,17,14,171,28,105,19,21,10,183,354
BIHAR,2010,Total,40,228,272,136,36,712,54,227,159,53,21,514,1226
BIHAR,2010,Total Salaried,0,31,17,7,1,56,2,4,9,1,0,16,72
BIHAR,2010,Total Self-employed,12,82,155,103,20,372,7,22,28,2,0,59,431
CHHATTISGARH,2010,House Wife,0,0,0,0,0,0,2,453,286,91,30,862,862
CHHATTISGARH,2010,Service (Government),0,8,16,14,0,38,0,1,0,1,0,2,40
CHHATTISGARH,2010,Service (Private),0,127,103,55,2,287,0,22,18,2,2,44,331
CHHATTISGARH,2010,Public Sector Undertaking,0,16,13,15,0,44,0,0,0,0,0,0,44
CHHATTISGARH,2010,Student,47,166,9,1,0,223,24,125,5,0,0,154,377
CHHATTISGARH,2010,Unemployed,4,177,306,104,2,593,2,13,4,0,0,19,612
CHHATTISGARH,2010,Self-employed (Business activity),0,42,31,18,7,98,0,2,4,0,0,6,104
CHHATTISGARH,2010,Professional Activity,0,86,95,40,10,231,0,2,1,1,0,4,235
CHHATTISGARH,2010,Farming/Agriculture Activity,3,196,274,219,86,778,2,65,137,103,41,348,1126
CHHATTISGARH,2010,Others (Please Specify),0,294,423,411,175,1303,5,93,113,47,26,284,1587
CHHATTISGARH,2010,Retired Person,0,0,0,0,1,1,0,0,0,0,0,0,1
CHHATTISGARH,2010,Others (Please Specify),56,272,268,225,128,949,23,86,79,47,19,254,1203
CHHATTISGARH,2010,Total,110,1384,1538,1102,411,4545,58,862,647,292,118,1977,6522
CHHATTISGARH,2010,Total Salaried,0,151,132,84,2,369,0,23,18,3,2,46,415
CHHATTISGARH,2010,Total Self-employed,3,618,823,688,278,2410,7,162,255,151,67,642,3052
GOA,2010,House Wife,0,0,0,0,0,0,0,14,18,9,11,52,52
GOA,2010,Service (Government),0,1,4,4,0,9,0,0,0,0,0,0,9
GOA,2010,Service (Private),0,24,31,11,1,67,0,3,0,0,0,3,70
GOA,2010,Public Sector Undertaking,0,1,1,0,0,2,0,0,0,0,0,0,2
GOA,2010,Student,2,10,1,0,0,13,2,8,0,0,0,10,23
GOA,2010,Unemployed,0,15,19,14,3,51,1,7,2,0,0,10,61
GOA,2010,Self-employed (Business activity),0,2,4,5,0,11,0,0,0,0,0,0,11
GOA,2010,Professional Activity,0,0,0,1,0,1,0,0,0,0,0,0,1
GOA,2010,Farming/Agriculture Activity,0,2,3,3,7,15,0,0,0,0,0,0,15
GOA,2010,Others (Please Specify),0,5,5,4,4,18,0,0,0,0,0,0,18
GOA,2010,Retired Person,0,0,0,0,3,3,0,0,0,0,0,0,3
GOA,2010,Others (Please Specify),0,9,13,21,3,46,0,5,1,0,5,11,57
GOA,2010,Total,2,69,81,63,21,236,3,37,21,9,16,86,322
GOA,2010,Total Salaried,0,26,36,15,1,78,0,3,0,0,0,3,81
GOA,2010,Total Self-employed,0,9,12,13,11,45,0,0,0,0,0,0,45
GUJARAT,2010,House Wife,0,0,0,0,0,0,2,726,512,253,82,1575,1575
GUJARAT,2010,Service (Government),0,17,31,14,0,62,0,6,5,2,0,13,75
GUJARAT,2010,Service (Private),0,197,202,116,9,524,0,42,44,11,1,98,622
GUJARAT,2010,Public Sector Undertaking,0,23,31,20,3,77,0,11,7,6,0,24,101
GUJARAT,2010,Student,19,125,6,1,0,151,18,121,3,0,0,142,293
GUJARAT,2010,Unemployed,1,217,231,81,18,548,0,39,17,5,0,61,609
GUJARAT,2010,Self-employed (Business activity),1,151,185,70,21,428,6,8,12,11,2,39,467
GUJARAT,2010,Professional Activity,2,116,127,63,13,321,0,10,5,4,0,19,340
GUJARAT,2010,Farming/Agriculture Activity,1,127,201,104,25,458,1,18,25,17,4,65,523
GUJARAT,2010,Others (Please Specify),3,193,203,168,32,599,4,58,34,26,8,130,729
GUJARAT,2010,Retired Person,0,2,1,11,85,99,0,0,0,8,44,52,151
GUJARAT,2010,Others (Please Specify),10,175,194,110,57,546,11,66,58,24,17,176,722
GUJARAT,2010,Total,37,1343,1412,758,263,3813,42,1105,722,367,158,2394,6207
GUJARAT,2010,Total Salaried,0,237,264,150,12,663,0,59,56,19,1,135,798
GUJARAT,2010,Total Self-employed,7,587,716,405,91,1806,11,94,76,58,14,253,2059
HARYANA,2010,House Wife,0,0,0,0,0,0,0,174,124,50,16,364,364
HARYANA,2010,Service (Government),0,14,16,10,0,40,0,24,18,3,0,45,85
HARYANA,2010,Service (Private),0,78,72,42,2,194,0,18,7,2,0,27,221
HARYANA,2010,Public Sector Undertaking,0,8,2,1,0,11,1,4,0,0,0,5,16
HARYANA,2010,Student,12,101,6,0,0,119,8,21,0,0,0,29,148
HARYANA,2010,Unemployed,3,143,118,67,16,347,0,21,9,4,3,37,384
HARYANA,2010,Self-employed (Business activity),0,16,12,16,2,46,0,0,0,0,0,0,46
HARYANA,2010,Professional Activity,0,14,17,13,1,45,0,0,0,0,0,0,45
HARYANA,2010,Farming/Agriculture Activity,0,94,103,59,25,281,0,9,5,2,0,16,297
HARYANA,2010,Others (Please Specify),2,190,183,133,45,553,5,11,20,9,5,50,603
HARYANA,2010,Retired Person,0,0,0,0,0,0,0,0,0,0,0,0,0
HARYANA,2010,Others (Please Specify),7,181,209,114,31,542,3,38,59,39,5,144,686
HARYANA,2010,Total,24,839,738,455,122,2178,17,320,242,109,29,717,2895
HARYANA,2010,Total Salaried,0,100,90,53,2,245,1,46,25,5,0,77,322
HARYANA,2010,Total Self-employed,2,314,315,221,73,925,5,20,25,11,5,66,991
HIMACHAL PRADESH,2010,House Wife,0,0,0,0,0,0,0,44,24,15,5,88,88
HIMACHAL PRADESH,2010,Service (Government),0,2,7,11,0,20,0,1,1,1,0,3,23
HIMACHAL PRADESH,2010,Service (Private),0,10,17,9,2,38,0,4,2,1,0,7,45
HIMACHAL PRADESH,2010,Public Sector Undertaking,0,3,6,2,1,12,0,2,1,2,1,6,18
HIMACHAL PRADESH,2010,Student,7,26,0,0,0,33,4,27,2,0,0,33,66
HIMACHAL PRADESH,2010,Unemployed,0,24,23,4,1,52,0,2,1,0,0,3,55
HIMACHAL PRADESH,2010,Self-employed (Business activity),0,4,5,7,3,19,0,1,2,1,1,5,24
HIMACHAL PRADESH,2010,Professional Activity,0,10,4,6,1,21,0,0,1,0,0,1,22
HIMACHAL PRADESH,2010,Farming/Agriculture Activity,0,12,24,15,8,59,0,2,0,0,0,2,61
HIMACHAL PRADESH,2010,Others (Please Specify),0,14,15,7,1,37,0,7,7,5,3,22,59
HIMACHAL PRADESH,2010,Retired Person,0,0,1,4,2,7,0,0,0,0,0,0,7
HIMACHAL PRADESH,2010,Others (Please Specify),1,12,23,8,6,50,0,7,10,6,1,24,74
HIMACHAL PRADESH,2010,Total,8,117,125,73,25,348,4,97,51,31,11,194,542
HIMACHAL PRADESH,2010,Total Salaried,0,15,30,22,3,70,0,7,4,4,1,16,86
HIMACHAL PRADESH,2010,Total Self-employed,0,40,48,35,13,136,0,10,10,6,4,30,166
JAMMU & KASHMIR,2010,House Wife,0,0,0,0,0,0,0,30,24,4,0,58,58
JAMMU & KASHMIR,2010,Service (Government),0,2,2,0,0,4,0,1,1,0,0,2,6
JAMMU & KASHMIR,2010,Service (Private),0,1,9,3,0,13,0,0,0,0,0,0,13
JAMMU & KASHMIR,2010,Public Sector Undertaking,0,1,1,0,0,2,0,0,0,0,0,0,2
JAMMU & KASHMIR,2010,Student,3,11,3,0,0,17,2,12,3,2,0,19,36
JAMMU & KASHMIR,2010,Unemployed,0,12,11,4,0,27,1,12,3,0,0,16,43
JAMMU & KASHMIR,2010,Self-employed (Business activity),0,1,2,4,2,9,0,0,0,0,0,0,9
JAMMU & KASHMIR,2010,Professional Activity,0,2,0,0,0,2,0,0,1,0,0,1,3
JAMMU & KASHMIR,2010,Farming/Agriculture Activity,0,3,8,4,1,16,0,2,0,0,0,2,18
JAMMU & KASHMIR,2010,Others (Please Specify),0,5,1,3,3,12,0,7,2,0,0,9,21
JAMMU & KASHMIR,2010,Retired Person,0,0,0,1,0,1,0,0,0,0,0,0,1
JAMMU & KASHMIR,2010,Others (Please Specify),0,8,3,7,1,19,0,22,5,2,1,30,49
JAMMU & KASHMIR,2010,Total,3,46,40,26,7,122,3,86,39,8,1,137,259
JAMMU & KASHMIR,2010,Total Salaried,0,4,12,3,0,19,0,1,1,0,0,2,21
JAMMU & KASHMIR,2010,Total Self-employed,0,11,11,11,6,39,0,9,3,0,0,12,51
JHARKHAND,2010,House Wife,0,0,0,0,0,0,1,52,104,51,4,212,212
JHARKHAND,2010,Service (Government),0,1,3,4,0,8,0,0,1,1,0,2,10
JHARKHAND,2010,Service (Private),0,20,29,28,0,77,0,5,3,2,0,10,87
JHARKHAND,2010,Public Sector Undertaking,18,1,2,3,0,24,0,4,0,0,0,4,28
JHARKHAND,2010,Student,18,70,4,0,0,92,9,40,1,0,0,50,142
JHARKHAND,2010,Unemployed,0,34,41,13,0,88,0,8,4,0,0,12,100
JHARKHAND,2010,Self-employed (Business activity),0,8,13,6,0,27,0,2,2,0,0,4,31
JHARKHAND,2010,Professional Activity,0,3,4,2,0,9,0,0,0,0,0,0,9
JHARKHAND,2010,Farming/Agriculture Activity,10,47,58,30,5,150,0,13,6,4,0,23,173
JHARKHAND,2010,Others (Please Specify),2,33,64,31,2,132,0,33,9,15,5,62,194
JHARKHAND,2010,Retired Person,0,0,0,0,3,3,0,0,0,0,0,0,3
JHARKHAND,2010,Others (Please Specify),36,35,57,55,2,185,6,18,12,7,15,58,243
JHARKHAND,2010,Total,84,252,275,172,12,795,16,175,142,80,24,437,1232
JHARKHAND,2010,Total Salaried,18,22,34,35,0,109,0,9,4,3,0,16,125
JHARKHAND,2010,Total Self-employed,12,91,139,69,7,318,0,48,17,19,5,89,407
KARNATAKA,2010,House Wife,0,0,0,0,0,0,2,703,664,361,159,1889,1889
KARNATAKA,2010,Service (Government),0,37,60,65,16,178,0,17,17,4,2,40,218
KARNATAKA,2010,Service (Private),0,244,377,204,64,889,0,124,71,23,9,227,1116
KARNATAKA,2010,Public Sector Undertaking,0,85,79,58,32,254,0,15,12,14,0,41,295
KARNATAKA,2010,Student,43,238,9,22,7,319,89,176,7,0,0,272,591
KARNATAKA,2010,Unemployed,0,125,122,95,20,362,0,35,21,2,0,58,420
KARNATAKA,2010,Self-employed (Business activity),0,234,303,227,81,845,0,13,15,11,4,43,888
KARNATAKA,2010,Professional Activity,2,30,34,38,6,110,0,5,7,3,0,15,125
KARNATAKA,2010,Farming/Agriculture Activity,3,381,723,751,270,2128,11,159,128,111,48,457,2585
KARNATAKA,2010,Others (Please Specify),20,505,761,544,199,2029,27,234,168,161,47,637,2666
KARNATAKA,2010,Retired Person,0,0,2,29,60,91,0,0,0,2,7,9,100
KARNATAKA,2010,Others (Please Specify),19,191,395,355,242,1202,39,121,138,143,115,556,1758
KARNATAKA,2010,Total,87,2070,2865,2388,997,8407,168,1602,1248,835,391,4244,12651
KARNATAKA,2010,Total Salaried,0,366,516,327,112,1321,0,156,100,41,11,308,1629
KARNATAKA,2010,Total Self-employed,25,1150,1821,1560,556,5112,38,411,318,286,99,1152,6264
KERALA,2010,House Wife,0,0,0,0,0,0,0,270,370,349,230,1219,1219
KERALA,2010,Service (Government),0,7,28,27,0,62,0,1,5,3,0,9,71
KERALA,2010,Service (Private),0,66,149,158,7,380,0,28,33,13,0,74,454
KERALA,2010,Public Sector Undertaking,0,23,59,52,2,136,0,4,4,4,0,12,148
KERALA,2010,Student,56,72,1,0,0,129,44,140,0,0,0,184,313
KERALA,2010,Unemployed,1,162,248,214,207,832,1,52,55,32,70,210,1042
KERALA,2010,Self-employed (Business activity),0,57,148,163,96,464,0,1,3,9,2,15,479
KERALA,2010,Professional Activity,0,25,56,81,13,175,0,4,5,1,1,11,186
KERALA,2010,Farming/Agriculture Activity,0,98,242,264,193,797,0,28,26,14,30,98,895
KERALA,2010,Others (Please Specify),4,261,553,629,348,1795,1,43,70,47,31,192,1987
KERALA,2010,Retired Person,0,0,2,14,50,66,0,0,1,2,7,10,76
KERALA,2010,Others (Please Specify),3,269,487,569,182,1510,0,37,54,70,45,206,1716
KERALA,2010,Total,64,1040,1973,2171,1098,6346,46,608,626,544,416,2240,8586
KERALA,2010,Total Salaried,0,96,236,237,9,578,0,33,42,20,0,95,673
KERALA,2010,Total Self-employed,4,441,999,1137,650,3231,1,76,104,71,64,316,3547
MADHYA PRADESH,2010,House Wife,0,0,0,0,0,0,18,1366,815,255,110,2564,2564
MADHYA PRADESH,2010,Service (Government),0,19,48,29,6,102,0,3,5,4,0,12,114
MADHYA PRADESH,2010,Service (Private),0,149,108,66,21,344,2,24,18,8,6,58,402
MADHYA PRADESH,2010,Public Sector Undertaking,0,39,64,15,13,131,0,6,3,2,4,15,146
MADHYA PRADESH,2010,Student,73,175,8,12,0,268,51,135,5,0,0,191,459
MADHYA PRADESH,2010,Unemployed,10,133,111,42,12,308,8,44,12,2,0,66,374
MADHYA PRADESH,2010,Self-employed (Business activity),0,112,145,89,25,371,0,0,0,0,0,0,371
MADHYA PRADESH,2010,Professional Activity,0,93,97,73,29,292,3,10,12,3,0,28,320
MADHYA PRADESH,2010,Farming/Agriculture Activity,17,282,357,208,109,973,14,132,74,27,17,264,1237
MADHYA PRADESH,2010,Others (Please Specify),49,524,464,272,116,1425,36,265,133,68,27,529,1954
MADHYA PRADESH,2010,Retired Person,0,0,1,4,6,11,0,5,0,0,0,5,16
MADHYA PRADESH,2010,Others (Please Specify),66,264,265,180,87,862,29,85,28,23,19,184,1046
MADHYA PRADESH,2010,Total,215,1790,1668,990,424,5087,161,2075,1105,392,183,3916,9003
MADHYA PRADESH,2010,Total Salaried,0,207,220,110,40,577,2,33,26,14,10,85,662
MADHYA PRADESH,2010,Total Self-employed,66,1011,1063,642,279,3061,53,407,219,98,44,821,3882
MAHARASHTRA,2010,House Wife,0,0,0,0,0,0,0,1882,1098,405,254,3639,3639
MAHARASHTRA,2010,Service (Government),0,35,78,59,1,173,0,8,1,1,0,10,183
MAHARASHTRA,2010,Service (Private),0,559,739,376,40,1714,1,93,34,15,0,143,1857
MAHARASHTRA,2010,Public Sector Undertaking,0,40,69,28,6,143,0,3,1,0,0,4,147
MAHARASHTRA,2010,Student,46,427,8,1,0,482,82,492,0,0,0,574,1056
MAHARASHTRA,2010,Unemployed,0,365,305,108,41,819,2,60,20,6,1,89,908
MAHARASHTRA,2010,Self-employed (Business activity),0,143,172,100,24,439,0,3,3,0,0,6,445
MAHARASHTRA,2010,Professional Activity,0,265,376,270,129,1040,0,42,22,15,4,83,1123
MAHARASHTRA,2010,Farming/Agriculture Activity,0,784,1094,743,326,2947,2,79,68,33,12,194,3141
MAHARASHTRA,2010,Others (Please Specify),0,792,1020,586,270,2668,3,134,79,44,23,283,2951
MAHARASHTRA,2010,Retired Person,0,0,1,13,99,113,0,0,1,0,3,4,117
MAHARASHTRA,2010,Others (Please Specify),3,75,110,79,53,320,5,8,7,5,4,29,349
MAHARASHTRA,2010,Total,49,3485,3972,2363,989,10858,95,2804,1334,524,301,5058,15916
MAHARASHTRA,2010,Total Salaried,0,634,886,463,47,2030,1,104,36,16,0,157,2187
MAHARASHTRA,2010,Total Self-employed,0,1984,2662,1699,749,7094,5,258,172,92,39,566,7660
MANIPUR,2010,House Wife,0,0,0,0,0,0,0,6,1,1,0,8,8
MANIPUR,2010,Service (Government),0,1,3,2,0,6,0,0,0,0,0,0,6
MANIPUR,2010,Service (Private),0,0,0,0,0,0,0,0,0,0,0,0,0
MANIPUR,2010,Public Sector Undertaking,0,0,0,0,0,0,0,0,0,0,0,0,0
MANIPUR,2010,Student,0,1,0,0,0,1,0,0,0,0,0,0,1
MANIPUR,2010,Unemployed,0,4,7,1,0,12,0,0,0,0,0,0,12
MANIPUR,2010,Self-employed (Business activity),0,0,0,0,0,0,0,0,0,0,0,0,0
MANIPUR,2010,Professional Activity,0,0,0,0,0,0,0,0,0,0,0,0,0
MANIPUR,2010,Farming/Agriculture Activity,0,0,0,0,0,0,0,1,3,0,0,4,4
MANIPUR,2010,Others (Please Specify),0,0,0,0,0,0,0,0,0,0,0,0,0
MANIPUR,2010,Retired Person,0,0,0,0,0,0,0,0,0,0,0,0,0
MANIPUR,2010,Others (Please Specify),0,1,3,1,0,5,0,1,0,0,0,1,6
MANIPUR,2010,Total,0,7,13,4,0,24,0,8,4,1,0,13,37
MANIPUR,2010,Total Salaried,0,1,3,2,0,6,0,0,0,0,0,0,6
MANIPUR,2010,Total Self-employed,0,0,0,0,0,0,0,1,3,0,0,4,4
MEGHALAYA,2010,House Wife,0,0,0,0,0,0,0,7,5,1,1,14,14
MEGHALAYA,2010,Service (Government),0,2,4,2,0,8,0,0,0,0,0,0,8
MEGHALAYA,2010,Service (Private),0,6,1,4,0,11,0,0,0,0,0,0,11
MEGHALAYA,2010,Public Sector Undertaking,0,1,0,0,0,1,0,0,0,0,0,0,1
MEGHALAYA,2010,Student,2,10,2,0,0,14,1,5,1,0,0,7,21
MEGHALAYA,2010,Unemployed,0,5,8,2,0,15,0,1,1,0,0,2,17
MEGHALAYA,2010,Self-employed (Business activity),0,0,0,0,0,0,0,0,0,0,0,0,0
MEGHALAYA,2010,Professional Activity,0,0,1,0,0,1,0,0,0,0,0,0,1
MEGHALAYA,2010,Farming/Agriculture Activity,0,5,5,3,2,15,0,0,0,1,0,1,16
MEGHALAYA,2010,Others (Please Specify),0,2,0,1,2,5,0,1,1,0,0,2,7
MEGHALAYA,2010,Retired Person,0,0,0,0,1,1,0,0,0,0,0,0,1
MEGHALAYA,2010,Others (Please Specify),0,6,2,1,0,9,0,1,1,0,0,2,11
MEGHALAYA,2010,Total,2,37,23,13,5,80,1,15,9,2,1,28,108
MEGHALAYA,2010,Total Salaried,0,9,5,6,0,20,0,0,0,0,0,0,20
MEGHALAYA,2010,Total Self-employed,0,7,6,4,4,21,0,1,1,1,0,3,24
MIZORAM,2010,House Wife,0,0,0,0,0,0,0,0,0,0,0,0,0
MIZORAM,2010,Service (Government),0,10,10,2,1,23,0,4,0,0,0,4,27
MIZORAM,2010,Service (Private),2,0,0,0,0,2,0,0,1,0,0,1,3
MIZORAM,2010,Public Sector Undertaking,0,0,0,0,0,0,0,0,0,0,0,0,0
MIZORAM,2010,Student,2,0,0,0,0,2,0,0,0,0,0,0,2
MIZORAM,2010,Unemployed,0,10,5,3,1,19,0,2,0,0,0,2,21
MIZORAM,2010,Self-employed (Business activity),0,0,0,0,0,0,0,0,0,0,0,0,0
MIZORAM,2010,Professional Activity,0,0,0,0,0,0,0,0,0,0,0,0,0
MIZORAM,2010,Farming/Agriculture Activity,0,4,0,1,0,5,0,0,0,0,0,0,5
MIZORAM,2010,Others (Please Specify),0,0,0,0,0,0,0,0,0,0,0,0,0
MIZORAM,2010,Retired Person,0,0,0,0,0,0,0,0,0,0,0,0,0
MIZORAM,2010,Others (Please Specify),0,6,10,0,0,16,0,2,0,0,0,2,18
MIZORAM,2010,Total,4,30,25,6,2,67,0,8,1,0,0,9,76
MIZORAM,2010,Total Salaried,2,10,10,2,1,25,0,4,1,0,0,5,30
MIZORAM,2010,Total Self-employed,0,4,0,1,0,5,0,0,0,0,0,0,5
NAGALAND,2010,House Wife,0,0,0,0,0,0,0,1,0,0,0,1,1
NAGALAND,2010,Service (Government),0,1,0,1,0,2,0,0,0,0,0,0,2
NAGALAND,2010,Service (Private),0,0,0,0,0,0,0,0,0,0,0,0,0
NAGALAND,2010,Public Sector Undertaking,0,0,0,0,0,0,0,0,0,0,0,0,0
NAGALAND,2010,Student,0,0,2,0,0,2,0,0,0,0,0,0,2
NAGALAND,2010,Unemployed,0,2,2,0,0,4,0,0,0,0,0,0,4
NAGALAND,2010,Self-employed (Business activity),0,0,0,0,0,0,0,0,0,0,0,0,0
NAGALAND,2010,Professional Activity,0,1,2,0,0,3,0,0,0,0,0,0,3
NAGALAND,2010,Farming/Agriculture Activity,0,0,0,0,0,0,0,0,0,0,0,0,0
NAGALAND,2010,Others (Please Specify),0,0,0,0,0,0,0,0,0,0,0,0,0
NAGALAND,2010,Retired Person,0,0,0,0,0,0,0,0,0,0,0,0,0
NAGALAND,2010,Others (Please Specify),0,0,0,0,0,0,0,0,0,0,0,0,0
NAGALAND,2010,Total,0,4,6,1,0,11,0,1,0,0,0,1,12
NAGALAND,2010,Total Salaried,0,1,0,1,0,2,0,0,0,0,0,0,2
NAGALAND,2010,Total Self-employed,0,1,2,0,0,3,0,0,0,0,0,0,3
ODISHA,2010,House Wife,0,0,0,0,0,0,1,362,232,111,24,730,730
ODISHA,2010,Service (Government),0,2,7,2,0,11,0,2,1,1,0,4,15
ODISHA,2010,Service (Private),0,74,114,70,11,269,0,30,25,4,4,63,332
ODISHA,2010,Public Sector Undertaking,0,57,39,14,0,110,0,13,16,6,0,35,145
ODISHA,2010,Student,30,138,5,0,0,173,22,104,2,0,0,128,301
ODISHA,2010,Unemployed,11,142,103,36,2,294,7,47,25,7,4,90,384
ODISHA,2010,Self-employed (Business activity),0,52,115,70,7,244,0,3,14,2,0,19,263
ODISHA,2010,Professional Activity,0,15,34,15,10,74,0,2,3,2,2,9,83
ODISHA,2010,Farming/Agriculture Activity,0,17,77,36,15,145,0,0,12,5,0,17,162
ODISHA,2010,Others (Please Specify),41,211,244,212,54,762,39,186,154,99,24,502,1264
ODISHA,2010,Retired Person,0,0,0,1,23,24,0,0,0,1,2,3,27
ODISHA,2010,Others (Please Specify),17,89,104,77,37,324,8,104,70,36,7,225,549
ODISHA,2010,Total,99,797,842,533,159,2430,77,853,554,274,67,1825,4255
ODISHA,2010,Total Salaried,0,133,160,86,11,390,0,45,42,11,4,102,492
ODISHA,2010,Total Self-employed,41,295,470,333,86,1225,39,191,183,108,26,547,1772
PUNJAB,2010,House Wife,0,0,0,0,0,0,1,60,48,16,5,130,130
PUNJAB,2010,Service (Government),0,5,13,3,0,21,0,2,0,0,0,2,23
PUNJAB,2010,Service (Private),2,27,44,7,2,82,0,0,1,0,0,1,83
PUNJAB,2010,Public Sector Undertaking,0,0,0,0,0,0,0,0,0,0,0,0,0
PUNJAB,2010,Student,4,21,6,0,0,31,1,23,0,0,0,24,55
PUNJAB,2010,Unemployed,3,25,23,5,3,59,0,3,1,0,4,8,67
PUNJAB,2010,Self-employed (Business activity),0,20,16,4,1,41,0,0,0,0,0,0,41
PUNJAB,2010,Professional Activity,0,13,5,3,0,21,0,0,0,0,0,0,21
PUNJAB,2010,Farming/Agriculture Activity,0,27,31,12,10,80,0,0,0,0,0,0,80
PUNJAB,2010,Others (Please Specify),0,77,77,59,26,239,1,5,3,2,3,14,253
PUNJAB,2010,Retired Person,0,0,0,1,7,8,0,0,0,0,0,0,8
PUNJAB,2010,Others (Please Specify),1,44,44,33,15,137,0,11,8,3,0,22,159
PUNJAB,2010,Total,10,259,259,127,64,719,3,104,61,21,12,201,920
PUNJAB,2010,Total Salaried,2,32,57,10,2,103,0,2,1,0,0,3,106
PUNJAB,2010,Total Self-employed,0,137,129,78,37,381,1,5,3,2,3,14,395
RAJASTHAN,2010,House Wife,0,0,0,0,0,0,19,426,403,161,25,1034,1034
RAJASTHAN,2010,Service (Government),0,5,20,11,0,36,0,0,6,0,0,6,42
RAJASTHAN,2010,Service (Private),0,135,149,97,22,403,0,16,7,5,0,28,431
RAJASTHAN,2010,Public Sector Undertaking,0,8,10,13,3,34,0,3,3,0,0,6,40
RAJASTHAN,2010,Student,19,118,7,0,0,144,12,75,1,1,0,89,233
RAJASTHAN,2010,Unemployed,0,78,66,24,4,172,0,9,11,7,0,27,199
RAJASTHAN,2010,Self-employed (Business activity),0,55,89,26,6,176,0,2,2,1,0,5,181
RAJASTHAN,2010,Professional Activity,0,14,39,2,6,61,0,2,1,1,0,4,65
RAJASTHAN,2010,Farming/Agriculture Activity,2,114,146,66,23,351,0,20,13,6,0,39,390
RAJASTHAN,2010,Others (Please Specify),2,226,386,261,41,916,5,56,20,11,3,95,1011
RAJASTHAN,2010,Retired Person,0,14,7,9,5,35,0,6,0,0,0,6,41
RAJASTHAN,2010,Others (Please Specify),67,326,369,229,46,1037,31,86,63,28,8,216,1253
RAJASTHAN,2010,Total,90,1093,1288,738,156,3365,67,701,530,221,36,1555,4920
RAJASTHAN,2010,Total Salaried,0,148,179,121,25,473,0,19,16,5,0,40,513
RAJASTHAN,2010,Total Self-employed,4,409,660,355,76,1504,5,80,36,19,3,143,1647
SIKKIM,2010,House Wife,0,0,0,0,0,0,0,2,1,1,1,5,5
SIKKIM,2010,Service (Government),0,17,11,1,0,29,0,1,5,0,0,6,35
SIKKIM,2010,Service (Private),9,23,17,1,2,52,0,1,2,0,0,3,55
SIKKIM,2010,Public Sector Undertaking,0,11,7,3,0,21,0,5,5,0,0,10,31
SIKKIM,2010,Student,0,2,0,0,0,2,0,1,0,0,0,1,3
SIKKIM,2010,Unemployed,11,13,12,7,2,45,0,2,5,0,0,7,52
SIKKIM,2010,Self-employed (Business activity),0,11,10,0,2,23,0,0,0,1,0,1,24
SIKKIM,2010,Professional Activity,0,9,9,0,3,21,0,0,0,1,0,1,22
SIKKIM,2010,Farming/Agriculture Activity,1,5,5,7,1,19,0,0,0,0,0,0,19
SIKKIM,2010,Others (Please Specify),0,7,0,0,0,7,0,0,1,0,0,1,8
SIKKIM,2010,Retired Person,0,0,0,0,3,3,0,0,0,0,2,2,5
SIKKIM,2010,Others (Please Specify),0,0,0,11,2,13,0,1,0,7,0,8,21
SIKKIM,2010,Total,21,98,71,30,15,235,0,13,19,10,3,45,280
SIKKIM,2010,Total Salaried,9,51,35,5,2,102,0,7,12,0,0,19,121
SIKKIM,2010,Total Self-employed,1,32,24,7,6,70,0,0,1,2,0,3,73
TAMIL NADU,2010,House Wife,0,0,0,0,0,0,3,935,984,520,225,2667,2667
TAMIL NADU,2010,Service (Government),0,21,40,61,0,122,0,18,23,16,1,58,180
TAMIL NADU,2010,Service (Private),1,383,609,384,53,1430,0,152,84,67,2,305,1735
TAMIL NADU,2010,Public Sector Undertaking,0,53,122,78,11,264,0,28,37,12,0,77,341
TAMIL NADU,2010,Student,99,254,6,0,0,359,65,208,5,0,0,278,637
TAMIL NADU,2010,Unemployed,3,418,577,360,169,1527,3,289,136,90,27,545,2072
TAMIL NADU,2010,Self-employed (Business activity),0,212,314,273,62,861,6,85,77,32,19,219,1080
TAMIL NADU,2010,Professional Activity,0,53,86,50,23,212,5,16,18,10,2,51,263
TAMIL NADU,2010,Farming/Agriculture Activity,13,137,131,103,58,442,0,65,25,6,3,99,541
TAMIL NADU,2010,Others (Please Specify),60,695,590,376,229,1950,19,296,262,113,77,767,2717
TAMIL NADU,2010,Retired Person,0,0,0,35,77,112,0,0,0,5,15,20,132
TAMIL NADU,2010,Others (Please Specify),23,740,1037,859,614,3273,84,412,143,158,126,923,4196
TAMIL NADU,2010,Total,199,2966,3512,2579,1296,10552,185,2504,1794,1029,497,6009,16561
TAMIL NADU,2010,Total Salaried,1,457,771,523,64,1816,0,198,144,95,3,440,2256
TAMIL NADU,2010,Total Self-employed,73,1097,1121,802,372,3465,30,462,382,161,101,1136,4601
TRIPURA,2010,House Wife,0,0,0,0,0,0,1,72,64,34,23,194,194
TRIPURA,2010,Service (Government),0,2,8,8,0,18,0,0,0,1,0,1,19
TRIPURA,2010,Service (Private),0,14,5,6,5,30,0,0,0,0,0,0,30
TRIPURA,2010,Public Sector Undertaking,0,0,0,0,0,0,0,0,0,0,0,0,0
TRIPURA,2010,Student,15,57,2,0,0,74,14,16,2,0,0,32,106
TRIPURA,2010,Unemployed,0,4,3,14,14,35,0,0,0,0,6,6,41
TRIPURA,2010,Self-employed (Business activity),0,15,42,6,12,75,0,3,4,5,0,12,87
TRIPURA,2010,Professional Activity,0,5,17,5,3,30,0,0,0,0,0,0,30
TRIPURA,2010,Farming/Agriculture Activity,0,11,15,17,3,46,0,1,4,7,0,12,58
TRIPURA,2010,Others (Please Specify),1,19,50,34,18,122,3,16,6,2,0,27,149
TRIPURA,2010,Retired Person,0,0,0,1,10,11,0,0,0,0,0,0,11
TRIPURA,2010,Others (Please Specify),0,0,0,0,0,0,0,0,0,0,0,0,0
TRIPURA,2010,Total,16,127,142,91,65,441,18,108,80,49,29,284,725
TRIPURA,2010,Total Salaried,0,16,13,14,5,48,0,0,0,1,0,1,49
TRIPURA,2010,Total Self-employed,1,50,124,62,36,273,3,20,14,14,0,51,324
UTTAR PRADESH,2010,House Wife,0,0,0,0,0,0,8,480,350,105,62,1005,1005
UTTAR PRADESH,2010,Service (Government),0,14,16,7,1,38,0,60,9,6,0,75,113
UTTAR PRADESH,2010,Service (Private),0,90,51,42,5,188,4,37,20,8,1,70,258
UTTAR PRADESH,2010,Public Sector Undertaking,0,5,7,4,0,16,0,3,2,1,0,6,22
UTTAR PRADESH,2010,Student,13,131,10,2,0,156,29,132,0,0,0,161,317
UTTAR PRADESH,2010,Unemployed,5,95,88,32,12,232,0,23,24,9,0,56,288
UTTAR PRADESH,2010,Self-employed (Business activity),0,50,60,45,29,184,0,5,2,0,0,7,191
UTTAR PRADESH,2010,Professional Activity,0,32,21,9,5,67,0,0,0,0,0,0,67
UTTAR PRADESH,2010,Farming/Agriculture Activity,2,110,171,116,33,432,4,54,31,19,8,116,548
UTTAR PRADESH,2010,Others (Please Specify),6,109,123,46,30,314,9,124,59,22,7,221,535
UTTAR PRADESH,2010,Retired Person,0,0,0,4,8,12,0,1,0,2,1,4,16
UTTAR PRADESH,2010,Others (Please Specify),20,36,33,40,19,148,4,108,8,0,0,120,268
UTTAR PRADESH,2010,Total,46,672,580,347,142,1787,58,1027,505,172,79,1841,3628
UTTAR PRADESH,2010,Total Salaried,0,109,74,53,6,242,4,100,31,15,1,151,393
UTTAR PRADESH,2010,Total Self-employed,8,301,375,216,97,997,13,183,92,41,15,344,1341
UTTARAKHAND,2010,House Wife,0,0,0,0,0,0,0,28,18,6,2,54,54
UTTARAKHAND,2010,Service (Government),0,4,6,1,0,11,0,1,2,0,0,3,14
UTTARAKHAND,2010,Service (Private),0,7,10,4,0,21,0,3,0,0,0,3,24
UTTARAKHAND,2010,Public Sector Undertaking,0,0,0,0,0,0,0,1,0,0,0,1,1
UTTARAKHAND,2010,Student,2,8,0,0,0,10,4,20,0,0,0,24,34
UTTARAKHAND,2010,Unemployed,0,14,0,5,0,19,0,1,2,0,0,3,22
UTTARAKHAND,2010,Self-employed (Business activity),2,4,6,2,1,15,0,0,0,0,0,0,15
UTTARAKHAND,2010,Professional Activity,0,0,1,0,0,1,0,0,0,0,0,0,1
UTTARAKHAND,2010,Farming/Agriculture Activity,0,8,14,7,4,33,0,4,2,0,0,6,39
UTTARAKHAND,2010,Others (Please Specify),0,8,9,5,4,26,0,4,3,1,0,8,34
UTTARAKHAND,2010,Retired Person,0,0,0,3,0,3,0,0,0,0,0,0,3
UTTARAKHAND,2010,Others (Please Specify),0,9,11,2,3,25,3,7,3,2,0,15,40
UTTARAKHAND,2010,Total,4,62,57,29,12,164,7,69,30,9,2,117,281
UTTARAKHAND,2010,Total Salaried,0,11,16,5,0,32,0,5,2,0,0,7,39
UTTARAKHAND,2010,Total Self-employed,2,20,30,14,9,75,0,8,5,1,0,14,89
WEST BENGAL,2010,House Wife,0,0,0,0,0,0,0,1271,1123,459,75,2928,2928
WEST BENGAL,2010,Service (Government),0,17,84,39,1,141,0,4,7,8,0,19,160
WEST BENGAL,2010,Service (Private),0,143,243,253,7,646,0,64,69,19,5,157,803
WEST BENGAL,2010,Public Sector Undertaking,0,83,264,195,2,544,0,57,44,12,11,124,668
WEST BENGAL,2010,Student,108,398,35,3,0,544,97,280,23,5,0,405,949
WEST BENGAL,2010,Unemployed,0,304,382,75,3,764,0,114,127,23,1,265,1029
WEST BENGAL,2010,Self-employed (Business activity),0,241,329,260,21,851,0,7,24,6,0,37,888
WEST BENGAL,2010,Professional Activity,0,56,232,102,11,401,0,31,53,10,6,100,501
WEST BENGAL,2010,Farming/Agriculture Activity,2,218,389,164,27,800,0,63,53,57,20,193,993
WEST BENGAL,2010,Others (Please Specify),70,634,932,627,214,2477,33,416,508,311,74,1342,3819
WEST BENGAL,2010,Retired Person,0,0,0,0,55,55,0,0,0,0,11,11,66
WEST BENGAL,2010,Others (Please Specify),88,582,605,586,217,2078,82,319,346,321,87,1155,3233
WEST BENGAL,2010,Total,268,2676,3495,2304,558,9301,212,2626,2377,1231,290,6736,16037
WEST BENGAL,2010,Total Salaried,0,243,591,487,10,1331,0,125,120,39,16,300,1631
WEST BENGAL,2010,Total Self-employed,72,1149,1882,1153,273,4529,33,517,638,384,100,1672,6201
TOTAL (STATES),2010,House Wife,0,0,0,0,0,0,58,10725,8389,3749,1608,24529,24529
TOTAL (STATES),2010,Service (Government),0,297,627,441,26,1391,0,198,144,52,3,397,1788
TOTAL (STATES),2010,Service (Private),14,2774,3485,2150,274,8697,9,737,484,192,39,1461,10158
TOTAL (STATES),2010,Public Sector Undertaking,18,635,1011,623,124,2411,1,170,176,74,16,437,2848
TOTAL (STATES),2010,Student,697,3045,136,42,7,3927,672,2483,68,8,0,3231,7158
TOTAL (STATES),2010,Unemployed,52,2828,3079,1440,531,7930,28,827,536,192,116,1699,9629
TOTAL (STATES),2010,Self-employed (Business activity),3,1874,2541,1680,453,6551,12,216,191,100,31,550,7101
TOTAL (STATES),2010,Professional Activity,4,989,1379,840,286,3498,8,137,133,53,16,347,3845
TOTAL (STATES),2010,Farming/Agriculture Activity,58,3411,5069,3608,1415,13561,46,889,759,453,225,2372,15933
TOTAL (STATES),2010,Others (Please Specify),313,6009,7650,5498,2233,21703,234,2445,1947,1139,448,6213,27916
TOTAL (STATES),2010,Retired Person,0,16,17,141,562,736,0,12,2,31,101,146,882
TOTAL (STATES),2010,Others (Please Specify),456,3935,4907,4050,1934,15282,393,1856,1353,1022,533,5157,20439
TOTAL (STATES),2010,Total,1615,25813,29901,20513,7845,85687,1461,20695,14182,7065,3136,46539,132226
TOTAL (STATES),2010,Total Salaried,32,3706,5123,3214,424,12499,10,1105,804,318,58,2295,14794
TOTAL (STATES),2010,Total Self-employed,378,12283,16639,11626,4387,45313,300,3687,3030,1745,720,9482,54795
A & N ISLANDS,2010,House Wife,0,0,0,0,0,0,0,15,11,2,3,31,31
A & N ISLANDS,2010,Service (Government),0,3,8,7,0,18,0,1,0,0,0,1,19
A & N ISLANDS,2010,Service (Private),0,16,19,10,3,48,0,2,0,0,0,2,50
A & N ISLANDS,2010,Public Sector Undertaking,0,0,0,0,0,0,0,0,0,0,0,0,0
A & N ISLANDS,2010,Student,4,4,0,0,0,8,0,6,0,0,0,6,14
A & N ISLANDS,2010,Unemployed,0,13,0,0,0,13,0,4,0,0,0,4,17
A & N ISLANDS,2010,Self-employed (Business activity),0,1,3,1,1,6,0,0,0,0,0,0,6
A & N ISLANDS,2010,Professional Activity,0,0,0,0,0,0,0,0,0,0,0,0,0
A & N ISLANDS,2010,Farming/Agriculture Activity,0,1,2,0,5,8,0,0,0,0,0,0,8
A & N ISLANDS,2010,Others (Please Specify),0,0,1,0,1,2,0,0,0,0,0,0,2
A & N ISLANDS,2010,Retired Person,0,0,0,0,8,8,0,0,0,0,0,0,8
A & N ISLANDS,2010,Others (Please Specify),0,1,0,0,0,1,0,0,0,0,0,0,1
A & N ISLANDS,2010,Total,4,39,33,18,18,112,0,28,11,2,3,44,156
A & N ISLANDS,2010,Total Salaried,0,19,27,17,3,66,0,3,0,0,0,3,69
A & N ISLANDS,2010,Total Self-employed,0,2,6,1,7,16,0,0,0,0,0,0,16
CHANDIGARH,2010,House Wife,0,0,0,0,0,0,0,6,10,2,1,19,19
CHANDIGARH,2010,Service (Government),0,1,2,0,0,3,0,1,0,0,0,1,4
CHANDIGARH,2010,Service (Private),0,4,4,2,0,10,0,0,0,0,0,0,10
CHANDIGARH,2010,Public Sector Undertaking,0,1,0,1,0,2,0,0,0,0,0,0,2
CHANDIGARH,2010,Student,0,4,0,0,0,4,1,9,0,0,0,10,14
CHANDIGARH,2010,Unemployed,0,4,1,0,0,5,0,3,0,0,0,3,8
CHANDIGARH,2010,Self-employed (Business activity),0,0,1,0,0,1,0,0,0,0,0,0,1
CHANDIGARH,2010,Professional Activity,0,0,0,0,0,0,0,0,0,0,0,0,0
CHANDIGARH,2010,Farming/Agriculture Activity,0,0,0,0,0,0,0,0,0,0,0,0,0
CHANDIGARH,2010,Others (Please Specify),0,0,4,1,0,5,1,5,0,0,0,6,11
CHANDIGARH,2010,Retired Person,0,0,0,0,1,1,0,0,0,0,0,0,1
CHANDIGARH,2010,Others (Please Specify),0,0,0,0,0,0,0,1,0,0,0,1,1
CHANDIGARH,2010,Total,0,14,12,4,1,31,2,25,10,2,1,40,71
CHANDIGARH,2010,Total Salaried,0,6,6,3,0,15,0,1,0,0,0,1,16
CHANDIGARH,2010,Total Self-employed,0,0,5,1,0,6,1,5,0,0,0,6,12
D & N HAVELI,2010,House Wife,0,0,0,0,0,0,0,15,4,4,0,23,23
D & N HAVELI,2010,Service (Government),0,1,0,0,0,1,0,0,0,0,0,0,1
D & N HAVELI,2010,Service (Private),0,6,5,1,0,12,0,0,0,0,0,0,12
D & N HAVELI,2010,Public Sector Undertaking,0,0,0,0,0,0,0,0,0,0,0,0,0
D & N HAVELI,2010,Student,0,0,0,0,0,0,0,3,0,0,0,3,3
D & N HAVELI,2010,Unemployed,0,0,0,0,0,0,0,0,0,0,0,0,0
D & N HAVELI,2010,Self-employed (Business activity),0,0,0,0,0,0,0,0,0,0,0,0,0
D & N HAVELI,2010,Professional Activity,0,0,0,0,0,0,0,0,0,0,0,0,0
D & N HAVELI,2010,Farming/Agriculture Activity,0,2,5,3,0,10,0,0,0,0,0,0,10
D & N HAVELI,2010,Others (Please Specify),0,1,0,0,0,1,0,0,0,0,0,0,1
D & N HAVELI,2010,Retired Person,0,0,0,0,0,0,0,0,0,0,0,0,0
D & N HAVELI,2010,Others (Please Specify),0,4,2,2,5,13,0,0,0,0,0,0,13
D & N HAVELI,2010,Total,0,14,12,6,5,37,0,18,4,4,0,26,63
D & N HAVELI,2010,Total Salaried,0,7,5,1,0,13,0,0,0,0,0,0,13
D & N HAVELI,2010,Total Self-employed,0,3,5,3,0,11,0,0,0,0,0,0,11
DAMAN & DIU,2010,House Wife,0,0,0,0,0,0,0,6,2,0,0,8,8
DAMAN & DIU,2010,Service (Government),0,0,1,0,0,1,0,0,0,0,0,0,1
DAMAN & DIU,2010,Service (Private),0,4,5,1,0,10,0,1,0,0,0,1,11
DAMAN & DIU,2010,Public Sector Undertaking,0,0,0,0,0,0,0,0,0,0,0,0,0
DAMAN & DIU,2010,Student,3,2,0,0,0,5,0,1,0,0,0,1,6
DAMAN & DIU,2010,Unemployed,0,0,0,0,0,0,0,0,0,0,0,0,0
DAMAN & DIU,2010,Self-employed (Business activity),0,0,0,0,0,0,0,0,0,0,0,0,0
DAMAN & DIU,2010,Professional Activity,0,0,0,0,0,0,0,0,0,0,0,0,0
DAMAN & DIU,2010,Farming/Agriculture Activity,0,0,0,0,0,0,0,0,0,0,0,0,0
DAMAN & DIU,2010,Others (Please Specify),0,0,0,0,0,0,0,0,0,0,0,0,0
DAMAN & DIU,2010,Retired Person,0,0,0,0,0,0,0,0,0,0,0,0,0
DAMAN & DIU,2010,Others (Please Specify),0,2,0,1,0,3,0,2,0,0,0,2,5
DAMAN & DIU,2010,Total,3,8,6,2,0,19,0,10,2,0,0,12,31
DAMAN & DIU,2010,Total Salaried,0,4,6,1,0,11,0,1,0,0,0,1,12
DAMAN & DIU,2010,Total Self-employed,0,0,0,0,0,0,0,0,0,0,0,0,0
DELHI (UT),2010,House Wife,0,0,0,0,0,0,0,197,117,31,7,352,352
DELHI (UT),2010,Service (Government),0,2,7,6,0,15,0,3,0,0,0,3,18
DELHI (UT),2010,Service (Private),0,90,78,22,11,201,0,18,3,1,0,22,223
DELHI (UT),2010,Public Sector Undertaking,0,12,23,4,0,39,0,5,0,0,0,5,44
DELHI (UT),2010,Student,11,75,1,0,0,87,18,56,3,2,0,79,166
DELHI (UT),2010,Unemployed,0,102,88,30,16,236,3,32,8,0,0,43,279
DELHI (UT),2010,Self-employed (Business activity),0,13,11,8,0,32,0,0,0,0,0,0,32
DELHI (UT),2010,Professional Activity,0,1,2,0,0,3,0,0,1,0,0,1,4
DELHI (UT),2010,Farming/Agriculture Activity,0,2,5,2,0,9,0,0,0,0,0,0,9
DELHI (UT),2010,Others (Please Specify),0,63,69,34,10,176,0,29,6,1,1,37,213
DELHI (UT),2010,Retired Person,0,0,0,0,4,4,0,0,0,0,0,0,4
DELHI (UT),2010,Others (Please Specify),5,69,55,24,6,159,3,23,12,1,1,40,199
DELHI (UT),2010,Total,16,429,339,130,47,961,24,363,150,36,9,582,1543
DELHI (UT),2010,Total Salaried,0,104,108,32,11,255,0,26,3,1,0,30,285
DELHI (UT),2010,Total Self-employed,0,79,87,44,10,220,0,29,7,1,1,38,258
LAKSHADWEEP,2010,House Wife,0,0,0,0,0,0,0,0,1,0,0,1,1
LAKSHADWEEP,2010,Service (Government),0,0,0,0,0,0,0,0,0,0,0,0,0
LAKSHADWEEP,2010,Service (Private),0,0,0,0,0,0,0,0,0,0,0,0,0
LAKSHADWEEP,2010,Public Sector Undertaking,0,0,0,0,0,0,0,0,0,0,0,0,0
LAKSHADWEEP,2010,Student,0,0,0,0,0,0,0,0,0,0,0,0,0
LAKSHADWEEP,2010,Unemployed,0,0,0,0,0,0,0,0,0,0,0,0,0
LAKSHADWEEP,2010,Self-employed (Business activity),0,0,0,0,0,0,0,0,0,0,0,0,0
LAKSHADWEEP,2010,Professional Activity,0,0,0,0,0,0,0,0,0,0,0,0,0
LAKSHADWEEP,2010,Farming/Agriculture Activity,0,0,0,0,0,0,0,0,0,0,0,0,0
LAKSHADWEEP,2010,Others (Please Specify),0,0,0,0,0,0,0,0,0,0,0,0,0
LAKSHADWEEP,2010,Retired Person,0,0,0,0,0,0,0,0,0,0,0,0,0
LAKSHADWEEP,2010,Others (Please Specify),0,0,0,0,0,0,0,0,0,0,0,0,0
LAKSHADWEEP,2010,Total,0,0,0,0,0,0,0,0,1,0,0,1,1
LAKSHADWEEP,2010,Total Salaried,0,0,0,0,0,0,0,0,0,0,0,0,0
LAKSHADWEEP,2010,Total Self-employed,0,0,0,0,0,0,0,0,0,0,0,0,0
PUDUCHERRY,2010,House Wife,0,0,0,0,0,0,0,44,30,10,11,95,95
PUDUCHERRY,2010,Service (Government),0,1,4,2,1,8,0,2,1,0,0,3,11
PUDUCHERRY,2010,Service (Private),0,10,9,2,0,21,0,12,5,0,0,17,38
PUDUCHERRY,2010,Public Sector Undertaking,0,0,2,2,0,4,0,0,2,0,0,2,6
PUDUCHERRY,2010,Student,2,4,0,0,0,6,2,10,0,0,0,12,18
PUDUCHERRY,2010,Unemployed,0,17,14,13,16,60,0,29,4,0,7,40,100
PUDUCHERRY,2010,Self-employed (Business activity),0,3,8,3,0,14,0,0,0,0,0,0,14
PUDUCHERRY,2010,Professional Activity,0,34,98,68,5,205,0,2,0,2,1,5,210
PUDUCHERRY,2010,Farming/Agriculture Activity,0,0,1,3,0,4,0,0,0,0,0,0,4
PUDUCHERRY,2010,Others (Please Specify),0,1,5,2,0,8,1,0,0,0,0,1,9
PUDUCHERRY,2010,Retired Person,0,0,0,0,3,3,0,0,0,0,0,0,3
PUDUCHERRY,2010,Others (Please Specify),0,0,0,0,0,0,0,0,0,0,0,0,0
PUDUCHERRY,2010,Total,2,70,141,95,25,333,3,99,42,12,19,175,508
PUDUCHERRY,2010,Total Salaried,0,11,15,6,1,33,0,14,8,0,0,22,55
PUDUCHERRY,2010,Total Self-employed,0,38,112,76,5,231,1,2,0,2,1,6,237
TOTAL (UTs),2010,House Wife,0,0,0,0,0,0,0,283,175,49,22,529,529
TOTAL (UTs),2010,Service (Government),0,8,22,15,1,46,0,7,1,0,0,8,54
TOTAL (UTs),2010,Service (Private),0,130,120,38,14,302,0,33,8,1,0,42,344
TOTAL (UTs),2010,Public Sector Undertaking,0,13,25,7,0,45,0,5,2,0,0,7,52
TOTAL (UTs),2010,Student,20,89,1,0,0,110,21,85,3,2,0,111,221
TOTAL (UTs),2010,Unemployed,0,136,103,43,32,314,3,68,12,0,7,90,404
TOTAL (UTs),2010,Self-employed (Business activity),0,17,23,12,1,53,0,0,0,0,0,0,53
TOTAL (UTs),2010,Professional Activity,0,35,100,68,5,208,0,2,1,2,1,6,214
TOTAL (UTs),2010,Farming/Agriculture Activity,0,5,13,8,5,31,0,0,0,0,0,0,31
TOTAL (UTs),2010,Others (Please Specify),0,65,79,37,11,192,2,34,6,1,1,44,236
TOTAL (UTs),2010,Retired Person,0,0,0,0,16,16,0,0,0,0,0,0,16
TOTAL (UTs),2010,Others (Please Specify),5,76,57,27,11,176,3,26,12,1,1,43,219
TOTAL (UTs),2010,Total,25,574,543,255,96,1493,29,543,220,56,32,880,2373
TOTAL (UTs),2010,Total Salaried,0,151,167,60,15,393,0,45,11,1,0,57,450
TOTAL (UTs),2010,Total Self-employed,0,122,215,125,22,484,2,36,7,3,2,50,534
TOTAL (ALL INDIA),2010,House Wife,0,0,0,0,0,0,58,11008,8564,3798,1630,25058,25058
TOTAL (ALL INDIA),2010,Service (Government),0,305,649,456,27,1437,0,205,145,52,3,405,1842
TOTAL (ALL INDIA),2010,Service (Private),14,2904,3605,2188,288,8999,9,770,492,193,39,1503,10502
TOTAL (ALL INDIA),2010,Public Sector Undertaking,18,648,1036,630,124,2456,1,175,178,74,16,444,2900
TOTAL (ALL INDIA),2010,Student,717,3134,137,42,7,4037,693,2568,71,10,0,3342,7379
TOTAL (ALL INDIA),2010,Unemployed,52,2964,3182,1483,563,8244,31,895,548,192,123,1789,10033
TOTAL (ALL INDIA),2010,Self-employed (Business activity),3,1891,2564,1692,454,6604,12,216,191,100,31,550,7154
TOTAL (ALL INDIA),2010,Professional Activity,4,1024,1479,908,291,3706,8,139,134,55,17,353,4059
TOTAL (ALL INDIA),2010,Farming/Agriculture Activity,58,3416,5082,3616,1420,13592,46,889,759,453,225,2372,15964
TOTAL (ALL INDIA),2010,Others (Please Specify),313,6074,7729,5535,2244,21895,236,2479,1953,1140,449,6257,28152
TOTAL (ALL INDIA),2010,Retired Person,0,16,17,141,578,752,0,12,2,31,101,146,898
TOTAL (ALL INDIA),2010,Others (Please Specify),461,4011,4964,4077,1945,15458,396,1882,1365,1023,534,5200,20658
TOTAL (ALL INDIA),2010,Total,1640,26387,30444,20768,7941,87180,1490,21238,14402,7121,3168,47419,134599
TOTAL (ALL INDIA),2010,Total Salaried,32,3857,5290,3274,439,12892,10,1150,815,319,58,2352,15244
TOTAL (ALL INDIA),2010,Total Self-employed,378,12405,16854,11751,4409,45797,302,3723,3037,1748,722,9532,55329
