,STATE/UT,Year,CAUSE,Male upto 14 years,Male 15-29 years,Male 30-44 years,Male 45-59 years,Male 60 years and above,Total Male,Female upto 14 years,Female 15-29 years,Female 30-44 years,Female 45-59 years,Female 60 years and above,Total Female,Grand Total
0,ANDHRA PRADESH,2001,House Wife,0,0,0,0,0,0,0,1132,811,397,104,2444,2444
1,ANDHRA PRADESH,2001,Service (Government),0,34,57,44,0,135,0,23,22,9,7,61,196
2,ANDHRA PRADESH,2001,Service (Private),1,250,275,138,10,674,5,43,24,28,6,106,780
3,ANDHRA PRADESH,2001,Public Sector Undertaking,0,32,36,29,13,110,0,4,5,1,0,10,120
4,ANDHRA PRADESH,2001,Student,56,202,19,18,0,295,46,115,5,9,0,175,470
5,ANDHRA PRADESH,2001,Unemployed,1,230,206,94,12,543,1,57,12,8,0,78,621
6,ANDHRA PRADESH,2001,Self-employed (Business activity),25,107,223,117,14,486,20,24,22,4,12,82,568
7,ANDHRA PRADESH,2001,Professional Activity,13,118,157,80,22,390,5,22,4,10,0,41,431
8,ANDHRA PRADESH,2001,Farming/Agriculture Activity,16,382,480,374,79,1331,12,65,46,45,10,178,1509
9,ANDHRA PRADESH,2001,Others (Please Specify),29,299,358,264,79,1029,38,212,154,78,16,498,1527
10,ANDHRA PRADESH,2001,Retired Person,0,0,1,4,16,21,0,0,2,0,3,5,26
11,ANDHRA PRADESH,2001,Others (Please Specify),32,404,401,404,124,1365,58,174,91,108,34,465,1830
12,ANDHRA PRADESH,2001,Total,173,2058,2213,1566,369,6379,185,1871,1198,697,192,4143,10522
13,ANDHRA PRADESH,2001,Total Salaried,1,316,368,211,23,919,5,70,51,38,13,177,1096
14,ANDHRA PRADESH,2001,Total Self-employed,83,906,1218,835,194,3236,75,323,226,137,38,799,4035
15,ARUNACHAL PRADESH,2001,House Wife,0,0,0,0,0,0,0,9,5,1,0,15,15
16,ARUNACHAL PRADESH,2001,Service (Government),0,5,7,2,0,14,0,0,0,0,0,0,14
17,ARUNACHAL PRADESH,2001,Service (Private),0,12,19,1,0,32,0,5,4,0,0,9,41
18,ARUNACHAL PRADESH,2001,Public Sector Undertaking,0,0,0,0,0,0,0,0,0,0,0,0,0
19,ARUNACHAL PRADESH,2001,Student,0,2,0,0,0,2,2,4,0,0,0,6,8
20,ARUNACHAL PRADESH,2001,Unemployed,0,2,1,0,0,3,0,0,0,0,0,0,3
21,ARUNACHAL PRADESH,2001,Self-employed (Business activity),0,2,6,3,1,12,0,0,0,0,0,0,12
22,ARUNACHAL PRADESH,2001,Professional Activity,0,0,0,0,0,0,0,0,0,0,0,0,0
23,ARUNACHAL PRADESH,2001,Farming/Agriculture Activity,2,1,5,4,0,12,0,5,0,0,0,5,17
24,ARUNACHAL PRADESH,2001,Others (Please Specify),0,0,0,0,0,0,0,0,0,0,0,0,0
25,ARUNACHAL PRADESH,2001,Retired Person,0,0,0,1,0,1,0,0,0,0,0,0,1
26,ARUNACHAL PRADESH,2001,Others (Please Specify),0,0,0,0,0,0,0,0,0,0,0,0,0
27,ARUNACHAL PRADESH,2001,Total,2,24,38,11,1,76,2,23,9,1,0,35,111
28,ARUNACHAL PRADESH,2001,Total Salaried,0,17,26,3,0,46,0,5,4,0,0,9,55
29,ARUNACHAL PRADESH,2001,Total Self-employed,2,3,11,7,1,24,0,5,0,0,0,5,29
30,ASSAM,2001,House Wife,0,0,0,0,0,0,0,158,161,68,7,394,394
31,ASSAM,2001,Service (Government),0,7,25,13,0,45,0,0,2,0,0,2,47
32,ASSAM,2001,Service (Private),0,46,49,32,4,131,0,13,12,3,0,28,159
33,ASSAM,2001,Public Sector Undertaking,0,39,28,17,0,84,0,0,2,0,0,2,86
34,ASSAM,2001,Student,29,86,6,0,0,121,9,55,6,0,0,70,191
35,ASSAM,2001,Unemployed,0,108,124,59,5,296,0,21,14,3,0,38,334
36,ASSAM,2001,Self-employed (Business activity),0,59,85,45,10,199,0,12,5,7,0,24,223
37,ASSAM,2001,Professional Activity,0,16,36,15,0,67,0,1,0,0,0,1,68
38,ASSAM,2001,Farming/Agriculture Activity,0,30,62,43,9,144,0,7,6,9,1,23,167
39,ASSAM,2001,Others (Please Specify),1,129,173,123,11,437,5,76,36,12,1,130,567
40,ASSAM,2001,Retired Person,0,0,0,2,4,6,0,0,0,0,0,0,6
41,ASSAM,2001,Others (Please Specify),5,100,114,69,18,306,5,40,30,17,7,99,405
42,ASSAM,2001,Total,35,620,702,418,61,1836,19,383,274,119,16,811,2647
43,ASSAM,2001,Total Salaried,0,92,102,62,4,260,0,13,16,3,0,32,292
44,ASSAM,2001,Total Self-employed,1,234,356,226,30,847,5,96,47,28,2,178,1025
45,BIHAR,2001,House Wife,0,0,0,0,0,0,0,62,62,13,3,140,140
46,BIHAR,2001,Service (Government),0,1,4,0,0,5,0,1,0,0,0,1,6
47,BIHAR,2001,Service (Private),0,11,3,0,1,15,0,3,0,0,0,3,18
48,BIHAR,2001,Public Sector Undertaking,0,0,1,0,0,1,0,0,0,0,0,0,1
49,BIHAR,2001,Student,3,34,2,0,0,39,6,17,2,0,0,25,64
50,BIHAR,2001,Unemployed,1,13,6,1,1,22,2,10,2,2,0,16,38
51,BIHAR,2001,Self-employed (Business activity),0,2,12,0,0,14,1,0,0,0,0,1,15
52,BIHAR,2001,Professional Activity,0,2,1,0,0,3,0,0,0,0,0,0,3
53,BIHAR,2001,Farming/Agriculture Activity,0,19,23,12,1,55,0,4,1,1,0,6,61
54,BIHAR,2001,Others (Please Specify),3,22,7,1,1,34,0,7,7,0,0,14,48
55,BIHAR,2001,Retired Person,0,0,0,0,2,2,0,0,0,0,0,0,2
56,BIHAR,2001,Others (Please Specify),1,27,62,17,10,117,5,49,20,11,5,90,207
57,BIHAR,2001,Total,8,131,121,31,16,307,14,153,94,27,8,296,603
58,BIHAR,2001,Total Salaried,0,12,8,0,1,21,0,4,0,0,0,4,25
59,BIHAR,2001,Total Self-employed,3,45,43,13,2,106,1,11,8,1,0,21,127
60,CHHATTISGARH,2001,House Wife,0,0,0,0,0,0,3,301,202,74,26,606,606
61,CHHATTISGARH,2001,Service (Government),0,11,36,15,1,63,0,4,2,1,0,7,70
62,CHHATTISGARH,2001,Service (Private),0,47,81,33,6,167,1,6,2,1,0,10,177
63,CHHATTISGARH,2001,Public Sector Undertaking,0,9,31,16,3,59,0,2,3,1,0,6,65
64,CHHATTISGARH,2001,Student,17,100,17,0,0,134,23,69,3,0,0,95,229
65,CHHATTISGARH,2001,Unemployed,0,100,69,17,7,193,0,19,6,0,0,25,218
66,CHHATTISGARH,2001,Self-employed (Business activity),1,21,30,9,5,66,0,2,0,0,0,2,68
67,CHHATTISGARH,2001,Professional Activity,0,12,14,4,2,32,0,2,2,0,0,4,36
68,CHHATTISGARH,2001,Farming/Agriculture Activity,8,286,429,302,173,1198,5,81,92,51,25,254,1452
69,CHHATTISGARH,2001,Others (Please Specify),10,133,142,106,53,444,6,74,61,45,26,212,656
70,CHHATTISGARH,2001,Retired Person,0,8,3,0,2,13,0,0,0,0,0,0,13
71,CHHATTISGARH,2001,Others (Please Specify),8,65,103,61,34,271,11,74,45,20,14,164,435
72,CHHATTISGARH,2001,Total,44,792,955,563,286,2640,49,634,418,193,91,1385,4025
73,CHHATTISGARH,2001,Total Salaried,0,67,148,64,10,289,1,12,7,3,0,23,312
74,CHHATTISGARH,2001,Total Self-employed,19,452,615,421,233,1740,11,159,155,96,51,472,2212
75,GOA,2001,House Wife,0,0,0,0,0,0,0,11,24,6,14,55,55
76,GOA,2001,Service (Government),0,0,2,2,0,4,0,0,1,0,1,2,6
77,GOA,2001,Service (Private),0,11,29,6,0,46,0,5,1,0,0,6,52
78,GOA,2001,Public Sector Undertaking,0,0,0,0,0,0,0,0,0,0,0,0,0
79,GOA,2001,Student,0,4,0,0,0,4,3,6,0,0,0,9,13
80,GOA,2001,Unemployed,0,17,21,3,3,44,0,6,4,0,0,10,54
81,GOA,2001,Self-employed (Business activity),0,1,2,6,1,10,0,0,0,0,0,0,10
82,GOA,2001,Professional Activity,0,0,2,0,0,2,0,0,0,0,0,0,2
83,GOA,2001,Farming/Agriculture Activity,0,1,4,9,4,18,0,0,0,0,0,0,18
84,GOA,2001,Others (Please Specify),0,4,5,2,0,11,0,2,0,0,2,4,15
85,GOA,2001,Retired Person,0,0,0,0,3,3,0,0,0,0,0,0,3
86,GOA,2001,Others (Please Specify),0,5,8,7,5,25,0,0,2,0,1,3,28
87,GOA,2001,Total,0,43,73,35,16,167,3,30,32,6,18,89,256
88,GOA,2001,Total Salaried,0,11,31,8,0,50,0,5,2,0,1,8,58
89,GOA,2001,Total Self-employed,0,6,13,17,5,41,0,2,0,0,2,4,45
90,GUJARAT,2001,House Wife,0,0,0,0,0,0,15,736,534,199,84,1568,1568
91,GUJARAT,2001,Service (Government),0,12,26,24,0,62,0,3,5,0,0,8,70
92,GUJARAT,2001,Service (Private),0,145,169,45,6,365,0,18,14,7,0,39,404
93,GUJARAT,2001,Public Sector Undertaking,0,22,47,21,2,92,0,8,4,3,0,15,107
94,GUJARAT,2001,Student,19,109,6,0,0,134,28,101,1,0,0,130,264
95,GUJARAT,2001,Unemployed,5,210,137,66,8,426,6,27,28,10,0,71,497
96,GUJARAT,2001,Self-employed (Business activity),6,67,116,58,8,255,0,0,1,0,0,1,256
97,GUJARAT,2001,Professional Activity,0,98,127,86,14,325,0,18,5,2,2,27,352
98,GUJARAT,2001,Farming/Agriculture Activity,1,188,213,84,31,517,2,34,30,7,4,77,594
99,GUJARAT,2001,Others (Please Specify),4,114,144,46,14,322,4,57,22,13,10,106,428
100,GUJARAT,2001,Retired Person,0,0,0,13,43,56,0,0,0,5,38,43,99
101,GUJARAT,2001,Others (Please Specify),5,37,34,9,10,95,3,28,13,11,2,57,152
102,GUJARAT,2001,Total,40,1002,1019,452,136,2649,58,1030,657,257,140,2142,4791
103,GUJARAT,2001,Total Salaried,0,179,242,90,8,519,0,29,23,10,0,62,581
104,GUJARAT,2001,Total Self-employed,11,467,600,274,67,1419,6,109,58,22,16,211,1630
105,HARYANA,2001,House Wife,0,0,0,0,0,0,0,167,104,15,11,297,297
106,HARYANA,2001,Service (Government),0,25,32,16,0,73,0,0,13,8,0,21,94
107,HARYANA,2001,Service (Private),0,40,45,13,0,98,0,24,15,6,2,47,145
108,HARYANA,2001,Public Sector Undertaking,0,33,29,4,0,66,0,14,13,1,0,28,94
109,HARYANA,2001,Student,15,64,8,0,0,87,7,29,2,3,0,41,128
110,HARYANA,2001,Unemployed,13,117,52,42,3,227,7,26,18,9,0,60,287
111,HARYANA,2001,Self-employed (Business activity),0,28,16,12,1,57,0,0,0,0,0,0,57
112,HARYANA,2001,Professional Activity,0,17,33,12,2,64,0,0,1,0,0,1,65
113,HARYANA,2001,Farming/Agriculture Activity,0,50,43,27,13,133,0,6,3,3,0,12,145
114,HARYANA,2001,Others (Please Specify),0,27,51,14,11,103,0,4,17,3,4,28,131
115,HARYANA,2001,Retired Person,0,0,0,1,17,18,0,0,0,0,4,4,22
116,HARYANA,2001,Others (Please Specify),6,118,190,95,29,438,6,52,34,8,4,104,542
117,HARYANA,2001,Total,34,519,499,236,76,1364,20,322,220,56,25,643,2007
118,HARYANA,2001,Total Salaried,0,98,106,33,0,237,0,38,41,15,2,96,333
119,HARYANA,2001,Total Self-employed,0,122,143,65,27,357,0,10,21,6,4,41,398
120,HIMACHAL PRADESH,2001,House Wife,0,0,0,0,0,0,0,44,26,12,2,84,84
121,HIMACHAL PRADESH,2001,Service (Government),0,0,5,3,0,8,0,2,1,0,0,3,11
122,HIMACHAL PRADESH,2001,Service (Private),0,6,9,8,1,24,0,0,0,0,0,0,24
123,HIMACHAL PRADESH,2001,Public Sector Undertaking,0,0,3,4,0,7,0,0,0,0,0,0,7
124,HIMACHAL PRADESH,2001,Student,0,8,0,0,0,8,2,9,0,0,0,11,19
125,HIMACHAL PRADESH,2001,Unemployed,0,18,9,4,0,31,0,6,1,0,0,7,38
126,HIMACHAL PRADESH,2001,Self-employed (Business activity),0,4,5,0,0,9,0,0,0,0,0,0,9
127,HIMACHAL PRADESH,2001,Professional Activity,0,0,2,0,0,2,0,0,1,0,0,1,3
128,HIMACHAL PRADESH,2001,Farming/Agriculture Activity,0,3,9,8,2,22,0,0,0,0,0,0,22
129,HIMACHAL PRADESH,2001,Others (Please Specify),0,1,6,5,1,13,0,0,6,0,0,6,19
130,HIMACHAL PRADESH,2001,Retired Person,0,0,0,1,0,1,0,0,0,0,0,0,1
131,HIMACHAL PRADESH,2001,Others (Please Specify),1,14,16,16,5,52,1,9,3,2,3,18,70
132,HIMACHAL PRADESH,2001,Total,1,54,64,49,9,177,3,70,38,14,5,130,307
133,HIMACHAL PRADESH,2001,Total Salaried,0,6,17,15,1,39,0,2,1,0,0,3,42
134,HIMACHAL PRADESH,2001,Total Self-employed,0,8,22,13,3,46,0,0,7,0,0,7,53
135,JAMMU & KASHMIR,2001,House Wife,0,0,0,0,0,0,0,18,13,4,1,36,36
136,JAMMU & KASHMIR,2001,Service (Government),0,1,7,1,0,9,0,0,0,0,0,0,9
137,JAMMU & KASHMIR,2001,Service (Private),0,0,2,0,0,2,0,0,0,0,0,0,2
138,JAMMU & KASHMIR,2001,Public Sector Undertaking,0,0,1,0,0,1,0,0,0,0,0,0,1
139,JAMMU & KASHMIR,2001,Student,0,5,0,0,0,5,0,1,0,0,0,1,6
140,JAMMU & KASHMIR,2001,Unemployed,0,3,4,4,1,12,0,3,0,0,0,3,15
141,JAMMU & KASHMIR,2001,Self-employed (Business activity),0,1,1,0,0,2,0,0,0,0,0,0,2
142,JAMMU & KASHMIR,2001,Professional Activity,2,0,0,0,0,2,0,0,0,0,0,0,2
143,JAMMU & KASHMIR,2001,Farming/Agriculture Activity,0,5,4,3,0,12,1,0,1,1,0,3,15
144,JAMMU & KASHMIR,2001,Others (Please Specify),0,3,4,1,0,8,0,4,0,0,0,4,12
145,JAMMU & KASHMIR,2001,Retired Person,0,0,0,0,0,0,0,0,0,0,0,0,0
146,JAMMU & KASHMIR,2001,Others (Please Specify),0,11,8,9,10,38,1,5,7,0,2,15,53
147,JAMMU & KASHMIR,2001,Total,2,29,31,18,11,91,2,31,21,5,3,62,153
148,JAMMU & KASHMIR,2001,Total Salaried,0,1,10,1,0,12,0,0,0,0,0,0,12
149,JAMMU & KASHMIR,2001,Total Self-employed,2,9,9,4,0,24,1,4,1,1,0,7,31
150,JHARKHAND,2001,House Wife,0,0,0,0,0,0,1,29,21,8,0,59,59
151,JHARKHAND,2001,Service (Government),0,0,0,0,0,0,0,0,0,0,0,0,0
152,JHARKHAND,2001,Service (Private),0,0,3,1,0,4,0,0,2,0,0,2,6
153,JHARKHAND,2001,Public Sector Undertaking,0,0,3,0,0,3,0,0,2,0,0,2,5
154,JHARKHAND,2001,Student,3,3,0,0,0,6,0,1,0,0,0,1,7
155,JHARKHAND,2001,Unemployed,0,9,7,1,1,18,0,1,0,0,0,1,19
156,JHARKHAND,2001,Self-employed (Business activity),0,0,1,0,0,1,0,0,0,0,0,0,1
157,JHARKHAND,2001,Professional Activity,0,3,2,1,0,6,0,0,0,0,0,0,6
158,JHARKHAND,2001,Farming/Agriculture Activity,0,5,17,5,0,27,0,0,0,0,0,0,27
159,JHARKHAND,2001,Others (Please Specify),0,18,11,7,0,36,1,12,0,2,0,15,51
160,JHARKHAND,2001,Retired Person,0,0,0,0,0,0,0,0,0,0,0,0,0
161,JHARKHAND,2001,Others (Please Specify),1,7,12,11,9,40,3,7,6,13,0,29,69
162,JHARKHAND,2001,Total,4,45,56,26,10,141,5,50,31,23,0,109,250
163,JHARKHAND,2001,Total Salaried,0,0,6,1,0,7,0,0,4,0,0,4,11
164,JHARKHAND,2001,Total Self-employed,0,26,31,13,0,70,1,12,0,2,0,15,85
165,KARNATAKA,2001,House Wife,0,0,0,0,0,0,10,1008,707,334,138,2197,2197
166,KARNATAKA,2001,Service (Government),0,35,108,67,1,211,0,23,24,12,0,59,270
167,KARNATAKA,2001,Service (Private),3,241,352,190,79,865,6,111,40,31,12,200,1065
168,KARNATAKA,2001,Public Sector Undertaking,0,66,95,60,7,228,0,15,0,0,0,15,243
169,KARNATAKA,2001,Student,72,230,26,1,0,329,60,120,1,2,0,183,512
170,KARNATAKA,2001,Unemployed,6,225,207,103,17,558,5,48,23,5,4,85,643
171,KARNATAKA,2001,Self-employed (Business activity),5,195,221,133,37,591,2,22,7,3,0,34,625
172,KARNATAKA,2001,Professional Activity,1,69,71,41,13,195,1,6,1,0,0,8,203
173,KARNATAKA,2001,Farming/Agriculture Activity,25,551,811,579,187,2153,17,138,117,68,12,352,2505
174,KARNATAKA,2001,Others (Please Specify),48,441,708,484,266,1947,36,201,130,91,59,517,2464
175,KARNATAKA,2001,Retired Person,0,16,18,16,46,96,0,5,14,11,9,39,135
176,KARNATAKA,2001,Others (Please Specify),20,173,263,162,80,698,47,120,54,69,31,321,1019
177,KARNATAKA,2001,Total,180,2242,2880,1836,733,7871,184,1817,1118,626,265,4010,11881
178,KARNATAKA,2001,Total Salaried,3,342,555,317,87,1304,6,149,64,43,12,274,1578
179,KARNATAKA,2001,Total Self-employed,79,1256,1811,1237,503,4886,56,367,255,162,71,911,5797
180,KERALA,2001,House Wife,0,0,0,0,0,0,0,290,475,394,247,1406,1406
181,KERALA,2001,Service (Government),0,10,53,111,2,176,0,7,15,9,0,31,207
182,KERALA,2001,Service (Private),0,73,145,139,92,449,0,25,33,24,35,117,566
183,KERALA,2001,Public Sector Undertaking,0,35,48,63,37,183,0,3,12,10,2,27,210
184,KERALA,2001,Student,37,90,1,0,0,128,33,119,1,0,0,153,281
185,KERALA,2001,Unemployed,0,312,550,560,334,1756,3,155,74,41,66,339,2095
186,KERALA,2001,Self-employed (Business activity),0,56,187,177,55,475,0,7,5,9,1,22,497
187,KERALA,2001,Professional Activity,0,30,77,74,21,202,0,2,9,8,2,21,223
188,KERALA,2001,Farming/Agriculture Activity,0,93,325,362,194,974,0,18,17,12,14,61,1035
189,KERALA,2001,Others (Please Specify),6,270,456,504,299,1535,3,80,64,83,62,292,1827
190,KERALA,2001,Retired Person,0,1,2,29,67,99,0,0,2,7,11,20,119
191,KERALA,2001,Others (Please Specify),0,139,263,221,187,810,9,88,91,69,39,296,1106
192,KERALA,2001,Total,43,1109,2107,2240,1288,6787,48,794,798,666,479,2785,9572
193,KERALA,2001,Total Salaried,0,118,246,313,131,808,0,35,60,43,37,175,983
194,KERALA,2001,Total Self-employed,6,449,1045,1117,569,3186,3,107,95,112,79,396,3582
195,MADHYA PRADESH,2001,House Wife,0,0,0,0,0,0,14,1346,553,201,87,2201,2201
196,MADHYA PRADESH,2001,Service (Government),0,59,54,40,1,154,0,13,12,3,0,28,182
197,MADHYA PRADESH,2001,Service (Private),0,142,108,40,4,294,0,48,10,5,0,63,357
198,MADHYA PRADESH,2001,Public Sector Undertaking,0,43,10,9,0,62,0,36,6,2,0,44,106
199,MADHYA PRADESH,2001,Student,50,147,11,3,0,211,32,62,0,0,0,94,305
200,MADHYA PRADESH,2001,Unemployed,2,91,63,23,18,197,2,11,0,0,0,13,210
201,MADHYA PRADESH,2001,Self-employed (Business activity),0,71,83,40,23,217,0,28,21,11,11,71,288
202,MADHYA PRADESH,2001,Professional Activity,0,30,64,20,12,126,0,4,8,7,3,22,148
203,MADHYA PRADESH,2001,Farming/Agriculture Activity,5,397,384,198,94,1078,5,142,95,31,21,294,1372
204,MADHYA PRADESH,2001,Others (Please Specify),40,230,194,148,85,697,43,105,59,30,14,251,948
205,MADHYA PRADESH,2001,Retired Person,0,0,0,0,13,13,0,0,0,0,1,1,14
206,MADHYA PRADESH,2001,Others (Please Specify),33,207,158,49,40,487,19,123,48,28,24,242,729
207,MADHYA PRADESH,2001,Total,130,1417,1129,570,290,3536,115,1918,812,318,161,3324,6860
208,MADHYA PRADESH,2001,Total Salaried,0,244,172,89,5,510,0,97,28,10,0,135,645
209,MADHYA PRADESH,2001,Total Self-employed,45,728,725,406,214,2118,48,279,183,79,49,638,2756
210,MAHARASHTRA,2001,House Wife,0,0,0,0,0,0,9,1663,1078,394,207,3351,3351
211,MAHARASHTRA,2001,Service (Government),0,51,111,57,3,222,0,19,15,3,0,37,259
212,MAHARASHTRA,2001,Service (Private),0,346,561,337,40,1284,0,74,48,21,2,145,1429
213,MAHARASHTRA,2001,Public Sector Undertaking,0,33,40,38,2,113,0,7,3,1,0,11,124
214,MAHARASHTRA,2001,Student,81,337,15,0,0,433,78,273,5,0,0,356,789
215,MAHARASHTRA,2001,Unemployed,0,386,357,162,51,956,0,60,19,17,5,101,1057
216,MAHARASHTRA,2001,Self-employed (Business activity),0,118,157,108,18,401,0,10,16,11,0,37,438
217,MAHARASHTRA,2001,Professional Activity,0,62,106,54,22,244,0,6,5,9,4,24,268
218,MAHARASHTRA,2001,Farming/Agriculture Activity,11,789,1263,643,239,2945,13,278,205,72,23,591,3536
219,MAHARASHTRA,2001,Others (Please Specify),33,640,984,471,277,2405,27,228,201,81,42,579,2984
220,MAHARASHTRA,2001,Retired Person,0,0,6,39,125,170,0,0,0,5,7,12,182
221,MAHARASHTRA,2001,Others (Please Specify),3,43,70,29,20,165,6,15,12,3,0,36,201
222,MAHARASHTRA,2001,Total,128,2805,3670,1938,797,9338,133,2633,1607,617,290,5280,14618
223,MAHARASHTRA,2001,Total Salaried,0,430,712,432,45,1619,0,100,66,25,2,193,1812
224,MAHARASHTRA,2001,Total Self-employed,44,1609,2510,1276,556,5995,40,522,427,173,69,1231,7226
225,MANIPUR,2001,House Wife,0,0,0,0,0,0,0,3,5,1,0,9,9
226,MANIPUR,2001,Service (Government),0,0,0,0,0,0,0,0,0,0,0,0,0
227,MANIPUR,2001,Service (Private),0,0,0,0,0,0,0,0,0,0,0,0,0
228,MANIPUR,2001,Public Sector Undertaking,0,3,0,0,0,3,0,0,0,0,0,0,3
229,MANIPUR,2001,Student,1,5,0,0,0,6,0,1,0,0,0,1,7
230,MANIPUR,2001,Unemployed,0,0,0,2,0,2,0,0,0,0,0,0,2
231,MANIPUR,2001,Self-employed (Business activity),0,0,0,0,0,0,0,0,0,0,0,0,0
232,MANIPUR,2001,Professional Activity,0,0,0,0,0,0,0,0,0,0,0,0,0
233,MANIPUR,2001,Farming/Agriculture Activity,0,0,0,0,0,0,0,0,0,0,0,0,0
234,MANIPUR,2001,Others (Please Specify),0,0,4,3,1,8,0,3,0,0,0,3,11
235,MANIPUR,2001,Retired Person,0,0,0,0,0,0,0,0,0,0,0,0,0
236,MANIPUR,2001,Others (Please Specify),0,4,1,0,0,5,0,4,0,0,0,4,9
237,MANIPUR,2001,Total,1,12,5,5,1,24,0,11,5,1,0,17,41
238,MANIPUR,2001,Total Salaried,0,3,0,0,0,3,0,0,0,0,0,0,3
239,MANIPUR,2001,Total Self-employed,0,0,4,3,1,8,0,3,0,0,0,3,11
240,MEGHALAYA,2001,House Wife,0,0,0,0,0,0,0,3,1,0,0,4,4
241,MEGHALAYA,2001,Service (Government),0,1,6,0,1,8,0,1,1,0,0,2,10
242,MEGHALAYA,2001,Service (Private),0,0,2,0,0,2,0,0,0,0,0,0,2
243,MEGHALAYA,2001,Public Sector Undertaking,0,0,0,0,0,0,0,0,0,0,0,0,0
244,MEGHALAYA,2001,Student,1,4,2,0,0,7,0,0,0,0,0,0,7
245,MEGHALAYA,2001,Unemployed,0,7,3,0,2,12,0,2,0,0,0,2,14
246,MEGHALAYA,2001,Self-employed (Business activity),0,2,2,0,0,4,0,0,0,0,0,0,4
247,MEGHALAYA,2001,Professional Activity,0,0,1,1,0,2,0,0,0,0,0,0,2
248,MEGHALAYA,2001,Farming/Agriculture Activity,0,0,2,0,0,2,0,2,0,0,0,2,4
249,MEGHALAYA,2001,Others (Please Specify),0,8,14,4,0,26,0,3,0,3,1,7,33
250,MEGHALAYA,2001,Retired Person,0,0,2,0,1,3,0,0,0,0,1,1,4
251,MEGHALAYA,2001,Others (Please Specify),0,0,2,0,1,3,0,0,0,0,0,0,3
252,MEGHALAYA,2001,Total,1,22,36,5,5,69,0,11,2,3,2,18,87
253,MEGHALAYA,2001,Total Salaried,0,1,8,0,1,10,0,1,1,0,0,2,12
254,MEGHALAYA,2001,Total Self-employed,0,10,19,5,0,34,0,5,0,3,1,9,43
255,MIZORAM,2001,House Wife,0,0,0,0,0,0,0,0,0,0,0,0,0
256,MIZORAM,2001,Service (Government),0,2,1,0,0,3,0,0,0,0,0,0,3
257,MIZORAM,2001,Service (Private),0,2,0,0,0,2,0,0,0,0,0,0,2
258,MIZORAM,2001,Public Sector Undertaking,0,0,0,0,0,0,0,0,0,0,0,0,0
259,MIZORAM,2001,Student,1,11,0,0,0,12,0,1,0,0,0,1,13
260,MIZORAM,2001,Unemployed,2,2,4,1,0,9,0,2,1,2,0,5,14
261,MIZORAM,2001,Self-employed (Business activity),0,0,0,0,0,0,0,0,0,0,0,0,0
262,MIZORAM,2001,Professional Activity,0,0,0,0,0,0,0,0,0,0,0,0,0
263,MIZORAM,2001,Farming/Agriculture Activity,0,0,0,0,0,0,0,0,0,0,0,0,0
264,MIZORAM,2001,Others (Please Specify),0,5,0,4,1,10,0,0,1,0,1,2,12
265,MIZORAM,2001,Retired Person,0,0,0,0,1,1,0,0,0,0,0,0,1
266,MIZORAM,2001,Others (Please Specify),4,0,5,0,0,9,0,0,0,0,0,0,9
267,MIZORAM,2001,Total,7,22,10,5,2,46,0,3,2,2,1,8,54
268,MIZORAM,2001,Total Salaried,0,4,1,0,0,5,0,0,0,0,0,0,5
269,MIZORAM,2001,Total Self-employed,0,5,0,4,1,10,0,0,1,0,1,2,12
270,NAGALAND,2001,House Wife,0,0,0,0,0,0,0,2,4,0,0,6,6
271,NAGALAND,2001,Service (Government),0,1,3,1,0,5,0,0,1,0,0,1,6
272,NAGALAND,2001,Service (Private),0,1,3,0,0,4,0,1,0,0,0,1,5
273,NAGALAND,2001,Public Sector Undertaking,0,0,0,0,0,0,0,0,0,0,0,0,0
274,NAGALAND,2001,Student,0,0,0,0,0,0,0,0,0,1,0,1,1
275,NAGALAND,2001,Unemployed,0,5,7,1,0,13,0,4,0,2,0,6,19
276,NAGALAND,2001,Self-employed (Business activity),0,0,2,0,0,2,0,0,0,0,0,0,2
277,NAGALAND,2001,Professional Activity,0,0,0,0,0,0,0,0,0,0,0,0,0
278,NAGALAND,2001,Farming/Agriculture Activity,0,0,0,0,0,0,0,0,0,0,0,0,0
279,NAGALAND,2001,Others (Please Specify),0,0,0,0,0,0,0,0,0,0,0,0,0
280,NAGALAND,2001,Retired Person,0,0,0,0,0,0,0,0,0,0,0,0,0
281,NAGALAND,2001,Others (Please Specify),0,1,0,0,0,1,0,0,0,0,0,0,1
282,NAGALAND,2001,Total,0,8,15,2,0,25,0,7,5,3,0,15,40
283,NAGALAND,2001,Total Salaried,0,2,6,1,0,9,0,1,1,0,0,2,11
284,NAGALAND,2001,Total Self-employed,0,0,2,0,0,2,0,0,0,0,0,0,2
285,ODISHA,2001,House Wife,0,0,0,0,0,0,2,347,330,135,26,840,840
286,ODISHA,2001,Service (Government),0,23,25,8,0,56,0,13,6,1,0,20,76
287,ODISHA,2001,Service (Private),0,58,52,32,8,150,0,49,27,7,0,83,233
288,ODISHA,2001,Public Sector Undertaking,0,16,20,5,0,41,0,13,17,2,2,34,75
289,ODISHA,2001,Student,24,111,9,0,0,144,27,94,0,1,2,124,268
290,ODISHA,2001,Unemployed,0,87,100,26,7,220,0,67,33,1,0,101,321
291,ODISHA,2001,Self-employed (Business activity),0,71,111,104,9,295,0,36,46,20,2,104,399
292,ODISHA,2001,Professional Activity,0,10,13,6,2,31,0,4,0,0,2,6,37
293,ODISHA,2001,Farming/Agriculture Activity,0,56,87,47,17,207,0,22,18,8,1,49,256
294,ODISHA,2001,Others (Please Specify),6,120,182,169,65,542,16,157,144,63,36,416,958
295,ODISHA,2001,Retired Person,0,2,0,13,11,26,0,0,0,0,2,2,28
296,ODISHA,2001,Others (Please Specify),6,154,110,82,25,377,17,79,58,22,8,184,561
297,ODISHA,2001,Total,36,708,709,492,144,2089,62,881,679,260,81,1963,4052
298,ODISHA,2001,Total Salaried,0,97,97,45,8,247,0,75,50,10,2,137,384
299,ODISHA,2001,Total Self-employed,6,257,393,326,93,1075,16,219,208,91,41,575,1650
300,PUNJAB,2001,House Wife,0,0,0,0,0,0,0,55,28,6,9,98,98
301,PUNJAB,2001,Service (Government),0,5,5,3,1,14,0,3,0,0,0,3,17
302,PUNJAB,2001,Service (Private),0,17,9,4,2,32,0,3,2,1,0,6,38
303,PUNJAB,2001,Public Sector Undertaking,0,4,2,1,1,8,0,2,1,0,0,3,11
304,PUNJAB,2001,Student,0,5,0,0,0,5,0,3,0,0,0,3,8
305,PUNJAB,2001,Unemployed,0,24,15,3,19,61,0,6,4,0,0,10,71
306,PUNJAB,2001,Self-employed (Business activity),0,9,0,6,1,16,0,0,0,1,0,1,17
307,PUNJAB,2001,Professional Activity,1,3,0,1,2,7,0,0,0,0,0,0,7
308,PUNJAB,2001,Farming/Agriculture Activity,0,14,0,9,19,42,0,3,0,0,0,3,45
309,PUNJAB,2001,Others (Please Specify),0,17,0,4,4,25,0,2,1,0,0,3,28
310,PUNJAB,2001,Retired Person,0,0,0,0,6,6,0,0,0,0,0,0,6
311,PUNJAB,2001,Others (Please Specify),0,31,33,104,12,180,0,72,30,11,9,122,302
312,PUNJAB,2001,Total,1,129,64,135,67,396,0,149,66,19,18,252,648
313,PUNJAB,2001,Total Salaried,0,26,16,8,4,54,0,8,3,1,0,12,66
314,PUNJAB,2001,Total Self-employed,1,43,0,20,26,90,0,5,1,1,0,7,97
315,RAJASTHAN,2001,House Wife,0,0,0,0,0,0,2,391,265,101,24,783,783
316,RAJASTHAN,2001,Service (Government),0,14,33,12,0,59,0,2,0,1,0,3,62
317,RAJASTHAN,2001,Service (Private),0,88,84,36,10,218,0,14,11,2,0,27,245
318,RAJASTHAN,2001,Public Sector Undertaking,0,24,41,7,0,72,0,4,6,1,0,11,83
319,RAJASTHAN,2001,Student,34,68,14,5,0,121,30,53,0,0,0,83,204
320,RAJASTHAN,2001,Unemployed,0,89,70,18,2,179,0,19,2,0,0,21,200
321,RAJASTHAN,2001,Self-employed (Business activity),0,56,49,29,9,143,0,8,3,0,0,11,154
322,RAJASTHAN,2001,Professional Activity,1,13,14,11,1,40,0,0,0,0,0,0,40
323,RAJASTHAN,2001,Farming/Agriculture Activity,1,156,173,78,16,424,1,38,33,5,4,81,505
324,RAJASTHAN,2001,Others (Please Specify),45,88,127,92,29,381,21,65,28,5,12,131,512
325,RAJASTHAN,2001,Retired Person,0,0,0,0,8,8,0,0,0,0,0,0,8
326,RAJASTHAN,2001,Others (Please Specify),5,81,108,75,45,314,7,30,39,7,2,85,399
327,RAJASTHAN,2001,Total,86,677,713,363,120,1959,61,624,387,122,42,1236,3195
328,RAJASTHAN,2001,Total Salaried,0,126,158,55,10,349,0,20,17,4,0,41,390
329,RAJASTHAN,2001,Total Self-employed,47,313,363,210,55,988,22,111,64,10,16,223,1211
330,SIKKIM,2001,House Wife,0,0,0,0,0,0,0,2,10,0,0,12,12
331,SIKKIM,2001,Service (Government),0,1,1,0,0,2,0,2,1,0,0,3,5
332,SIKKIM,2001,Service (Private),0,3,4,0,0,7,0,0,0,0,0,0,7
333,SIKKIM,2001,Public Sector Undertaking,0,1,0,0,0,1,0,0,0,0,0,0,1
334,SIKKIM,2001,Student,0,1,0,0,0,1,2,2,0,0,0,4,5
335,SIKKIM,2001,Unemployed,0,4,3,0,1,8,0,3,1,0,0,4,12
336,SIKKIM,2001,Self-employed (Business activity),0,0,3,0,0,3,0,0,0,0,0,0,3
337,SIKKIM,2001,Professional Activity,0,2,6,0,0,8,0,3,4,0,0,7,15
338,SIKKIM,2001,Farming/Agriculture Activity,0,6,4,4,2,16,0,2,0,0,0,2,18
339,SIKKIM,2001,Others (Please Specify),0,9,6,1,0,16,0,0,0,0,0,0,16
340,SIKKIM,2001,Retired Person,0,0,0,0,0,0,0,0,0,0,0,0,0
341,SIKKIM,2001,Others (Please Specify),0,0,0,0,0,0,0,0,0,0,0,0,0
342,SIKKIM,2001,Total,0,27,27,5,3,62,2,14,16,0,0,32,94
343,SIKKIM,2001,Total Salaried,0,5,5,0,0,10,0,2,1,0,0,3,13
344,SIKKIM,2001,Total Self-employed,0,17,19,5,2,43,0,5,4,0,0,9,52
345,TAMIL NADU,2001,House Wife,0,0,0,0,0,0,0,822,632,226,75,1755,1755
346,TAMIL NADU,2001,Service (Government),0,21,63,79,3,166,0,23,33,10,1,67,233
347,TAMIL NADU,2001,Service (Private),2,221,375,207,45,850,3,89,89,48,5,234,1084
348,TAMIL NADU,2001,Public Sector Undertaking,0,75,78,50,4,207,0,45,42,9,2,98,305
349,TAMIL NADU,2001,Student,46,180,10,0,0,236,39,116,7,6,0,168,404
350,TAMIL NADU,2001,Unemployed,6,333,540,402,49,1330,21,178,238,76,15,528,1858
351,TAMIL NADU,2001,Self-employed (Business activity),2,134,309,164,47,656,2,12,11,31,1,57,713
352,TAMIL NADU,2001,Professional Activity,3,83,141,58,9,294,0,14,27,23,0,64,358
353,TAMIL NADU,2001,Farming/Agriculture Activity,5,304,253,170,94,826,7,63,50,24,15,159,985
354,TAMIL NADU,2001,Others (Please Specify),18,492,508,313,135,1466,8,216,172,122,55,573,2039
355,TAMIL NADU,2001,Retired Person,0,0,0,9,35,44,0,0,0,0,6,6,50
356,TAMIL NADU,2001,Others (Please Specify),64,272,405,221,91,1053,65,124,143,83,38,453,1506
357,TAMIL NADU,2001,Total,146,2115,2682,1673,512,7128,145,1702,1444,658,213,4162,11290
358,TAMIL NADU,2001,Total Salaried,2,317,516,336,52,1223,3,157,164,67,8,399,1622
359,TAMIL NADU,2001,Total Self-employed,28,1013,1211,705,285,3242,17,305,260,200,71,853,4095
360,TRIPURA,2001,House Wife,0,0,0,0,0,0,0,20,40,8,3,71,71
361,TRIPURA,2001,Service (Government),0,0,0,0,0,0,0,0,0,0,0,0,0
362,TRIPURA,2001,Service (Private),0,2,10,1,0,13,0,0,0,2,0,2,15
363,TRIPURA,2001,Public Sector Undertaking,0,0,0,0,0,0,0,3,0,0,0,3,3
364,TRIPURA,2001,Student,10,18,9,0,0,37,5,10,18,0,0,33,70
365,TRIPURA,2001,Unemployed,2,20,14,2,2,40,2,10,1,1,0,14,54
366,TRIPURA,2001,Self-employed (Business activity),0,9,30,10,0,49,0,2,0,0,0,2,51
367,TRIPURA,2001,Professional Activity,0,4,4,1,0,9,0,2,2,0,0,4,13
368,TRIPURA,2001,Farming/Agriculture Activity,0,10,26,3,2,41,0,0,0,0,0,0,41
369,TRIPURA,2001,Others (Please Specify),0,16,25,6,3,50,0,10,1,4,4,19,69
370,TRIPURA,2001,Retired Person,0,0,0,0,0,0,0,0,0,0,0,0,0
371,TRIPURA,2001,Others (Please Specify),6,52,76,64,26,224,5,51,125,47,15,243,467
372,TRIPURA,2001,Total,18,131,194,87,33,463,12,108,187,62,22,391,854
373,TRIPURA,2001,Total Salaried,0,2,10,1,0,13,0,3,0,2,0,5,18
374,TRIPURA,2001,Total Self-employed,0,39,85,20,5,149,0,14,3,4,4,25,174
375,UTTAR PRADESH,2001,House Wife,0,0,0,0,0,0,13,577,374,87,24,1075,1075
376,UTTAR PRADESH,2001,Service (Government),0,8,16,6,1,31,0,15,11,0,0,26,57
377,UTTAR PRADESH,2001,Service (Private),1,113,85,39,1,239,1,34,23,15,0,73,312
378,UTTAR PRADESH,2001,Public Sector Undertaking,0,22,11,4,2,39,0,5,2,0,0,7,46
379,UTTAR PRADESH,2001,Student,38,82,3,0,0,123,20,66,2,0,0,88,211
380,UTTAR PRADESH,2001,Unemployed,12,167,96,34,7,316,2,12,4,2,0,20,336
381,UTTAR PRADESH,2001,Self-employed (Business activity),0,55,37,33,6,131,0,7,1,0,0,8,139
382,UTTAR PRADESH,2001,Professional Activity,0,8,17,9,3,37,0,1,2,1,0,4,41
383,UTTAR PRADESH,2001,Farming/Agriculture Activity,6,175,175,140,82,578,4,39,40,19,8,110,688
384,UTTAR PRADESH,2001,Others (Please Specify),11,57,66,45,20,199,11,88,59,47,36,241,440
385,UTTAR PRADESH,2001,Retired Person,0,0,0,2,3,5,0,1,2,1,2,6,11
386,UTTAR PRADESH,2001,Others (Please Specify),5,29,39,18,12,103,12,25,17,3,0,57,160
387,UTTAR PRADESH,2001,Total,73,716,545,330,137,1801,63,870,537,175,70,1715,3516
388,UTTAR PRADESH,2001,Total Salaried,1,143,112,49,4,309,1,54,36,15,0,106,415
389,UTTAR PRADESH,2001,Total Self-employed,17,295,295,227,111,945,15,135,102,67,44,363,1308
390,UTTARAKHAND,2001,House Wife,0,0,0,0,0,0,0,30,24,8,2,64,64
391,UTTARAKHAND,2001,Service (Government),0,2,6,2,0,10,0,9,1,0,0,10,20
392,UTTARAKHAND,2001,Service (Private),1,3,41,18,2,65,3,9,5,0,0,17,82
393,UTTARAKHAND,2001,Public Sector Undertaking,0,1,1,0,0,2,0,0,0,0,0,0,2
394,UTTARAKHAND,2001,Student,2,10,0,0,0,12,1,8,0,0,0,9,21
395,UTTARAKHAND,2001,Unemployed,0,10,18,0,0,28,0,3,0,1,0,4,32
396,UTTARAKHAND,2001,Self-employed (Business activity),0,4,0,4,0,8,0,0,0,0,0,0,8
397,UTTARAKHAND,2001,Professional Activity,0,0,0,0,0,0,0,0,0,0,0,0,0
398,UTTARAKHAND,2001,Farming/Agriculture Activity,0,3,9,5,1,18,0,2,1,0,0,3,21
399,UTTARAKHAND,2001,Others (Please Specify),0,7,12,9,2,30,0,10,8,1,0,19,49
400,UTTARAKHAND,2001,Retired Person,0,0,0,2,0,2,0,0,0,0,0,0,2
401,UTTARAKHAND,2001,Others (Please Specify),0,1,4,2,0,7,0,1,2,0,0,3,10
402,UTTARAKHAND,2001,Total,3,41,91,42,5,182,4,72,41,10,2,129,311
403,UTTARAKHAND,2001,Total Salaried,1,6,48,20,2,77,3,18,6,0,0,27,104
404,UTTARAKHAND,2001,Total Self-employed,0,14,21,18,3,56,0,12,9,1,0,22,78
405,WEST BENGAL,2001,House Wife,0,0,0,0,0,0,0,653,588,242,72,1555,1555
406,WEST BENGAL,2001,Service (Government),0,42,65,68,7,182,0,38,65,13,5,121,303
407,WEST BENGAL,2001,Service (Private),16,229,366,335,49,995,41,118,121,97,48,425,1420
408,WEST BENGAL,2001,Public Sector Undertaking,0,170,111,137,55,473,0,93,104,64,8,269,742
409,WEST BENGAL,2001,Student,132,263,2,0,0,397,73,331,13,0,0,417,814
410,WEST BENGAL,2001,Unemployed,2,217,229,186,12,646,0,99,110,14,0,223,869
411,WEST BENGAL,2001,Self-employed (Business activity),0,88,193,195,33,509,0,34,44,51,37,166,675
412,WEST BENGAL,2001,Professional Activity,0,23,67,64,41,195,5,22,28,16,10,81,276
413,WEST BENGAL,2001,Farming/Agriculture Activity,8,284,279,266,98,935,13,72,133,93,0,311,1246
414,WEST BENGAL,2001,Others (Please Specify),21,364,328,291,153,1157,24,271,265,215,72,847,2004
415,WEST BENGAL,2001,Retired Person,0,0,0,8,94,102,0,0,0,17,28,45,147
416,WEST BENGAL,2001,Others (Please Specify),104,347,786,496,171,1904,127,523,544,348,193,1735,3639
417,WEST BENGAL,2001,Total,283,2027,2426,2046,713,7495,283,2254,2015,1170,473,6195,13690
418,WEST BENGAL,2001,Total Salaried,16,441,542,540,111,1650,41,249,290,174,61,815,2465
419,WEST BENGAL,2001,Total Self-employed,29,759,867,816,325,2796,42,399,470,375,119,1405,4201
420,TOTAL (STATES),2001,House Wife,0,0,0,0,0,0,69,9879,7077,2934,1166,21125,21125
421,TOTAL (STATES),2001,Service (Government),0,371,751,574,21,1717,0,201,231,70,14,516,2233
422,TOTAL (STATES),2001,Service (Private),24,2107,2881,1655,360,7027,60,692,483,298,110,1643,8670
423,TOTAL (STATES),2001,Public Sector Undertaking,0,628,636,465,126,1855,0,254,222,95,14,585,2440
424,TOTAL (STATES),2001,Student,671,2179,160,27,0,3037,526,1666,66,22,2,2282,5319
425,TOTAL (STATES),2001,Unemployed,52,2806,2912,1814,562,8146,51,855,595,194,90,1785,9931
426,TOTAL (STATES),2001,Self-employed (Business activity),39,1160,1881,1253,278,4611,25,204,182,148,64,623,5234
427,TOTAL (STATES),2001,Professional Activity,21,603,955,538,166,2283,11,107,99,76,23,316,2599
428,TOTAL (STATES),2001,Farming/Agriculture Activity,88,3808,5080,3375,1357,13708,80,1021,888,449,138,2576,16284
429,TOTAL (STATES),2001,Others (Please Specify),275,3514,4515,3117,1510,12931,243,1887,1436,898,453,4917,17848
430,TOTAL (STATES),2001,Retired Person,0,27,32,140,497,696,0,6,20,46,112,184,880
431,TOTAL (STATES),2001,Others (Please Specify),309,2322,3271,2221,964,9087,407,1693,1414,880,431,4825,13912
432,TOTAL (STATES),2001,Total,1479,19525,23074,15179,5841,65098,1472,18465,12713,6110,2617,41377,106475
433,TOTAL (STATES),2001,Total Salaried,24,3106,4268,2694,507,10599,60,1147,936,463,138,2744,13343
434,TOTAL (STATES),2001,Total Self-employed,423,9085,12431,8283,3311,33533,359,3219,2605,1571,678,8432,41965
435,A & N ISLANDS,2001,House Wife,0,0,0,0,0,0,0,21,9,5,3,38,38
436,A & N ISLANDS,2001,Service (Government),0,3,10,7,0,20,0,0,0,0,0,0,20
437,A & N ISLANDS,2001,Service (Private),0,14,7,9,2,32,0,0,0,0,0,0,32
438,A & N ISLANDS,2001,Public Sector Undertaking,0,2,1,1,0,4,0,0,0,0,0,0,4
439,A & N ISLANDS,2001,Student,1,2,0,0,0,3,2,9,0,0,0,11,14
440,A & N ISLANDS,2001,Unemployed,0,0,0,0,0,0,0,0,0,0,0,0,0
441,A & N ISLANDS,2001,Self-employed (Business activity),0,0,0,0,0,0,0,0,0,0,0,0,0
442,A & N ISLANDS,2001,Professional Activity,0,0,0,0,0,0,0,0,0,0,0,0,0
443,A & N ISLANDS,2001,Farming/Agriculture Activity,0,0,0,0,3,3,0,0,0,0,0,0,3
444,A & N ISLANDS,2001,Others (Please Specify),1,4,5,4,1,15,0,1,0,0,0,1,16
445,A & N ISLANDS,2001,Retired Person,0,0,0,0,2,2,0,0,0,0,0,0,2
446,A & N ISLANDS,2001,Others (Please Specify),0,0,0,0,0,0,0,0,0,0,0,0,0
447,A & N ISLANDS,2001,Total,2,25,23,21,8,79,2,31,9,5,3,50,129
448,A & N ISLANDS,2001,Total Salaried,0,19,18,17,2,56,0,0,0,0,0,0,56
449,A & N ISLANDS,2001,Total Self-employed,1,4,5,4,4,18,0,1,0,0,0,1,19
450,CHANDIGARH,2001,House Wife,0,0,0,0,0,0,0,11,6,2,0,19,19
451,CHANDIGARH,2001,Service (Government),0,1,1,1,0,3,0,0,0,0,0,0,3
452,CHANDIGARH,2001,Service (Private),0,4,4,0,0,8,0,0,0,0,0,0,8
453,CHANDIGARH,2001,Public Sector Undertaking,0,0,0,0,0,0,0,0,0,0,0,0,0
454,CHANDIGARH,2001,Student,0,4,0,0,0,4,0,2,0,0,0,2,6
455,CHANDIGARH,2001,Unemployed,0,1,0,0,0,1,0,0,0,0,0,0,1
456,CHANDIGARH,2001,Self-employed (Business activity),0,1,0,0,0,1,0,0,0,0,0,0,1
457,CHANDIGARH,2001,Professional Activity,0,0,0,0,0,0,0,0,0,0,0,0,0
458,CHANDIGARH,2001,Farming/Agriculture Activity,0,0,0,0,0,0,0,0,0,0,0,0,0
459,CHANDIGARH,2001,Others (Please Specify),0,2,4,0,0,6,0,0,0,0,0,0,6
460,CHANDIGARH,2001,Retired Person,0,0,0,0,1,1,0,0,0,0,0,0,1
461,CHANDIGARH,2001,Others (Please Specify),0,7,6,1,1,15,0,5,5,0,0,10,25
462,CHANDIGARH,2001,Total,0,20,15,2,2,39,0,18,11,2,0,31,70
463,CHANDIGARH,2001,Total Salaried,0,5,5,1,0,11,0,0,0,0,0,0,11
464,CHANDIGARH,2001,Total Self-employed,0,3,4,0,0,7,0,0,0,0,0,0,7
465,D & N HAVELI,2001,House Wife,0,0,0,0,0,0,1,9,3,0,0,13,13
466,D & N HAVELI,2001,Service (Government),0,0,0,0,0,0,0,0,0,0,0,0,0
467,D & N HAVELI,2001,Service (Private),0,1,3,1,0,5,0,0,0,0,0,0,5
468,D & N HAVELI,2001,Public Sector Undertaking,0,0,0,0,0,0,0,0,0,0,0,0,0
469,D & N HAVELI,2001,Student,0,0,0,0,0,0,0,0,0,0,0,0,0
470,D & N HAVELI,2001,Unemployed,0,5,3,0,0,8,0,0,0,0,0,0,8
471,D & N HAVELI,2001,Self-employed (Business activity),0,0,0,0,0,0,0,0,0,0,0,0,0
472,D & N HAVELI,2001,Professional Activity,0,0,0,0,0,0,0,0,0,0,0,0,0
473,D & N HAVELI,2001,Farming/Agriculture Activity,0,4,4,3,8,19,0,0,0,0,0,0,19
474,D & N HAVELI,2001,Others (Please Specify),0,0,0,2,0,2,0,0,0,1,0,1,3
475,D & N HAVELI,2001,Retired Person,0,0,0,0,0,0,0,0,0,0,0,0,0
476,D & N HAVELI,2001,Others (Please Specify),0,0,0,1,0,1,0,0,1,0,0,1,2
477,D & N HAVELI,2001,Total,0,10,10,7,8,35,1,9,4,1,0,15,50
478,D & N HAVELI,2001,Total Salaried,0,1,3,1,0,5,0,0,0,0,0,0,5
479,D & N HAVELI,2001,Total Self-employed,0,4,4,5,8,21,0,0,0,1,0,1,22
480,DAMAN & DIU,2001,House Wife,0,0,0,0,0,0,0,3,0,0,0,3,3
481,DAMAN & DIU,2001,Service (Government),0,0,0,0,0,0,0,0,0,0,0,0,0
482,DAMAN & DIU,2001,Service (Private),0,2,3,0,0,5,0,1,0,0,0,1,6
483,DAMAN & DIU,2001,Public Sector Undertaking,0,0,0,0,0,0,0,0,0,0,0,0,0
484,DAMAN & DIU,2001,Student,0,0,0,0,0,0,0,0,0,0,0,0,0
485,DAMAN & DIU,2001,Unemployed,0,0,0,0,0,0,0,0,0,0,0,0,0
486,DAMAN & DIU,2001,Self-employed (Business activity),0,0,0,0,0,0,0,0,0,0,0,0,0
487,DAMAN & DIU,2001,Professional Activity,0,0,1,0,0,1,0,0,0,0,0,0,1
488,DAMAN & DIU,2001,Farming/Agriculture Activity,0,0,0,0,0,0,0,0,0,0,0,0,0
489,DAMAN & DIU,2001,Others (Please Specify),0,1,2,0,0,3,0,0,0,0,0,0,3
490,DAMAN & DIU,2001,Retired Person,0,0,0,0,0,0,0,0,0,0,0,0,0
491,DAMAN & DIU,2001,Others (Please Specify),0,1,0,0,0,1,0,0,0,0,0,0,1
492,DAMAN & DIU,2001,Total,0,4,6,0,0,10,0,4,0,0,0,4,14
493,DAMAN & DIU,2001,Total Salaried,0,2,3,0,0,5,0,1,0,0,0,1,6
494,DAMAN & DIU,2001,Total Self-employed,0,1,3,0,0,4,0,0,0,0,0,0,4
495,DELHI (UT),2001,House Wife,0,0,0,0,0,0,0,174,118,27,8,327,327
496,DELHI (UT),2001,Service (Government),0,11,13,5,0,29,0,1,1,0,0,2,31
497,DELHI (UT),2001,Service (Private),0,68,51,27,1,147,0,12,1,0,0,13,160
498,DELHI (UT),2001,Public Sector Undertaking,0,10,6,2,1,19,0,1,0,0,0,1,20
499,DELHI (UT),2001,Student,9,42,4,0,0,55,14,35,0,0,0,49,104
500,DELHI (UT),2001,Unemployed,1,91,76,34,7,209,4,13,3,0,0,20,229
501,DELHI (UT),2001,Self-employed (Business activity),0,6,13,4,0,23,0,0,0,0,0,0,23
502,DELHI (UT),2001,Professional Activity,0,3,4,4,0,11,0,1,0,0,0,1,12
503,DELHI (UT),2001,Farming/Agriculture Activity,0,8,7,1,0,16,0,2,0,0,0,2,18
504,DELHI (UT),2001,Others (Please Specify),3,67,76,32,8,186,6,43,31,1,3,84,270
505,DELHI (UT),2001,Retired Person,0,0,0,0,1,1,0,0,0,0,0,0,1
506,DELHI (UT),2001,Others (Please Specify),2,9,10,6,7,34,4,0,3,3,0,10,44
507,DELHI (UT),2001,Total,15,315,260,115,25,730,28,282,157,31,11,509,1239
508,DELHI (UT),2001,Total Salaried,0,89,70,34,2,195,0,14,2,0,0,16,211
509,DELHI (UT),2001,Total Self-employed,3,84,100,41,8,236,6,46,31,1,3,87,323
510,LAKSHADWEEP,2001,House Wife,0,0,0,0,0,0,0,0,0,0,0,0,0
511,LAKSHADWEEP,2001,Service (Government),0,0,0,0,0,0,0,0,0,0,0,0,0
512,LAKSHADWEEP,2001,Service (Private),0,0,0,0,0,0,0,0,0,0,0,0,0
513,LAKSHADWEEP,2001,Public Sector Undertaking,0,0,0,0,0,0,0,0,0,0,0,0,0
514,LAKSHADWEEP,2001,Student,0,0,0,0,0,0,0,0,0,0,0,0,0
515,LAKSHADWEEP,2001,Unemployed,0,0,0,0,0,0,0,0,0,0,0,0,0
516,LAKSHADWEEP,2001,Self-employed (Business activity),0,0,0,0,0,0,0,0,0,0,0,0,0
517,LAKSHADWEEP,2001,Professional Activity,0,0,0,0,0,0,0,0,0,0,0,0,0
518,LAKSHADWEEP,2001,Farming/Agriculture Activity,0,0,0,0,0,0,0,0,0,0,0,0,0
519,LAKSHADWEEP,2001,Others (Please Specify),0,0,0,0,0,0,0,0,0,0,0,0,0
520,LAKSHADWEEP,2001,Retired Person,0,0,0,0,0,0,0,0,0,0,0,0,0
521,LAKSHADWEEP,2001,Others (Please Specify),0,0,0,0,0,0,0,0,0,0,0,0,0
522,LAKSHADWEEP,2001,Total,0,0,0,0,0,0,0,0,0,0,0,0,0
523,LAKSHADWEEP,2001,Total Salaried,0,0,0,0,0,0,0,0,0,0,0,0,0
524,LAKSHADWEEP,2001,Total Self-employed,0,0,0,0,0,0,0,0,0,0,0,0,0
525,PUDUCHERRY,2001,House Wife,0,0,0,0,0,0,0,63,46,18,7,134,134
526,PUDUCHERRY,2001,Service (Government),0,0,5,0,0,5,0,0,0,1,0,1,6
527,PUDUCHERRY,2001,Service (Private),0,26,44,22,2,94,0,5,1,0,0,6,100
528,PUDUCHERRY,2001,Public Sector Undertaking,0,0,1,3,0,4,0,0,0,1,0,1,5
529,PUDUCHERRY,2001,Student,2,7,0,0,0,9,4,18,0,0,0,22,31
530,PUDUCHERRY,2001,Unemployed,0,14,6,5,26,51,2,27,3,0,0,32,83
531,PUDUCHERRY,2001,Self-employed (Business activity),0,7,5,4,1,17,0,0,0,0,0,0,17
532,PUDUCHERRY,2001,Professional Activity,0,0,0,0,0,0,0,0,0,0,0,0,0
533,PUDUCHERRY,2001,Farming/Agriculture Activity,0,10,28,35,10,83,0,5,1,2,0,8,91
534,PUDUCHERRY,2001,Others (Please Specify),0,18,26,15,1,60,0,2,0,0,0,2,62
535,PUDUCHERRY,2001,Retired Person,0,0,0,0,0,0,0,0,0,0,0,0,0
536,PUDUCHERRY,2001,Others (Please Specify),0,0,0,0,0,0,0,0,0,0,0,0,0
537,PUDUCHERRY,2001,Total,2,82,115,84,40,323,6,120,51,22,7,206,529
538,PUDUCHERRY,2001,Total Salaried,0,26,50,25,2,103,0,5,1,2,0,8,111
539,PUDUCHERRY,2001,Total Self-employed,0,35,59,54,12,160,0,7,1,2,0,10,170
540,TOTAL (UTs),2001,House Wife,0,0,0,0,0,0,1,281,182,52,18,534,534
541,TOTAL (UTs),2001,Service (Government),0,15,29,13,0,57,0,1,1,1,0,3,60
542,TOTAL (UTs),2001,Service (Private),0,115,112,59,5,291,0,18,2,0,0,20,311
543,TOTAL (UTs),2001,Public Sector Undertaking,0,12,8,6,1,27,0,1,0,1,0,2,29
544,TOTAL (UTs),2001,Student,12,55,4,0,0,71,20,64,0,0,0,84,155
545,TOTAL (UTs),2001,Unemployed,1,111,85,39,33,269,6,40,6,0,0,52,321
546,TOTAL (UTs),2001,Self-employed (Business activity),0,14,18,8,1,41,0,0,0,0,0,0,41
547,TOTAL (UTs),2001,Professional Activity,0,3,5,4,0,12,0,1,0,0,0,1,13
548,TOTAL (UTs),2001,Farming/Agriculture Activity,0,22,39,39,21,121,0,7,1,2,0,10,131
549,TOTAL (UTs),2001,Others (Please Specify),4,92,113,53,10,272,6,46,31,2,3,88,360
550,TOTAL (UTs),2001,Retired Person,0,0,0,0,4,4,0,0,0,0,0,0,4
551,TOTAL (UTs),2001,Others (Please Specify),2,17,16,8,8,51,4,5,9,3,0,21,72
552,TOTAL (UTs),2001,Total,19,456,429,229,83,1216,37,464,232,61,21,815,2031
553,TOTAL (UTs),2001,Total Salaried,0,142,149,78,6,375,0,20,3,2,0,25,400
554,TOTAL (UTs),2001,Total Self-employed,4,131,175,104,32,446,6,54,32,4,3,99,545
555,TOTAL (ALL INDIA),2001,House Wife,0,0,0,0,0,0,70,10160,7259,2986,1184,21659,21659
556,TOTAL (ALL INDIA),2001,Service (Government),0,386,780,587,21,1774,0,202,232,71,14,519,2293
557,TOTAL (ALL INDIA),2001,Service (Private),24,2222,2993,1714,365,7318,60,710,485,298,110,1663,8981
558,TOTAL (ALL INDIA),2001,Public Sector Undertaking,0,640,644,471,127,1882,0,255,222,96,14,587,2469
559,TOTAL (ALL INDIA),2001,Student,683,2234,164,27,0,3108,546,1730,66,22,2,2366,5474
560,TOTAL (ALL INDIA),2001,Unemployed,53,2917,2997,1853,595,8415,57,895,601,194,90,1837,10252
561,TOTAL (ALL INDIA),2001,Self-employed (Business activity),39,1174,1899,1261,279,4652,25,204,182,148,64,623,5275
562,TOTAL (ALL INDIA),2001,Professional Activity,21,606,960,542,166,2295,11,108,99,76,23,317,2612
563,TOTAL (ALL INDIA),2001,Farming/Agriculture Activity,88,3830,5119,3414,1378,13829,80,1028,889,451,138,2586,16415
564,TOTAL (ALL INDIA),2001,Others (Please Specify),279,3606,4628,3170,1520,13203,249,1933,1467,900,456,5005,18208
565,TOTAL (ALL INDIA),2001,Retired Person,0,27,32,140,501,700,0,6,20,46,112,184,884
566,TOTAL (ALL INDIA),2001,Others (Please Specify),311,2339,3287,2229,972,9138,411,1698,1423,883,431,4846,13984
567,TOTAL (ALL INDIA),2001,Total,1498,19981,23503,15408,5924,66314,1509,18929,12945,6171,2638,42192,108506
568,TOTAL (ALL INDIA),2001,Total Salaried,24,3248,4417,2772,513,10974,60,1167,939,465,138,2769,13743
569,TOTAL (ALL INDIA),2001,Total Self-employed,427,9216,12606,8387,3343,33979,365,3273,2637,1575,681,8531,42510
0,ANDHRA PRADESH,2003,House Wife,0,0,0,0,0,0,4,955,622,256,92,1929,1929
1,ANDHRA PRADESH,2003,Service (Government),0,76,84,79,11,250,0,11,21,4,0,36,286
2,ANDHRA PRADESH,2003,Service (Private),2,90,166,103,8,369,2,32,43,21,5,103,472
3,ANDHRA PRADESH,2003,Public Sector Undertaking,0,20,48,37,16,121,0,20,21,11,3,55,176
4,ANDHRA PRADESH,2003,Student,69,240,39,0,0,348,71,148,2,0,0,221,569
5,ANDHRA PRADESH,2003,Unemployed,1,224,307,116,0,648,9,52,14,3,0,78,726
6,ANDHRA PRADESH,2003,Self-employed (Business activity),2,87,238,222,47,596,9,18,49,27,5,108,704
7,ANDHRA PRADESH,2003,Professional Activity,0,104,180,90,16,390,1,6,18,2,0,27,417
8,ANDHRA PRADESH,2003,Farming/Agriculture Activity,7,325,585,376,149,1442,6,81,163,96,12,358,1800
9,ANDHRA PRADESH,2003,Others (Please Specify),17,333,475,254,118,1197,31,129,68,58,29,315,1512
10,ANDHRA PRADESH,2003,Retired Person,0,0,15,25,37,77,0,0,3,33,16,52,129
11,ANDHRA PRADESH,2003,Others (Please Specify),57,771,709,443,95,2075,64,233,180,98,39,614,2689
12,ANDHRA PRADESH,2003,Total,155,2270,2846,1745,497,7513,197,1685,1204,609,201,3896,11409
13,ANDHRA PRADESH,2003,Total Salaried,2,186,298,219,35,740,2,63,85,36,8,194,934
14,ANDHRA PRADESH,2003,Total Self-employed,26,849,1478,942,330,3625,47,234,298,183,46,808,4433
15,ARUNACHAL PRADESH,2003,House Wife,0,0,0,0,0,0,0,8,8,2,0,18,18
16,ARUNACHAL PRADESH,2003,Service (Government),0,1,7,4,0,12,0,0,2,0,0,2,14
17,ARUNACHAL PRADESH,2003,Service (Private),0,2,1,0,0,3,0,0,0,0,0,0,3
18,ARUNACHAL PRADESH,2003,Public Sector Undertaking,0,1,0,0,0,1,0,0,0,0,0,0,1
19,ARUNACHAL PRADESH,2003,Student,1,0,0,0,0,1,1,3,0,0,0,4,5
20,ARUNACHAL PRADESH,2003,Unemployed,1,2,0,0,0,3,0,0,0,0,0,0,3
21,ARUNACHAL PRADESH,2003,Self-employed (Business activity),0,5,12,7,0,24,0,2,0,0,0,2,26
22,ARUNACHAL PRADESH,2003,Professional Activity,0,0,0,0,0,0,0,0,0,0,0,0,0
23,ARUNACHAL PRADESH,2003,Farming/Agriculture Activity,1,0,6,1,2,10,0,1,0,0,0,1,11
24,ARUNACHAL PRADESH,2003,Others (Please Specify),0,0,0,0,0,0,0,0,0,0,0,0,0
25,ARUNACHAL PRADESH,2003,Retired Person,0,0,0,0,0,0,0,0,0,0,0,0,0
26,ARUNACHAL PRADESH,2003,Others (Please Specify),0,0,0,0,0,0,0,0,0,0,0,0,0
27,ARUNACHAL PRADESH,2003,Total,3,11,26,12,2,54,1,14,10,2,0,27,81
28,ARUNACHAL PRADESH,2003,Total Salaried,0,4,8,4,0,16,0,0,2,0,0,2,18
29,ARUNACHAL PRADESH,2003,Total Self-employed,1,5,18,8,2,34,0,3,0,0,0,3,37
30,ASSAM,2003,House Wife,0,0,0,0,0,0,2,183,126,57,13,381,381
31,ASSAM,2003,Service (Government),0,2,9,4,0,15,0,0,0,0,0,0,15
32,ASSAM,2003,Service (Private),0,27,26,33,2,88,0,5,1,2,0,8,96
33,ASSAM,2003,Public Sector Undertaking,0,35,22,15,1,73,0,16,5,1,0,22,95
34,ASSAM,2003,Student,24,101,4,0,0,129,19,72,0,0,0,91,220
35,ASSAM,2003,Unemployed,0,40,111,52,2,205,0,28,28,10,1,67,272
36,ASSAM,2003,Self-employed (Business activity),0,56,72,51,2,181,0,22,2,2,0,26,207
37,ASSAM,2003,Professional Activity,2,8,17,3,4,34,0,0,0,0,0,0,34
38,ASSAM,2003,Farming/Agriculture Activity,2,53,56,27,18,156,0,30,1,0,0,31,187
39,ASSAM,2003,Others (Please Specify),20,270,182,106,17,595,15,98,42,15,13,183,778
40,ASSAM,2003,Retired Person,0,0,0,0,1,1,0,0,0,0,0,0,1
41,ASSAM,2003,Others (Please Specify),13,79,58,32,17,199,12,58,20,14,7,111,310
42,ASSAM,2003,Total,61,671,557,323,64,1676,48,512,225,101,34,920,2596
43,ASSAM,2003,Total Salaried,0,64,57,52,3,176,0,21,6,3,0,30,206
44,ASSAM,2003,Total Self-employed,24,387,327,187,41,966,15,150,45,17,13,240,1206
45,BIHAR,2003,House Wife,0,0,0,0,0,0,0,75,61,2,0,138,138
46,BIHAR,2003,Service (Government),0,0,2,1,0,3,0,1,1,0,0,2,5
47,BIHAR,2003,Service (Private),0,10,9,2,0,21,0,3,3,0,0,6,27
48,BIHAR,2003,Public Sector Undertaking,0,0,2,1,0,3,0,0,0,0,0,0,3
49,BIHAR,2003,Student,15,26,0,0,0,41,9,9,0,0,0,18,59
50,BIHAR,2003,Unemployed,12,20,27,3,0,62,1,5,5,2,0,13,75
51,BIHAR,2003,Self-employed (Business activity),0,7,2,9,1,19,0,2,0,0,0,2,21
52,BIHAR,2003,Professional Activity,1,8,7,3,0,19,0,1,5,0,0,6,25
53,BIHAR,2003,Farming/Agriculture Activity,5,11,15,12,2,45,0,0,1,0,0,1,46
54,BIHAR,2003,Others (Please Specify),9,21,17,1,0,48,1,10,7,4,0,22,70
55,BIHAR,2003,Retired Person,0,0,0,1,5,6,0,0,0,0,0,0,6
56,BIHAR,2003,Others (Please Specify),7,32,23,18,4,84,4,21,7,4,4,40,124
57,BIHAR,2003,Total,49,135,104,51,12,351,15,127,90,12,4,248,599
58,BIHAR,2003,Total Salaried,0,10,13,4,0,27,0,4,4,0,0,8,35
59,BIHAR,2003,Total Self-employed,15,47,41,25,3,131,1,13,13,4,0,31,162
60,CHHATTISGARH,2003,House Wife,0,0,0,0,0,0,3,248,187,80,33,551,551
61,CHHATTISGARH,2003,Service (Government),0,10,27,17,0,54,0,1,2,0,0,3,57
62,CHHATTISGARH,2003,Service (Private),0,36,39,27,3,105,0,7,5,3,0,15,120
63,CHHATTISGARH,2003,Public Sector Undertaking,0,6,14,6,0,26,0,0,0,0,0,0,26
64,CHHATTISGARH,2003,Student,31,88,6,0,0,125,19,61,0,0,0,80,205
65,CHHATTISGARH,2003,Unemployed,7,85,56,12,0,160,1,12,7,4,0,24,184
66,CHHATTISGARH,2003,Self-employed (Business activity),0,15,21,12,4,52,0,4,1,0,0,5,57
67,CHHATTISGARH,2003,Professional Activity,1,32,43,19,2,97,0,13,14,3,1,31,128
68,CHHATTISGARH,2003,Farming/Agriculture Activity,11,230,309,220,89,859,28,104,55,17,3,207,1066
69,CHHATTISGARH,2003,Others (Please Specify),29,143,145,123,46,486,13,57,35,24,10,139,625
70,CHHATTISGARH,2003,Retired Person,0,0,1,1,2,4,0,0,0,0,0,0,4
71,CHHATTISGARH,2003,Others (Please Specify),24,201,217,117,65,624,42,115,67,30,18,272,896
72,CHHATTISGARH,2003,Total,103,846,878,554,211,2592,106,622,373,161,65,1327,3919
73,CHHATTISGARH,2003,Total Salaried,0,52,80,50,3,185,0,8,7,3,0,18,203
74,CHHATTISGARH,2003,Total Self-employed,41,420,518,374,141,1494,41,178,105,44,14,382,1876
75,GOA,2003,House Wife,0,0,0,0,0,0,0,27,12,8,2,49,49
76,GOA,2003,Service (Government),0,0,6,1,0,7,0,0,1,0,0,1,8
77,GOA,2003,Service (Private),0,15,32,15,0,62,0,7,2,1,0,10,72
78,GOA,2003,Public Sector Undertaking,0,0,1,0,0,1,0,0,0,0,0,0,1
79,GOA,2003,Student,0,11,1,0,0,12,3,4,0,0,0,7,19
80,GOA,2003,Unemployed,0,17,26,2,2,47,0,10,1,0,0,11,58
81,GOA,2003,Self-employed (Business activity),0,6,7,3,0,16,0,0,1,1,0,2,18
82,GOA,2003,Professional Activity,0,1,1,0,0,2,0,0,1,0,0,1,3
83,GOA,2003,Farming/Agriculture Activity,0,1,3,9,4,17,0,0,0,1,0,1,18
84,GOA,2003,Others (Please Specify),0,1,8,7,1,17,0,0,0,0,1,1,18
85,GOA,2003,Retired Person,0,0,0,0,0,0,0,0,0,0,0,0,0
86,GOA,2003,Others (Please Specify),0,9,11,5,7,32,1,3,0,0,0,4,36
87,GOA,2003,Total,0,61,96,42,14,213,4,51,18,11,3,87,300
88,GOA,2003,Total Salaried,0,15,39,16,0,70,0,7,3,1,0,11,81
89,GOA,2003,Total Self-employed,0,9,19,19,5,52,0,0,2,2,1,5,57
90,GUJARAT,2003,House Wife,0,0,0,0,0,0,1,608,466,202,97,1374,1374
91,GUJARAT,2003,Service (Government),0,21,33,15,2,71,0,1,4,0,0,5,76
92,GUJARAT,2003,Service (Private),0,120,144,56,6,326,0,34,18,3,0,55,381
93,GUJARAT,2003,Public Sector Undertaking,0,8,18,11,0,37,0,7,3,0,0,10,47
94,GUJARAT,2003,Student,12,77,2,0,0,91,21,73,1,1,0,96,187
95,GUJARAT,2003,Unemployed,0,176,153,64,12,405,3,30,16,6,1,56,461
96,GUJARAT,2003,Self-employed (Business activity),0,59,98,50,18,225,0,3,0,0,0,3,228
97,GUJARAT,2003,Professional Activity,0,143,135,81,17,376,0,8,1,0,5,14,390
98,GUJARAT,2003,Farming/Agriculture Activity,0,149,169,121,30,469,0,46,33,24,9,112,581
99,GUJARAT,2003,Others (Please Specify),2,113,172,72,10,369,11,37,16,7,7,78,447
100,GUJARAT,2003,Retired Person,0,5,6,17,57,85,0,2,3,4,29,38,123
101,GUJARAT,2003,Others (Please Specify),8,60,66,36,26,196,7,24,20,13,11,75,271
102,GUJARAT,2003,Total,22,931,996,523,178,2650,43,873,581,260,159,1916,4566
103,GUJARAT,2003,Total Salaried,0,149,195,82,8,434,0,42,25,3,0,70,504
104,GUJARAT,2003,Total Self-employed,2,464,574,324,75,1439,11,94,50,31,21,207,1646
105,HARYANA,2003,House Wife,0,0,0,0,0,0,0,173,107,29,12,321,321
106,HARYANA,2003,Service (Government),0,20,28,20,0,68,0,5,4,1,0,10,78
107,HARYANA,2003,Service (Private),6,68,90,25,1,190,0,26,8,2,0,36,226
108,HARYANA,2003,Public Sector Undertaking,0,17,33,4,0,54,0,10,6,1,0,17,71
109,HARYANA,2003,Student,5,69,12,0,0,86,10,28,1,0,0,39,125
110,HARYANA,2003,Unemployed,2,89,65,25,3,184,1,17,7,3,0,28,212
111,HARYANA,2003,Self-employed (Business activity),0,7,55,50,23,135,0,1,0,0,0,1,136
112,HARYANA,2003,Professional Activity,0,11,13,9,0,33,0,0,0,0,0,0,33
113,HARYANA,2003,Farming/Agriculture Activity,1,59,66,51,15,192,0,5,6,4,0,15,207
114,HARYANA,2003,Others (Please Specify),4,120,25,26,12,187,6,24,25,13,5,73,260
115,HARYANA,2003,Retired Person,0,0,0,10,13,23,0,0,0,4,3,7,30
116,HARYANA,2003,Others (Please Specify),16,116,215,78,36,461,8,25,21,9,4,67,528
117,HARYANA,2003,Total,34,576,602,298,103,1613,25,314,185,66,24,614,2227
118,HARYANA,2003,Total Salaried,6,105,151,49,1,312,0,41,18,4,0,63,375
119,HARYANA,2003,Total Self-employed,5,197,159,136,50,547,6,30,31,17,5,89,636
120,HIMACHAL PRADESH,2003,House Wife,0,0,0,0,0,0,0,37,25,10,0,72,72
121,HIMACHAL PRADESH,2003,Service (Government),0,1,8,5,0,14,0,0,1,1,0,2,16
122,HIMACHAL PRADESH,2003,Service (Private),0,8,12,9,1,30,0,1,1,0,0,2,32
123,HIMACHAL PRADESH,2003,Public Sector Undertaking,0,0,2,0,0,2,0,0,0,0,0,0,2
124,HIMACHAL PRADESH,2003,Student,2,9,0,0,0,11,4,15,0,0,0,19,30
125,HIMACHAL PRADESH,2003,Unemployed,0,24,15,0,2,41,0,1,0,0,0,1,42
126,HIMACHAL PRADESH,2003,Self-employed (Business activity),0,0,5,6,2,13,0,0,0,0,0,0,13
127,HIMACHAL PRADESH,2003,Professional Activity,0,1,0,0,1,2,0,0,0,0,0,0,2
128,HIMACHAL PRADESH,2003,Farming/Agriculture Activity,0,5,13,10,1,29,0,2,3,0,0,5,34
129,HIMACHAL PRADESH,2003,Others (Please Specify),0,7,14,17,4,42,1,3,1,1,0,6,48
130,HIMACHAL PRADESH,2003,Retired Person,0,0,0,0,1,1,0,0,0,0,0,0,1
131,HIMACHAL PRADESH,2003,Others (Please Specify),0,23,12,16,4,55,0,13,15,9,2,39,94
132,HIMACHAL PRADESH,2003,Total,2,78,81,63,16,240,5,72,46,21,2,146,386
133,HIMACHAL PRADESH,2003,Total Salaried,0,9,22,14,1,46,0,1,2,1,0,4,50
134,HIMACHAL PRADESH,2003,Total Self-employed,0,13,32,33,8,86,1,5,4,1,0,11,97
135,JAMMU & KASHMIR,2003,House Wife,0,0,0,0,0,0,1,26,12,0,2,41,41
136,JAMMU & KASHMIR,2003,Service (Government),0,2,3,0,0,5,0,0,0,0,0,0,5
137,JAMMU & KASHMIR,2003,Service (Private),0,0,0,0,0,0,0,0,0,0,0,0,0
138,JAMMU & KASHMIR,2003,Public Sector Undertaking,0,0,0,0,0,0,0,0,0,0,0,0,0
139,JAMMU & KASHMIR,2003,Student,0,2,0,0,0,2,0,2,0,0,0,2,4
140,JAMMU & KASHMIR,2003,Unemployed,0,3,1,0,0,4,0,0,0,0,0,0,4
141,JAMMU & KASHMIR,2003,Self-employed (Business activity),0,0,0,0,0,0,0,0,0,0,0,0,0
142,JAMMU & KASHMIR,2003,Professional Activity,0,0,0,0,0,0,0,0,0,0,0,0,0
143,JAMMU & KASHMIR,2003,Farming/Agriculture Activity,0,4,0,1,0,5,1,0,2,0,0,3,8
144,JAMMU & KASHMIR,2003,Others (Please Specify),0,2,2,1,0,5,0,2,0,0,0,2,7
145,JAMMU & KASHMIR,2003,Retired Person,0,0,0,0,0,0,0,0,0,0,0,0,0
146,JAMMU & KASHMIR,2003,Others (Please Specify),1,17,13,7,4,42,3,13,7,3,1,27,69
147,JAMMU & KASHMIR,2003,Total,1,30,19,9,4,63,5,43,21,3,3,75,138
148,JAMMU & KASHMIR,2003,Total Salaried,0,2,3,0,0,5,0,0,0,0,0,0,5
149,JAMMU & KASHMIR,2003,Total Self-employed,0,6,2,2,0,10,1,2,2,0,0,5,15
150,JHARKHAND,2003,House Wife,0,0,0,0,0,0,0,28,25,10,0,63,63
151,JHARKHAND,2003,Service (Government),0,0,0,0,0,0,0,0,0,0,0,0,0
152,JHARKHAND,2003,Service (Private),0,0,4,1,0,5,0,0,3,0,0,3,8
153,JHARKHAND,2003,Public Sector Undertaking,0,0,2,1,0,3,0,0,2,1,0,3,6
154,JHARKHAND,2003,Student,3,4,0,0,0,7,0,3,0,0,0,3,10
155,JHARKHAND,2003,Unemployed,0,8,8,11,0,27,0,1,1,0,0,2,29
156,JHARKHAND,2003,Self-employed (Business activity),0,0,2,1,0,3,0,0,1,0,0,1,4
157,JHARKHAND,2003,Professional Activity,0,4,1,2,2,9,0,0,0,0,0,0,9
158,JHARKHAND,2003,Farming/Agriculture Activity,0,4,14,3,0,21,0,0,0,0,0,0,21
159,JHARKHAND,2003,Others (Please Specify),0,18,10,6,0,34,0,10,0,2,0,12,46
160,JHARKHAND,2003,Retired Person,0,2,0,0,0,2,0,0,0,0,0,0,2
161,JHARKHAND,2003,Others (Please Specify),6,5,11,11,9,42,4,5,8,15,0,32,74
162,JHARKHAND,2003,Total,9,45,52,36,11,153,4,47,40,28,0,119,272
163,JHARKHAND,2003,Total Salaried,0,0,6,2,0,8,0,0,5,1,0,6,14
164,JHARKHAND,2003,Total Self-employed,0,26,27,12,2,67,0,10,1,2,0,13,80
165,KARNATAKA,2003,House Wife,0,0,0,0,0,0,6,703,658,309,188,1864,1864
166,KARNATAKA,2003,Service (Government),0,40,75,81,2,198,0,14,11,0,0,25,223
167,KARNATAKA,2003,Service (Private),5,194,266,161,62,688,0,71,51,34,8,164,852
168,KARNATAKA,2003,Public Sector Undertaking,0,57,91,56,8,212,2,17,6,8,1,34,246
169,KARNATAKA,2003,Student,54,154,16,2,1,227,62,127,4,2,0,195,422
170,KARNATAKA,2003,Unemployed,12,235,207,132,64,650,3,63,26,8,7,107,757
171,KARNATAKA,2003,Self-employed (Business activity),10,127,212,150,45,544,6,5,4,3,2,20,564
172,KARNATAKA,2003,Professional Activity,0,44,60,26,6,136,0,2,4,2,0,8,144
173,KARNATAKA,2003,Farming/Agriculture Activity,8,593,809,642,274,2326,21,119,107,85,20,352,2678
174,KARNATAKA,2003,Others (Please Specify),20,625,775,475,216,2111,28,258,208,90,46,630,2741
175,KARNATAKA,2003,Retired Person,0,0,0,9,37,46,0,0,0,0,6,6,52
176,KARNATAKA,2003,Others (Please Specify),33,357,384,268,195,1237,26,252,202,70,31,581,1818
177,KARNATAKA,2003,Total,142,2426,2895,2002,910,8375,154,1631,1281,611,309,3986,12361
178,KARNATAKA,2003,Total Salaried,5,291,432,298,72,1098,2,102,68,42,9,223,1321
179,KARNATAKA,2003,Total Self-employed,38,1389,1856,1293,541,5117,55,384,323,180,68,1010,6127
180,KERALA,2003,House Wife,0,0,0,0,0,0,0,294,467,373,297,1431,1431
181,KERALA,2003,Service (Government),0,4,35,47,0,86,0,7,5,7,0,19,105
182,KERALA,2003,Service (Private),0,54,142,105,24,325,0,16,17,5,3,41,366
183,KERALA,2003,Public Sector Undertaking,0,8,22,32,1,63,0,8,0,4,0,12,75
184,KERALA,2003,Student,43,109,8,0,0,160,33,109,12,0,0,154,314
185,KERALA,2003,Unemployed,0,249,195,207,232,883,1,118,28,24,45,216,1099
186,KERALA,2003,Self-employed (Business activity),0,51,133,141,64,389,0,4,3,0,0,7,396
187,KERALA,2003,Professional Activity,0,26,65,46,12,149,0,3,2,1,0,6,155
188,KERALA,2003,Farming/Agriculture Activity,0,141,407,600,372,1520,0,18,15,17,13,63,1583
189,KERALA,2003,Others (Please Specify),3,390,723,721,469,2306,4,156,78,101,78,417,2723
190,KERALA,2003,Retired Person,0,0,3,29,44,76,0,0,0,4,3,7,83
191,KERALA,2003,Others (Please Specify),4,168,299,288,219,978,11,41,20,8,50,130,1108
192,KERALA,2003,Total,50,1200,2032,2216,1437,6935,49,774,647,544,489,2503,9438
193,KERALA,2003,Total Salaried,0,66,199,184,25,474,0,31,22,16,3,72,546
194,KERALA,2003,Total Self-employed,3,608,1328,1508,917,4364,4,181,98,119,91,493,4857
195,MADHYA PRADESH,2003,House Wife,0,0,0,0,0,0,1,1185,576,188,79,2029,2029
196,MADHYA PRADESH,2003,Service (Government),0,88,88,27,1,204,1,34,22,5,0,62,266
197,MADHYA PRADESH,2003,Service (Private),0,148,125,43,9,325,0,51,21,2,0,74,399
198,MADHYA PRADESH,2003,Public Sector Undertaking,0,60,57,15,3,135,1,15,2,5,0,23,158
199,MADHYA PRADESH,2003,Student,46,136,2,0,0,184,40,98,0,0,0,138,322
200,MADHYA PRADESH,2003,Unemployed,0,119,68,19,13,219,0,5,7,0,0,12,231
201,MADHYA PRADESH,2003,Self-employed (Business activity),0,86,81,43,33,243,0,17,15,8,10,50,293
202,MADHYA PRADESH,2003,Professional Activity,0,52,68,46,23,189,0,5,8,4,5,22,211
203,MADHYA PRADESH,2003,Farming/Agriculture Activity,4,402,431,177,89,1103,6,183,115,29,9,342,1445
204,MADHYA PRADESH,2003,Others (Please Specify),27,175,201,108,53,564,26,268,82,27,19,422,986
205,MADHYA PRADESH,2003,Retired Person,0,0,0,0,23,23,0,0,0,0,0,0,23
206,MADHYA PRADESH,2003,Others (Please Specify),17,113,93,88,38,349,14,18,12,3,3,50,399
207,MADHYA PRADESH,2003,Total,94,1379,1214,566,285,3538,89,1879,860,271,125,3224,6762
208,MADHYA PRADESH,2003,Total Salaried,0,296,270,85,13,664,2,100,45,12,0,159,823
209,MADHYA PRADESH,2003,Total Self-employed,31,715,781,374,198,2099,32,473,220,68,43,836,2935
210,MAHARASHTRA,2003,House Wife,0,0,0,0,0,0,0,1701,1206,410,205,3522,3522
211,MAHARASHTRA,2003,Service (Government),0,43,126,77,0,246,0,14,13,3,0,30,276
212,MAHARASHTRA,2003,Service (Private),0,419,683,297,33,1432,0,86,72,13,0,171,1603
213,MAHARASHTRA,2003,Public Sector Undertaking,0,24,58,36,0,118,0,9,5,3,0,17,135
214,MAHARASHTRA,2003,Student,81,408,10,0,0,499,81,290,4,0,0,375,874
215,MAHARASHTRA,2003,Unemployed,1,414,350,105,17,887,1,42,25,13,0,81,968
216,MAHARASHTRA,2003,Self-employed (Business activity),0,152,223,122,22,519,0,11,11,4,0,26,545
217,MAHARASHTRA,2003,Professional Activity,0,74,116,62,18,270,0,10,4,1,1,16,286
218,MAHARASHTRA,2003,Farming/Agriculture Activity,8,899,1310,812,352,3381,4,202,148,73,28,455,3836
219,MAHARASHTRA,2003,Others (Please Specify),9,592,831,546,228,2206,6,117,62,37,17,239,2445
220,MAHARASHTRA,2003,Retired Person,0,0,1,33,110,144,0,0,0,0,6,6,150
221,MAHARASHTRA,2003,Others (Please Specify),0,41,39,16,12,108,0,4,2,4,2,12,120
222,MAHARASHTRA,2003,Total,99,3066,3747,2106,792,9810,92,2486,1552,561,259,4950,14760
223,MAHARASHTRA,2003,Total Salaried,0,486,867,410,33,1796,0,109,90,19,0,218,2014
224,MAHARASHTRA,2003,Total Self-employed,17,1717,2480,1542,620,6376,10,340,225,115,46,736,7112
225,MANIPUR,2003,House Wife,0,0,0,0,0,0,0,1,0,0,1,2,2
226,MANIPUR,2003,Service (Government),0,0,2,2,0,4,0,0,0,0,0,0,4
227,MANIPUR,2003,Service (Private),0,0,0,0,0,0,0,0,0,0,0,0,0
228,MANIPUR,2003,Public Sector Undertaking,0,0,0,0,0,0,0,0,0,0,0,0,0
229,MANIPUR,2003,Student,0,9,0,0,0,9,0,3,0,0,0,3,12
230,MANIPUR,2003,Unemployed,0,0,0,0,0,0,0,0,0,0,0,0,0
231,MANIPUR,2003,Self-employed (Business activity),0,0,4,0,0,4,0,0,0,0,0,0,4
232,MANIPUR,2003,Professional Activity,0,0,0,0,0,0,0,0,0,0,0,0,0
233,MANIPUR,2003,Farming/Agriculture Activity,0,0,0,1,3,4,0,0,0,0,0,0,4
234,MANIPUR,2003,Others (Please Specify),0,0,0,0,0,0,0,0,0,0,0,0,0
235,MANIPUR,2003,Retired Person,0,0,0,0,0,0,0,0,0,0,0,0,0
236,MANIPUR,2003,Others (Please Specify),0,0,0,0,0,0,0,0,0,0,0,0,0
237,MANIPUR,2003,Total,0,9,6,3,3,21,0,4,0,0,1,5,26
238,MANIPUR,2003,Total Salaried,0,0,2,2,0,4,0,0,0,0,0,0,4
239,MANIPUR,2003,Total Self-employed,0,0,4,1,3,8,0,0,0,0,0,0,8
240,MEGHALAYA,2003,House Wife,0,0,0,0,0,0,0,0,0,0,1,1,1
241,MEGHALAYA,2003,Service (Government),0,1,2,1,0,4,0,0,0,0,0,0,4
242,MEGHALAYA,2003,Service (Private),0,2,3,1,0,6,0,0,0,0,0,0,6
243,MEGHALAYA,2003,Public Sector Undertaking,0,0,0,0,0,0,0,0,0,0,0,0,0
244,MEGHALAYA,2003,Student,2,0,0,0,0,2,1,0,0,0,0,1,3
245,MEGHALAYA,2003,Unemployed,0,2,4,0,0,6,0,0,0,0,0,0,6
246,MEGHALAYA,2003,Self-employed (Business activity),0,0,0,0,0,0,0,1,0,0,0,1,1
247,MEGHALAYA,2003,Professional Activity,0,0,0,0,0,0,0,0,0,0,0,0,0
248,MEGHALAYA,2003,Farming/Agriculture Activity,0,0,0,3,1,4,0,0,0,0,0,0,4
249,MEGHALAYA,2003,Others (Please Specify),1,2,5,2,0,10,0,4,2,0,0,6,16
250,MEGHALAYA,2003,Retired Person,0,0,0,0,0,0,0,0,0,0,0,0,0
251,MEGHALAYA,2003,Others (Please Specify),0,0,0,0,0,0,0,0,0,0,0,0,0
252,MEGHALAYA,2003,Total,3,7,14,7,1,32,1,5,2,0,1,9,41
253,MEGHALAYA,2003,Total Salaried,0,3,5,2,0,10,0,0,0,0,0,0,10
254,MEGHALAYA,2003,Total Self-employed,1,2,5,5,1,14,0,5,2,0,0,7,21
255,MIZORAM,2003,House Wife,0,0,0,0,0,0,0,0,0,0,0,0,0
256,MIZORAM,2003,Service (Government),0,1,2,1,0,4,0,0,0,0,0,0,4
257,MIZORAM,2003,Service (Private),0,4,1,0,0,5,0,0,0,0,0,0,5
258,MIZORAM,2003,Public Sector Undertaking,0,0,0,0,0,0,0,0,0,0,0,0,0
259,MIZORAM,2003,Student,0,1,0,0,0,1,0,0,0,0,0,0,1
260,MIZORAM,2003,Unemployed,0,4,5,0,0,9,0,0,0,0,0,0,9
261,MIZORAM,2003,Self-employed (Business activity),0,1,0,2,0,3,0,0,0,0,0,0,3
262,MIZORAM,2003,Professional Activity,0,0,0,0,0,0,0,0,0,0,0,0,0
263,MIZORAM,2003,Farming/Agriculture Activity,0,0,0,0,0,0,0,0,0,0,0,0,0
264,MIZORAM,2003,Others (Please Specify),1,5,7,2,0,15,0,2,7,1,0,10,25
265,MIZORAM,2003,Retired Person,0,0,0,0,0,0,0,0,0,0,0,0,0
266,MIZORAM,2003,Others (Please Specify),0,2,1,1,0,4,0,1,0,0,0,1,5
267,MIZORAM,2003,Total,1,18,16,6,0,41,0,3,7,1,0,11,52
268,MIZORAM,2003,Total Salaried,0,5,3,1,0,9,0,0,0,0,0,0,9
269,MIZORAM,2003,Total Self-employed,1,6,7,4,0,18,0,2,7,1,0,10,28
270,NAGALAND,2003,House Wife,0,0,0,0,0,0,0,4,0,0,0,4,4
271,NAGALAND,2003,Service (Government),0,0,7,0,0,7,0,0,0,0,0,0,7
272,NAGALAND,2003,Service (Private),0,0,0,0,0,0,0,0,0,0,0,0,0
273,NAGALAND,2003,Public Sector Undertaking,0,0,0,0,0,0,0,0,0,0,0,0,0
274,NAGALAND,2003,Student,0,1,0,0,0,1,0,1,0,0,0,1,2
275,NAGALAND,2003,Unemployed,0,3,1,0,0,4,0,0,0,0,0,0,4
276,NAGALAND,2003,Self-employed (Business activity),0,0,1,0,0,1,0,0,0,0,0,0,1
277,NAGALAND,2003,Professional Activity,0,0,0,0,0,0,0,0,0,0,0,0,0
278,NAGALAND,2003,Farming/Agriculture Activity,0,0,0,0,0,0,0,0,0,0,0,0,0
279,NAGALAND,2003,Others (Please Specify),0,1,0,0,0,1,0,0,0,0,0,0,1
280,NAGALAND,2003,Retired Person,0,0,0,0,0,0,0,0,0,0,0,0,0
281,NAGALAND,2003,Others (Please Specify),0,1,2,0,0,3,0,0,0,0,0,0,3
282,NAGALAND,2003,Total,0,6,11,0,0,17,0,5,0,0,0,5,22
283,NAGALAND,2003,Total Salaried,0,0,7,0,0,7,0,0,0,0,0,0,7
284,NAGALAND,2003,Total Self-employed,0,1,1,0,0,2,0,0,0,0,0,0,2
285,ODISHA,2003,House Wife,0,0,0,0,0,0,0,306,205,110,26,647,647
286,ODISHA,2003,Service (Government),1,20,17,24,0,62,0,43,36,12,0,91,153
287,ODISHA,2003,Service (Private),5,149,102,107,14,377,0,30,30,21,3,84,461
288,ODISHA,2003,Public Sector Undertaking,0,21,29,56,0,106,0,10,4,0,0,14,120
289,ODISHA,2003,Student,16,101,17,13,0,147,22,86,3,1,0,112,259
290,ODISHA,2003,Unemployed,0,145,116,33,3,297,2,75,47,8,0,132,429
291,ODISHA,2003,Self-employed (Business activity),0,65,69,48,2,184,1,15,8,6,0,30,214
292,ODISHA,2003,Professional Activity,0,26,17,12,0,55,0,6,9,7,0,22,77
293,ODISHA,2003,Farming/Agriculture Activity,1,101,136,69,17,324,0,21,10,10,0,41,365
294,ODISHA,2003,Others (Please Specify),16,204,270,214,70,774,6,128,76,62,27,299,1073
295,ODISHA,2003,Retired Person,0,3,1,0,37,41,0,0,4,4,1,9,50
296,ODISHA,2003,Others (Please Specify),28,91,135,85,34,373,15,82,51,40,11,199,572
297,ODISHA,2003,Total,67,926,909,661,177,2740,46,802,483,281,68,1680,4420
298,ODISHA,2003,Total Salaried,6,190,148,187,14,545,0,83,70,33,3,189,734
299,ODISHA,2003,Total Self-employed,17,396,492,343,89,1337,7,170,103,85,27,392,1729
300,PUNJAB,2003,House Wife,0,0,0,0,0,0,0,33,34,5,2,74,74
301,PUNJAB,2003,Service (Government),0,3,4,3,0,10,0,0,1,1,0,2,12
302,PUNJAB,2003,Service (Private),0,16,13,2,3,34,0,2,2,0,1,5,39
303,PUNJAB,2003,Public Sector Undertaking,0,0,2,0,0,2,0,0,0,0,0,0,2
304,PUNJAB,2003,Student,0,13,1,0,0,14,3,6,0,0,0,9,23
305,PUNJAB,2003,Unemployed,0,26,17,11,1,55,1,1,1,0,0,3,58
306,PUNJAB,2003,Self-employed (Business activity),0,19,13,13,1,46,0,1,0,0,0,1,47
307,PUNJAB,2003,Professional Activity,0,1,1,0,0,2,0,0,0,0,0,0,2
308,PUNJAB,2003,Farming/Agriculture Activity,0,11,8,6,0,25,0,0,0,1,0,1,26
309,PUNJAB,2003,Others (Please Specify),2,39,43,31,4,119,0,2,2,0,0,4,123
310,PUNJAB,2003,Retired Person,0,0,0,1,6,7,0,0,0,0,0,0,7
311,PUNJAB,2003,Others (Please Specify),1,86,54,25,26,192,1,11,10,3,1,26,218
312,PUNJAB,2003,Total,3,214,156,92,41,506,5,56,50,10,4,125,631
313,PUNJAB,2003,Total Salaried,0,19,19,5,3,46,0,2,3,1,1,7,53
314,PUNJAB,2003,Total Self-employed,2,70,65,50,5,192,0,3,2,1,0,6,198
315,RAJASTHAN,2003,House Wife,0,0,0,0,0,0,2,417,336,137,46,938,938
316,RAJASTHAN,2003,Service (Government),0,3,25,14,0,42,0,2,1,0,0,3,45
317,RAJASTHAN,2003,Service (Private),0,63,124,61,10,258,0,14,11,2,0,27,285
318,RAJASTHAN,2003,Public Sector Undertaking,0,22,35,16,0,73,0,11,6,1,0,18,91
319,RAJASTHAN,2003,Student,24,110,4,0,0,138,13,51,3,0,0,67,205
320,RAJASTHAN,2003,Unemployed,0,70,66,22,0,158,0,3,0,0,0,3,161
321,RAJASTHAN,2003,Self-employed (Business activity),0,33,72,30,5,140,0,0,0,0,0,0,140
322,RAJASTHAN,2003,Professional Activity,0,12,22,10,2,46,0,0,0,0,0,0,46
323,RAJASTHAN,2003,Farming/Agriculture Activity,0,195,218,111,38,562,0,34,27,12,1,74,636
324,RAJASTHAN,2003,Others (Please Specify),11,185,190,123,90,599,8,41,16,5,3,73,672
325,RAJASTHAN,2003,Retired Person,0,0,0,10,8,18,0,0,0,0,0,0,18
326,RAJASTHAN,2003,Others (Please Specify),31,131,123,53,17,355,13,28,10,11,7,69,424
327,RAJASTHAN,2003,Total,66,824,879,450,170,2389,36,601,410,168,57,1272,3661
328,RAJASTHAN,2003,Total Salaried,0,88,184,91,10,373,0,27,18,3,0,48,421
329,RAJASTHAN,2003,Total Self-employed,11,425,502,274,135,1347,8,75,43,17,4,147,1494
330,SIKKIM,2003,House Wife,0,0,0,0,0,0,0,7,5,4,5,21,21
331,SIKKIM,2003,Service (Government),0,0,3,2,1,6,0,0,3,0,0,3,9
332,SIKKIM,2003,Service (Private),0,4,2,4,3,13,0,0,0,0,0,0,13
333,SIKKIM,2003,Public Sector Undertaking,0,0,0,0,0,0,0,0,0,0,0,0,0
334,SIKKIM,2003,Student,1,7,0,0,1,9,0,1,0,0,0,1,10
335,SIKKIM,2003,Unemployed,0,6,5,0,1,12,0,1,0,0,0,1,13
336,SIKKIM,2003,Self-employed (Business activity),0,0,3,0,0,3,0,0,0,0,0,0,3
337,SIKKIM,2003,Professional Activity,0,0,0,0,0,0,0,0,0,0,0,0,0
338,SIKKIM,2003,Farming/Agriculture Activity,0,8,3,4,5,20,0,0,0,7,4,11,31
339,SIKKIM,2003,Others (Please Specify),0,0,0,4,1,5,0,0,0,0,0,0,5
340,SIKKIM,2003,Retired Person,0,0,0,0,0,0,0,0,0,0,0,0,0
341,SIKKIM,2003,Others (Please Specify),0,0,0,0,0,0,0,0,0,0,0,0,0
342,SIKKIM,2003,Total,1,25,16,14,12,68,0,9,8,11,9,37,105
343,SIKKIM,2003,Total Salaried,0,4,5,6,4,19,0,0,3,0,0,3,22
344,SIKKIM,2003,Total Self-employed,0,8,6,8,6,28,0,0,0,7,4,11,39
345,TAMIL NADU,2003,House Wife,0,0,0,0,0,0,0,779,777,409,103,2068,2068
346,TAMIL NADU,2003,Service (Government),0,36,74,74,5,189,0,31,22,24,0,77,266
347,TAMIL NADU,2003,Service (Private),0,208,321,223,42,794,0,179,155,93,10,437,1231
348,TAMIL NADU,2003,Public Sector Undertaking,0,78,141,78,11,308,0,32,44,24,1,101,409
349,TAMIL NADU,2003,Student,60,170,17,0,0,247,79,136,4,0,0,219,466
350,TAMIL NADU,2003,Unemployed,11,490,524,298,145,1468,7,200,147,123,29,506,1974
351,TAMIL NADU,2003,Self-employed (Business activity),1,155,258,240,46,700,0,38,38,23,7,106,806
352,TAMIL NADU,2003,Professional Activity,0,127,159,95,36,417,0,20,23,33,3,79,496
353,TAMIL NADU,2003,Farming/Agriculture Activity,1,244,300,200,87,832,5,101,71,27,16,220,1052
354,TAMIL NADU,2003,Others (Please Specify),24,325,461,415,157,1382,25,110,118,74,50,377,1759
355,TAMIL NADU,2003,Retired Person,0,0,0,15,52,67,0,0,0,4,13,17,84
356,TAMIL NADU,2003,Others (Please Specify),40,132,263,203,112,750,50,118,178,92,73,511,1261
357,TAMIL NADU,2003,Total,137,1965,2518,1841,693,7154,166,1744,1577,926,305,4718,11872
358,TAMIL NADU,2003,Total Salaried,0,322,536,375,58,1291,0,242,221,141,11,615,1906
359,TAMIL NADU,2003,Total Self-employed,26,851,1178,950,326,3331,30,269,250,157,76,782,4113
360,TRIPURA,2003,House Wife,0,0,0,0,0,0,0,52,51,17,0,120,120
361,TRIPURA,2003,Service (Government),0,12,4,3,0,19,0,3,3,3,0,9,28
362,TRIPURA,2003,Service (Private),0,14,6,3,0,23,0,2,2,0,0,4,27
363,TRIPURA,2003,Public Sector Undertaking,0,17,11,7,0,35,0,4,4,2,0,10,45
364,TRIPURA,2003,Student,7,59,70,21,0,157,2,29,31,11,0,73,230
365,TRIPURA,2003,Unemployed,0,74,85,49,0,208,3,35,40,24,0,102,310
366,TRIPURA,2003,Self-employed (Business activity),0,4,2,1,0,7,0,4,3,2,0,9,16
367,TRIPURA,2003,Professional Activity,0,0,0,1,0,1,0,3,2,1,0,6,7
368,TRIPURA,2003,Farming/Agriculture Activity,0,0,0,0,0,0,0,2,1,1,0,4,4
369,TRIPURA,2003,Others (Please Specify),0,11,7,4,0,22,0,4,4,0,0,8,30
370,TRIPURA,2003,Retired Person,0,0,0,0,4,4,0,0,0,0,4,4,8
371,TRIPURA,2003,Others (Please Specify),0,7,3,2,0,12,3,2,1,1,0,7,19
372,TRIPURA,2003,Total,7,198,188,91,4,488,8,140,142,62,4,356,844
373,TRIPURA,2003,Total Salaried,0,43,21,13,0,77,0,9,9,5,0,23,100
374,TRIPURA,2003,Total Self-employed,0,15,9,6,0,30,0,13,10,4,0,27,57
375,UTTAR PRADESH,2003,House Wife,0,0,0,0,0,0,2,548,310,159,54,1073,1073
376,UTTAR PRADESH,2003,Service (Government),0,19,15,9,0,43,0,6,10,1,0,17,60
377,UTTAR PRADESH,2003,Service (Private),4,23,93,46,7,173,0,36,26,11,2,75,248
378,UTTAR PRADESH,2003,Public Sector Undertaking,1,9,28,12,7,57,0,4,1,0,0,5,62
379,UTTAR PRADESH,2003,Student,24,93,0,1,0,118,27,64,7,0,0,98,216
380,UTTAR PRADESH,2003,Unemployed,3,195,141,42,11,392,3,35,16,7,1,62,454
381,UTTAR PRADESH,2003,Self-employed (Business activity),0,48,57,31,8,144,0,5,4,8,2,19,163
382,UTTAR PRADESH,2003,Professional Activity,1,34,44,18,9,106,0,7,3,1,0,11,117
383,UTTAR PRADESH,2003,Farming/Agriculture Activity,0,129,132,56,24,341,0,23,16,3,4,46,387
384,UTTAR PRADESH,2003,Others (Please Specify),24,94,96,80,44,338,17,44,28,31,26,146,484
385,UTTAR PRADESH,2003,Retired Person,0,0,5,10,14,29,0,7,0,1,1,9,38
386,UTTAR PRADESH,2003,Others (Please Specify),25,119,11,58,33,246,25,73,9,1,7,115,361
387,UTTAR PRADESH,2003,Total,82,763,622,363,157,1987,74,852,430,223,97,1676,3663
388,UTTAR PRADESH,2003,Total Salaried,5,51,136,67,14,273,0,46,37,12,2,97,370
389,UTTAR PRADESH,2003,Total Self-employed,25,305,329,185,85,929,17,79,51,43,32,222,1151
390,UTTARAKHAND,2003,House Wife,0,0,0,0,0,0,0,49,21,10,1,81,81
391,UTTARAKHAND,2003,Service (Government),0,4,6,4,0,14,0,1,0,0,0,1,15
392,UTTARAKHAND,2003,Service (Private),0,19,29,12,0,60,0,12,3,0,0,15,75
393,UTTARAKHAND,2003,Public Sector Undertaking,0,1,1,0,0,2,0,0,4,1,0,5,7
394,UTTARAKHAND,2003,Student,0,9,0,0,0,9,1,7,0,0,0,8,17
395,UTTARAKHAND,2003,Unemployed,0,30,15,10,0,55,0,0,0,0,0,0,55
396,UTTARAKHAND,2003,Self-employed (Business activity),0,4,4,3,0,11,0,0,0,0,0,0,11
397,UTTARAKHAND,2003,Professional Activity,0,5,2,2,0,9,0,0,1,0,0,1,10
398,UTTARAKHAND,2003,Farming/Agriculture Activity,0,14,14,10,1,39,0,1,1,0,0,2,41
399,UTTARAKHAND,2003,Others (Please Specify),0,16,16,12,3,47,0,4,1,3,1,9,56
400,UTTARAKHAND,2003,Retired Person,0,0,0,1,0,1,0,0,0,0,0,0,1
401,UTTARAKHAND,2003,Others (Please Specify),0,9,4,1,1,15,2,3,1,0,1,7,22
402,UTTARAKHAND,2003,Total,0,111,91,55,5,262,3,77,32,14,3,129,391
403,UTTARAKHAND,2003,Total Salaried,0,24,36,16,0,76,0,13,7,1,0,21,97
404,UTTARAKHAND,2003,Total Self-employed,0,39,36,27,4,106,0,5,3,3,1,12,118
405,WEST BENGAL,2003,House Wife,0,0,0,0,0,0,0,1402,1414,980,287,4083,4083
406,WEST BENGAL,2003,Service (Government),0,74,76,52,0,202,0,7,12,9,0,28,230
407,WEST BENGAL,2003,Service (Private),0,221,290,226,0,737,0,26,47,22,0,95,832
408,WEST BENGAL,2003,Public Sector Undertaking,0,322,255,369,0,946,0,79,44,18,0,141,1087
409,WEST BENGAL,2003,Student,41,418,79,0,0,538,61,413,99,0,0,573,1111
410,WEST BENGAL,2003,Unemployed,0,392,356,9,0,757,0,87,64,0,0,151,908
411,WEST BENGAL,2003,Self-employed (Business activity),0,217,329,322,74,942,0,35,22,11,0,68,1010
412,WEST BENGAL,2003,Professional Activity,0,92,121,140,15,368,0,9,6,5,1,21,389
413,WEST BENGAL,2003,Farming/Agriculture Activity,0,201,394,260,65,920,0,51,48,16,1,116,1036
414,WEST BENGAL,2003,Others (Please Specify),2,255,274,226,111,868,4,80,123,103,53,363,1231
415,WEST BENGAL,2003,Retired Person,0,0,0,0,241,241,0,0,0,0,7,7,248
416,WEST BENGAL,2003,Others (Please Specify),18,204,444,166,73,905,33,93,16,27,41,210,1115
417,WEST BENGAL,2003,Total,61,2396,2618,1770,579,7424,98,2282,1895,1191,390,5856,13280
418,WEST BENGAL,2003,Total Salaried,0,617,621,647,0,1885,0,112,103,49,0,264,2149
419,WEST BENGAL,2003,Total Self-employed,2,765,1118,948,265,3098,4,175,199,135,55,568,3666
420,TOTAL (STATES),2003,House Wife,0,0,0,0,0,0,22,9849,7711,3767,1546,22895,22895
421,TOTAL (STATES),2003,Service (Government),1,481,768,567,22,1839,1,181,175,71,0,428,2267
422,TOTAL (STATES),2003,Service (Private),22,1914,2723,1562,228,6449,2,640,521,235,32,1430,7879
423,TOTAL (STATES),2003,Public Sector Undertaking,1,706,872,752,47,2378,3,242,157,80,5,487,2865
424,TOTAL (STATES),2003,Student,561,2425,288,37,2,3313,582,1839,171,15,0,2607,5920
425,TOTAL (STATES),2003,Unemployed,50,3142,2924,1222,508,7846,36,821,480,235,84,1656,9502
426,TOTAL (STATES),2003,Self-employed (Business activity),13,1204,1973,1557,397,5144,16,188,162,95,26,487,5631
427,TOTAL (STATES),2003,Professional Activity,5,805,1072,665,163,2710,1,93,101,60,16,271,2981
428,TOTAL (STATES),2003,Farming/Agriculture Activity,49,3779,5398,3782,1638,14646,71,1024,823,423,120,2461,17107
429,TOTAL (STATES),2003,Others (Please Specify),221,3947,4949,3576,1654,14347,202,1588,1001,658,385,3834,18181
430,TOTAL (STATES),2003,Retired Person,0,10,32,162,692,896,0,9,10,54,89,162,1058
431,TOTAL (STATES),2003,Others (Please Specify),329,2774,3190,2017,1027,9337,338,1236,857,455,313,3199,12536
432,TOTAL (STATES),2003,Total,1252,21187,24189,15899,6378,68905,1274,17710,12169,6148,2616,39917,108822
433,TOTAL (STATES),2003,Total Salaried,24,3101,4363,2881,297,10666,6,1063,853,386,37,2345,13011
434,TOTAL (STATES),2003,Total Self-employed,288,9735,13392,9580,3852,36847,290,2893,2087,1236,547,7053,43900
435,A & N ISLANDS,2003,House Wife,0,0,0,0,0,0,0,17,8,2,1,28,28
436,A & N ISLANDS,2003,Service (Government),0,0,7,6,1,14,0,1,0,0,0,1,15
437,A & N ISLANDS,2003,Service (Private),0,17,13,10,2,42,0,0,0,0,0,0,42
438,A & N ISLANDS,2003,Public Sector Undertaking,0,1,2,0,0,3,0,0,0,0,0,0,3
439,A & N ISLANDS,2003,Student,1,1,0,0,0,2,4,4,0,0,0,8,10
440,A & N ISLANDS,2003,Unemployed,0,3,1,0,2,6,0,6,0,0,0,6,12
441,A & N ISLANDS,2003,Self-employed (Business activity),0,0,0,0,0,0,0,0,0,0,0,0,0
442,A & N ISLANDS,2003,Professional Activity,0,0,0,0,0,0,0,0,0,0,0,0,0
443,A & N ISLANDS,2003,Farming/Agriculture Activity,0,1,0,0,0,1,0,0,0,0,0,0,1
444,A & N ISLANDS,2003,Others (Please Specify),0,0,0,0,0,0,0,0,0,0,0,0,0
445,A & N ISLANDS,2003,Retired Person,0,0,0,1,1,2,0,0,0,0,0,0,2
446,A & N ISLANDS,2003,Others (Please Specify),0,0,0,0,0,0,0,0,0,0,0,0,0
447,A & N ISLANDS,2003,Total,1,23,23,17,6,70,4,28,8,2,1,43,113
448,A & N ISLANDS,2003,Total Salaried,0,18,22,16,3,59,0,1,0,0,0,1,60
449,A & N ISLANDS,2003,Total Self-employed,0,1,0,0,0,1,0,0,0,0,0,0,1
450,CHANDIGARH,2003,House Wife,0,0,0,0,0,0,0,11,7,2,2,22,22
451,CHANDIGARH,2003,Service (Government),0,2,6,1,0,9,0,0,0,0,0,0,9
452,CHANDIGARH,2003,Service (Private),0,9,11,3,1,24,0,1,0,0,0,1,25
453,CHANDIGARH,2003,Public Sector Undertaking,0,0,0,0,0,0,0,0,0,0,0,0,0
454,CHANDIGARH,2003,Student,0,4,0,0,0,4,1,7,0,0,0,8,12
455,CHANDIGARH,2003,Unemployed,0,9,3,0,0,12,0,2,1,0,0,3,15
456,CHANDIGARH,2003,Self-employed (Business activity),0,0,0,0,0,0,0,0,0,0,0,0,0
457,CHANDIGARH,2003,Professional Activity,0,1,1,0,0,2,0,0,0,0,0,0,2
458,CHANDIGARH,2003,Farming/Agriculture Activity,0,1,0,1,0,2,0,0,0,0,0,0,2
459,CHANDIGARH,2003,Others (Please Specify),0,0,0,0,0,0,0,0,0,0,0,0,0
460,CHANDIGARH,2003,Retired Person,0,0,0,1,1,2,0,0,0,0,0,0,2
461,CHANDIGARH,2003,Others (Please Specify),0,4,6,2,1,13,0,1,0,0,0,1,14
462,CHANDIGARH,2003,Total,0,30,27,8,3,68,1,22,8,2,2,35,103
463,CHANDIGARH,2003,Total Salaried,0,11,17,4,1,33,0,1,0,0,0,1,34
464,CHANDIGARH,2003,Total Self-employed,0,2,1,1,0,4,0,0,0,0,0,0,4
465,D & N HAVELI,2003,House Wife,0,0,0,0,0,0,0,5,7,9,0,21,21
466,D & N HAVELI,2003,Service (Government),0,0,1,0,0,1,0,0,0,0,0,0,1
467,D & N HAVELI,2003,Service (Private),0,0,4,0,0,4,0,0,0,0,0,0,4
468,D & N HAVELI,2003,Public Sector Undertaking,0,0,0,0,0,0,0,0,0,0,0,0,0
469,D & N HAVELI,2003,Student,1,0,0,0,0,1,0,1,0,0,0,1,2
470,D & N HAVELI,2003,Unemployed,0,0,0,0,0,0,0,0,0,0,0,0,0
471,D & N HAVELI,2003,Self-employed (Business activity),0,0,0,0,0,0,0,0,0,0,0,0,0
472,D & N HAVELI,2003,Professional Activity,0,0,0,0,0,0,0,0,0,0,0,0,0
473,D & N HAVELI,2003,Farming/Agriculture Activity,0,8,3,7,5,23,0,0,0,0,0,0,23
474,D & N HAVELI,2003,Others (Please Specify),0,0,0,0,0,0,0,0,0,0,0,0,0
475,D & N HAVELI,2003,Retired Person,0,0,0,0,0,0,0,0,0,0,0,0,0
476,D & N HAVELI,2003,Others (Please Specify),1,0,0,0,0,1,0,0,0,0,0,0,1
477,D & N HAVELI,2003,Total,2,8,8,7,5,30,0,6,7,9,0,22,52
478,D & N HAVELI,2003,Total Salaried,0,0,5,0,0,5,0,0,0,0,0,0,5
479,D & N HAVELI,2003,Total Self-employed,0,8,3,7,5,23,0,0,0,0,0,0,23
480,DAMAN & DIU,2003,House Wife,0,0,0,0,0,0,0,2,2,1,0,5,5
481,DAMAN & DIU,2003,Service (Government),0,0,0,0,0,0,0,0,0,0,0,0,0
482,DAMAN & DIU,2003,Service (Private),0,1,3,0,0,4,0,0,0,0,0,0,4
483,DAMAN & DIU,2003,Public Sector Undertaking,0,0,0,0,0,0,0,0,0,0,0,0,0
484,DAMAN & DIU,2003,Student,0,0,0,0,0,0,0,0,0,0,0,0,0
485,DAMAN & DIU,2003,Unemployed,0,1,2,0,0,3,0,0,0,0,0,0,3
486,DAMAN & DIU,2003,Self-employed (Business activity),0,1,0,0,0,1,0,0,0,0,0,0,1
487,DAMAN & DIU,2003,Professional Activity,0,0,1,0,0,1,0,0,0,0,0,0,1
488,DAMAN & DIU,2003,Farming/Agriculture Activity,0,0,0,0,0,0,0,0,0,0,0,0,0
489,DAMAN & DIU,2003,Others (Please Specify),0,1,1,1,0,3,0,0,0,0,0,0,3
490,DAMAN & DIU,2003,Retired Person,0,0,0,0,0,0,0,0,0,0,0,0,0
491,DAMAN & DIU,2003,Others (Please Specify),1,3,1,1,0,6,0,1,0,0,0,1,7
492,DAMAN & DIU,2003,Total,1,7,8,2,0,18,0,3,2,1,0,6,24
493,DAMAN & DIU,2003,Total Salaried,0,1,3,0,0,4,0,0,0,0,0,0,4
494,DAMAN & DIU,2003,Total Self-employed,0,2,2,1,0,5,0,0,0,0,0,0,5
495,DELHI (UT),2003,House Wife,0,0,0,0,0,0,0,115,77,26,3,221,221
496,DELHI (UT),2003,Service (Government),0,7,8,3,0,18,0,8,2,3,0,13,31
497,DELHI (UT),2003,Service (Private),0,46,46,14,2,108,0,13,7,0,0,20,128
498,DELHI (UT),2003,Public Sector Undertaking,0,2,6,2,0,10,0,1,0,0,0,1,11
499,DELHI (UT),2003,Student,9,43,0,0,0,52,12,50,3,0,0,65,117
500,DELHI (UT),2003,Unemployed,1,119,99,19,15,253,2,19,10,10,0,41,294
501,DELHI (UT),2003,Self-employed (Business activity),0,5,15,4,1,25,0,0,0,0,0,0,25
502,DELHI (UT),2003,Professional Activity,0,4,2,1,0,7,0,0,0,0,0,0,7
503,DELHI (UT),2003,Farming/Agriculture Activity,0,4,2,2,0,8,0,0,0,0,0,0,8
504,DELHI (UT),2003,Others (Please Specify),2,40,56,28,4,130,1,19,7,0,0,27,157
505,DELHI (UT),2003,Retired Person,0,0,0,0,0,0,0,0,0,0,0,0,0
506,DELHI (UT),2003,Others (Please Specify),6,58,44,17,5,130,4,10,6,2,2,24,154
507,DELHI (UT),2003,Total,18,328,278,90,27,741,19,235,112,41,5,412,1153
508,DELHI (UT),2003,Total Salaried,0,55,60,19,2,136,0,22,9,3,0,34,170
509,DELHI (UT),2003,Total Self-employed,2,53,75,35,5,170,1,19,7,0,0,27,197
510,LAKSHADWEEP,2003,House Wife,0,0,0,0,0,0,0,1,0,0,0,1,1
511,LAKSHADWEEP,2003,Service (Government),0,0,0,0,0,0,0,0,0,0,0,0,0
512,LAKSHADWEEP,2003,Service (Private),0,0,0,0,0,0,0,0,0,0,0,0,0
513,LAKSHADWEEP,2003,Public Sector Undertaking,0,0,0,0,0,0,0,0,0,0,0,0,0
514,LAKSHADWEEP,2003,Student,0,0,0,0,0,0,0,0,0,0,0,0,0
515,LAKSHADWEEP,2003,Unemployed,0,0,0,0,0,0,0,0,0,0,0,0,0
516,LAKSHADWEEP,2003,Self-employed (Business activity),0,0,0,0,0,0,0,0,0,0,0,0,0
517,LAKSHADWEEP,2003,Professional Activity,0,0,0,0,0,0,0,0,0,0,0,0,0
518,LAKSHADWEEP,2003,Farming/Agriculture Activity,0,0,0,0,0,0,0,0,0,0,0,0,0
519,LAKSHADWEEP,2003,Others (Please Specify),0,0,0,0,0,0,0,0,0,0,0,0,0
520,LAKSHADWEEP,2003,Retired Person,0,0,0,0,0,0,0,0,0,0,0,0,0
521,LAKSHADWEEP,2003,Others (Please Specify),0,0,0,0,1,1,0,0,0,0,0,0,1
522,LAKSHADWEEP,2003,Total,0,0,0,0,1,1,0,1,0,0,0,1,2
523,LAKSHADWEEP,2003,Total Salaried,0,0,0,0,0,0,0,0,0,0,0,0,0
524,LAKSHADWEEP,2003,Total Self-employed,0,0,0,0,0,0,0,0,0,0,0,0,0
525,PUDUCHERRY,2003,House Wife,0,0,0,0,0,0,0,49,28,14,17,108,108
526,PUDUCHERRY,2003,Service (Government),0,1,3,4,0,8,0,1,1,0,0,2,10
527,PUDUCHERRY,2003,Service (Private),0,9,5,2,1,17,0,10,0,0,0,10,27
528,PUDUCHERRY,2003,Public Sector Undertaking,0,1,5,4,1,11,0,0,0,0,0,0,11
529,PUDUCHERRY,2003,Student,3,12,0,0,0,15,0,15,0,0,0,15,30
530,PUDUCHERRY,2003,Unemployed,0,18,10,9,8,45,0,40,1,0,1,42,87
531,PUDUCHERRY,2003,Self-employed (Business activity),0,4,8,4,4,20,0,1,0,0,0,1,21
532,PUDUCHERRY,2003,Professional Activity,1,21,33,17,1,73,0,1,0,0,0,1,74
533,PUDUCHERRY,2003,Farming/Agriculture Activity,0,1,10,7,3,21,0,2,0,0,0,2,23
534,PUDUCHERRY,2003,Others (Please Specify),0,47,72,38,17,174,0,7,2,4,0,13,187
535,PUDUCHERRY,2003,Retired Person,0,0,0,0,0,0,0,0,0,0,0,0,0
536,PUDUCHERRY,2003,Others (Please Specify),0,0,0,3,1,4,0,0,0,0,0,0,4
537,PUDUCHERRY,2003,Total,4,114,146,88,36,388,0,126,32,18,18,194,582
538,PUDUCHERRY,2003,Total Salaried,0,11,13,10,2,36,0,11,1,0,0,12,48
539,PUDUCHERRY,2003,Total Self-employed,1,73,123,66,25,288,0,11,2,4,0,17,305
540,TOTAL (UTs),2003,House Wife,0,0,0,0,0,0,0,200,129,54,23,406,406
541,TOTAL (UTs),2003,Service (Government),0,10,25,14,1,50,0,10,3,3,0,16,66
542,TOTAL (UTs),2003,Service (Private),0,82,82,29,6,199,0,24,7,0,0,31,230
543,TOTAL (UTs),2003,Public Sector Undertaking,0,4,13,6,1,24,0,1,0,0,0,1,25
544,TOTAL (UTs),2003,Student,14,60,0,0,0,74,17,77,3,0,0,97,171
545,TOTAL (UTs),2003,Unemployed,1,150,115,28,25,319,2,67,12,10,1,92,411
546,TOTAL (UTs),2003,Self-employed (Business activity),0,10,23,8,5,46,0,1,0,0,0,1,47
547,TOTAL (UTs),2003,Professional Activity,1,26,37,18,1,83,0,1,0,0,0,1,84
548,TOTAL (UTs),2003,Farming/Agriculture Activity,0,15,15,17,8,55,0,2,0,0,0,2,57
549,TOTAL (UTs),2003,Others (Please Specify),2,88,129,67,21,307,1,26,9,4,0,40,347
550,TOTAL (UTs),2003,Retired Person,0,0,0,2,2,4,0,0,0,0,0,0,4
551,TOTAL (UTs),2003,Others (Please Specify),8,65,51,23,8,155,4,12,6,2,2,26,181
552,TOTAL (UTs),2003,Total,26,510,490,212,78,1316,24,421,169,73,26,713,2029
553,TOTAL (UTs),2003,Total Salaried,0,96,120,49,8,273,0,35,10,3,0,48,321
554,TOTAL (UTs),2003,Total Self-employed,3,139,204,110,35,491,1,30,9,4,0,44,535
555,TOTAL (ALL INDIA),2003,House Wife,0,0,0,0,0,0,22,10049,7840,3821,1569,23301,23301
556,TOTAL (ALL INDIA),2003,Service (Government),1,491,793,581,23,1889,1,191,178,74,0,444,2333
557,TOTAL (ALL INDIA),2003,Service (Private),22,1996,2805,1591,234,6648,2,664,528,235,32,1461,8109
558,TOTAL (ALL INDIA),2003,Public Sector Undertaking,1,710,885,758,48,2402,3,243,157,80,5,488,2890
559,TOTAL (ALL INDIA),2003,Student,575,2485,288,37,2,3387,599,1916,174,15,0,2704,6091
560,TOTAL (ALL INDIA),2003,Unemployed,51,3292,3039,1250,533,8165,38,888,492,245,85,1748,9913
561,TOTAL (ALL INDIA),2003,Self-employed (Business activity),13,1214,1996,1565,402,5190,16,189,162,95,26,488,5678
562,TOTAL (ALL INDIA),2003,Professional Activity,6,831,1109,683,164,2793,1,94,101,60,16,272,3065
563,TOTAL (ALL INDIA),2003,Farming/Agriculture Activity,49,3794,5413,3799,1646,14701,71,1026,823,423,120,2463,17164
564,TOTAL (ALL INDIA),2003,Others (Please Specify),223,4035,5078,3643,1675,14654,203,1614,1010,662,385,3874,18528
565,TOTAL (ALL INDIA),2003,Retired Person,0,10,32,164,694,900,0,9,10,54,89,162,1062
566,TOTAL (ALL INDIA),2003,Others (Please Specify),337,2839,3241,2040,1035,9492,342,1248,863,457,315,3225,12717
567,TOTAL (ALL INDIA),2003,Total,1278,21697,24679,16111,6456,70221,1298,18131,12338,6221,2642,40630,110851
568,TOTAL (ALL INDIA),2003,Total Salaried,24,3197,4483,2930,305,10939,6,1098,863,389,37,2393,13332
569,TOTAL (ALL INDIA),2003,Total Self-employed,291,9874,13596,9690,3887,37338,291,2923,2096,1240,547,7097,44435
0,ANDHRA PRADESH,2004,House Wife,0,0,0,0,0,0,0,1163,795,264,93,2315,2315
1,ANDHRA PRADESH,2004,Service (Government),0,81,163,51,5,300,0,5,8,1,0,14,314
2,ANDHRA PRADESH,2004,Service (Private),4,174,248,171,22,619,0,34,35,11,0,80,699
3,ANDHRA PRADESH,2004,Public Sector Undertaking,0,20,30,10,3,63,0,5,17,1,0,23,86
4,ANDHRA PRADESH,2004,Student,37,230,48,0,0,315,43,127,7,0,0,177,492
5,ANDHRA PRADESH,2004,Unemployed,1,175,239,147,0,562,2,46,18,14,0,80,642
6,ANDHRA PRADESH,2004,Self-employed (Business activity),4,248,348,205,108,913,0,29,19,18,1,67,980
7,ANDHRA PRADESH,2004,Professional Activity,1,87,154,60,27,329,1,24,21,23,12,81,410
8,ANDHRA PRADESH,2004,Farming/Agriculture Activity,2,455,857,687,217,2218,14,154,150,84,46,448,2666
9,ANDHRA PRADESH,2004,Others (Please Specify),6,460,526,380,94,1466,20,142,88,81,36,367,1833
10,ANDHRA PRADESH,2004,Retired Person,0,0,6,33,23,62,0,0,0,17,6,23,85
11,ANDHRA PRADESH,2004,Others (Please Specify),40,632,829,431,303,2235,62,230,186,175,116,769,3004
12,ANDHRA PRADESH,2004,Total,95,2562,3448,2175,802,9082,142,1959,1344,689,310,4444,13526
13,ANDHRA PRADESH,2004,Total Salaried,4,275,441,232,30,982,0,44,60,13,0,117,1099
14,ANDHRA PRADESH,2004,Total Self-employed,13,1250,1885,1332,446,4926,35,349,278,206,95,963,5889
15,ARUNACHAL PRADESH,2004,House Wife,0,0,0,0,0,0,0,7,10,0,0,17,17
16,ARUNACHAL PRADESH,2004,Service (Government),0,2,7,1,0,10,0,1,0,0,0,1,11
17,ARUNACHAL PRADESH,2004,Service (Private),0,1,1,0,0,2,0,0,0,0,0,0,2
18,ARUNACHAL PRADESH,2004,Public Sector Undertaking,0,0,0,0,0,0,0,0,0,0,0,0,0
19,ARUNACHAL PRADESH,2004,Student,1,4,0,0,0,5,2,3,0,0,0,5,10
20,ARUNACHAL PRADESH,2004,Unemployed,0,1,1,0,0,2,1,0,2,0,0,3,5
21,ARUNACHAL PRADESH,2004,Self-employed (Business activity),0,5,6,3,0,14,0,0,0,0,0,0,14
22,ARUNACHAL PRADESH,2004,Professional Activity,0,0,0,0,0,0,0,0,0,0,0,0,0
23,ARUNACHAL PRADESH,2004,Farming/Agriculture Activity,0,5,9,2,0,16,1,2,1,0,0,4,20
24,ARUNACHAL PRADESH,2004,Others (Please Specify),0,0,0,0,0,0,0,0,0,0,0,0,0
25,ARUNACHAL PRADESH,2004,Retired Person,0,0,0,0,0,0,0,0,0,0,0,0,0
26,ARUNACHAL PRADESH,2004,Others (Please Specify),0,0,0,0,0,0,0,0,0,0,0,0,0
27,ARUNACHAL PRADESH,2004,Total,1,18,24,6,0,49,4,13,13,0,0,30,79
28,ARUNACHAL PRADESH,2004,Total Salaried,0,3,8,1,0,12,0,1,0,0,0,1,13
29,ARUNACHAL PRADESH,2004,Total Self-employed,0,10,15,5,0,30,1,2,1,0,0,4,34
30,ASSAM,2004,House Wife,0,0,0,0,0,0,0,212,159,70,5,446,446
31,ASSAM,2004,Service (Government),0,0,4,6,0,10,0,0,1,1,0,2,12
32,ASSAM,2004,Service (Private),0,31,26,12,0,69,0,2,6,7,0,15,84
33,ASSAM,2004,Public Sector Undertaking,0,24,16,9,1,50,0,6,7,2,0,15,65
34,ASSAM,2004,Student,20,89,4,0,0,113,10,50,2,0,0,62,175
35,ASSAM,2004,Unemployed,0,50,90,86,11,237,0,33,18,10,1,62,299
36,ASSAM,2004,Self-employed (Business activity),2,118,122,52,6,300,0,16,16,2,0,34,334
37,ASSAM,2004,Professional Activity,2,47,64,10,1,124,0,0,0,0,0,0,124
38,ASSAM,2004,Farming/Agriculture Activity,0,83,155,67,11,316,2,8,3,2,0,15,331
39,ASSAM,2004,Others (Please Specify),14,144,216,117,28,519,4,70,57,13,4,148,667
40,ASSAM,2004,Retired Person,0,0,0,0,4,4,0,0,0,0,0,0,4
41,ASSAM,2004,Others (Please Specify),3,105,67,18,10,203,2,49,27,13,4,95,298
42,ASSAM,2004,Total,41,691,764,377,72,1945,18,446,296,120,14,894,2839
43,ASSAM,2004,Total Salaried,0,55,46,27,1,129,0,8,14,10,0,32,161
44,ASSAM,2004,Total Self-employed,18,392,557,246,46,1259,6,94,76,17,4,197,1456
45,BIHAR,2004,House Wife,0,0,0,0,0,0,0,39,40,9,2,90,90
46,BIHAR,2004,Service (Government),0,0,4,4,0,8,0,0,0,0,0,0,8
47,BIHAR,2004,Service (Private),0,4,7,4,0,15,0,0,0,1,0,1,16
48,BIHAR,2004,Public Sector Undertaking,0,1,6,1,0,8,0,0,0,0,0,0,8
49,BIHAR,2004,Student,7,14,1,0,0,22,5,5,0,0,0,10,32
50,BIHAR,2004,Unemployed,5,24,11,3,0,43,1,1,4,1,0,7,50
51,BIHAR,2004,Self-employed (Business activity),0,7,7,2,0,16,0,4,3,0,0,7,23
52,BIHAR,2004,Professional Activity,0,2,2,2,0,6,0,0,0,0,0,0,6
53,BIHAR,2004,Farming/Agriculture Activity,0,4,10,6,3,23,0,0,0,0,0,0,23
54,BIHAR,2004,Others (Please Specify),0,1,0,1,0,2,0,0,0,0,1,1,3
55,BIHAR,2004,Retired Person,0,0,11,3,3,17,0,0,0,0,0,0,17
56,BIHAR,2004,Others (Please Specify),4,18,17,4,9,52,3,10,4,3,3,23,75
57,BIHAR,2004,Total,16,75,76,30,15,212,9,59,51,14,6,139,351
58,BIHAR,2004,Total Salaried,0,5,17,9,0,31,0,0,0,1,0,1,32
59,BIHAR,2004,Total Self-employed,0,14,19,11,3,47,0,4,3,0,1,8,55
60,CHHATTISGARH,2004,House Wife,0,0,0,0,0,0,1,358,264,114,40,777,777
61,CHHATTISGARH,2004,Service (Government),0,7,17,10,1,35,0,1,1,0,0,2,37
62,CHHATTISGARH,2004,Service (Private),0,25,31,22,2,80,0,0,0,2,0,2,82
63,CHHATTISGARH,2004,Public Sector Undertaking,0,3,7,5,0,15,0,1,0,0,0,1,16
64,CHHATTISGARH,2004,Student,20,112,6,0,0,138,27,61,0,0,0,88,226
65,CHHATTISGARH,2004,Unemployed,5,97,55,4,0,161,0,2,1,0,0,3,164
66,CHHATTISGARH,2004,Self-employed (Business activity),0,19,12,14,0,45,0,0,0,0,0,0,45
67,CHHATTISGARH,2004,Professional Activity,0,9,20,14,4,47,0,4,1,0,1,6,53
68,CHHATTISGARH,2004,Farming/Agriculture Activity,3,312,475,303,120,1213,0,64,56,44,18,182,1395
69,CHHATTISGARH,2004,Others (Please Specify),9,102,258,222,92,683,10,53,71,42,14,190,873
70,CHHATTISGARH,2004,Retired Person,0,0,0,0,0,0,0,0,0,0,0,0,0
71,CHHATTISGARH,2004,Others (Please Specify),40,193,176,113,47,569,54,110,66,23,5,258,827
72,CHHATTISGARH,2004,Total,77,879,1057,707,266,2986,92,654,460,225,78,1509,4495
73,CHHATTISGARH,2004,Total Salaried,0,35,55,37,3,130,0,2,1,2,0,5,135
74,CHHATTISGARH,2004,Total Self-employed,12,442,765,553,216,1988,10,121,128,86,33,378,2366
75,GOA,2004,House Wife,0,0,0,0,0,0,0,19,22,10,4,55,55
76,GOA,2004,Service (Government),0,1,4,2,0,7,0,0,1,2,0,3,10
77,GOA,2004,Service (Private),0,11,19,9,0,39,0,6,0,1,0,7,46
78,GOA,2004,Public Sector Undertaking,0,4,3,3,0,10,0,0,3,0,0,3,13
79,GOA,2004,Student,2,11,0,0,0,13,3,7,0,0,0,10,23
80,GOA,2004,Unemployed,0,20,19,8,1,48,0,9,1,0,1,11,59
81,GOA,2004,Self-employed (Business activity),0,6,4,2,0,12,0,1,1,0,0,2,14
82,GOA,2004,Professional Activity,0,0,1,0,0,1,0,1,0,0,0,1,2
83,GOA,2004,Farming/Agriculture Activity,0,0,2,5,0,7,0,0,1,0,0,1,8
84,GOA,2004,Others (Please Specify),0,2,5,2,1,10,0,0,0,0,0,0,10
85,GOA,2004,Retired Person,0,0,0,2,1,3,0,0,0,0,0,0,3
86,GOA,2004,Others (Please Specify),4,18,25,11,4,62,2,3,2,1,1,9,71
87,GOA,2004,Total,6,73,82,44,7,212,5,46,31,14,6,102,314
88,GOA,2004,Total Salaried,0,16,26,14,0,56,0,6,4,3,0,13,69
89,GOA,2004,Total Self-employed,0,8,12,9,1,30,0,2,2,0,0,4,34
90,GUJARAT,2004,House Wife,0,0,0,0,0,0,6,616,489,190,59,1360,1360
91,GUJARAT,2004,Service (Government),0,15,30,15,0,60,0,1,4,1,0,6,66
92,GUJARAT,2004,Service (Private),0,107,153,81,10,351,0,40,19,9,1,69,420
93,GUJARAT,2004,Public Sector Undertaking,0,9,14,16,2,41,0,1,1,0,0,2,43
94,GUJARAT,2004,Student,15,115,10,0,0,140,13,92,1,0,1,107,247
95,GUJARAT,2004,Unemployed,1,171,170,73,10,425,0,27,19,6,0,52,477
96,GUJARAT,2004,Self-employed (Business activity),0,71,96,57,10,234,0,1,3,1,1,6,240
97,GUJARAT,2004,Professional Activity,0,123,141,85,16,365,0,10,8,2,1,21,386
98,GUJARAT,2004,Farming/Agriculture Activity,0,134,153,123,42,452,0,31,20,18,2,71,523
99,GUJARAT,2004,Others (Please Specify),4,163,184,97,29,477,5,69,30,8,7,119,596
100,GUJARAT,2004,Retired Person,0,0,0,15,46,61,0,0,0,11,30,41,102
101,GUJARAT,2004,Others (Please Specify),14,80,86,49,15,244,5,39,10,11,7,72,316
102,GUJARAT,2004,Total,34,988,1037,611,180,2850,29,927,604,257,109,1926,4776
103,GUJARAT,2004,Total Salaried,0,131,197,112,12,452,0,42,24,10,1,77,529
104,GUJARAT,2004,Total Self-employed,4,491,574,362,97,1528,5,111,61,29,11,217,1745
105,HARYANA,2004,House Wife,0,0,0,0,0,0,1,157,120,37,15,330,330
106,HARYANA,2004,Service (Government),0,20,28,19,0,67,0,11,4,1,0,16,83
107,HARYANA,2004,Service (Private),0,62,82,26,2,172,0,27,8,2,0,37,209
108,HARYANA,2004,Public Sector Undertaking,0,13,32,5,0,50,0,3,6,1,0,10,60
109,HARYANA,2004,Student,5,71,3,0,0,79,11,27,0,0,0,38,117
110,HARYANA,2004,Unemployed,4,71,72,34,6,187,3,6,10,5,0,24,211
111,HARYANA,2004,Self-employed (Business activity),0,28,30,20,11,89,0,0,0,0,0,0,89
112,HARYANA,2004,Professional Activity,0,1,19,13,0,33,0,0,0,0,0,0,33
113,HARYANA,2004,Farming/Agriculture Activity,0,40,56,38,10,144,0,6,6,4,0,16,160
114,HARYANA,2004,Others (Please Specify),4,55,69,40,8,176,2,8,19,9,2,40,216
115,HARYANA,2004,Retired Person,0,0,0,0,9,9,0,0,0,0,0,0,9
116,HARYANA,2004,Others (Please Specify),21,155,153,60,59,448,5,62,31,13,6,117,565
117,HARYANA,2004,Total,34,516,544,255,105,1454,22,307,204,72,23,628,2082
118,HARYANA,2004,Total Salaried,0,95,142,50,2,289,0,41,18,4,0,63,352
119,HARYANA,2004,Total Self-employed,4,124,174,111,29,442,2,14,25,13,2,56,498
120,HIMACHAL PRADESH,2004,House Wife,0,0,0,0,0,0,0,40,24,9,2,75,75
121,HIMACHAL PRADESH,2004,Service (Government),0,6,4,3,0,13,0,0,0,1,0,1,14
122,HIMACHAL PRADESH,2004,Service (Private),1,21,21,4,2,49,0,1,1,0,0,2,51
123,HIMACHAL PRADESH,2004,Public Sector Undertaking,0,1,0,1,0,2,0,0,0,0,0,0,2
124,HIMACHAL PRADESH,2004,Student,4,7,0,0,0,11,2,9,1,0,0,12,23
125,HIMACHAL PRADESH,2004,Unemployed,0,18,10,2,4,34,0,12,0,0,0,12,46
126,HIMACHAL PRADESH,2004,Self-employed (Business activity),0,5,3,3,0,11,0,1,0,0,0,1,12
127,HIMACHAL PRADESH,2004,Professional Activity,0,0,0,1,0,1,0,0,0,0,0,0,1
128,HIMACHAL PRADESH,2004,Farming/Agriculture Activity,0,14,14,13,2,43,0,3,4,1,1,9,52
129,HIMACHAL PRADESH,2004,Others (Please Specify),0,5,15,8,1,29,0,5,5,0,0,10,39
130,HIMACHAL PRADESH,2004,Retired Person,0,0,0,0,0,0,0,0,0,0,0,0,0
131,HIMACHAL PRADESH,2004,Others (Please Specify),0,0,15,19,9,43,2,0,7,3,1,13,56
132,HIMACHAL PRADESH,2004,Total,5,77,82,54,18,236,4,71,42,14,4,135,371
133,HIMACHAL PRADESH,2004,Total Salaried,1,28,25,8,2,64,0,1,1,1,0,3,67
134,HIMACHAL PRADESH,2004,Total Self-employed,0,24,32,25,3,84,0,9,9,1,1,20,104
135,JAMMU & KASHMIR,2004,House Wife,0,0,0,0,0,0,0,13,16,0,0,29,29
136,JAMMU & KASHMIR,2004,Service (Government),0,2,2,0,0,4,0,0,0,0,0,0,4
137,JAMMU & KASHMIR,2004,Service (Private),0,0,0,0,0,0,0,0,0,0,0,0,0
138,JAMMU & KASHMIR,2004,Public Sector Undertaking,0,0,0,0,0,0,0,1,0,0,0,1,1
139,JAMMU & KASHMIR,2004,Student,0,3,0,0,0,3,0,3,0,0,0,3,6
140,JAMMU & KASHMIR,2004,Unemployed,0,6,0,0,0,6,0,0,0,0,0,0,6
141,JAMMU & KASHMIR,2004,Self-employed (Business activity),0,0,0,0,0,0,0,0,0,0,0,0,0
142,JAMMU & KASHMIR,2004,Professional Activity,0,0,0,0,0,0,0,0,0,0,0,0,0
143,JAMMU & KASHMIR,2004,Farming/Agriculture Activity,0,0,0,1,0,1,0,0,0,0,0,0,1
144,JAMMU & KASHMIR,2004,Others (Please Specify),0,0,5,0,0,5,0,4,5,1,0,10,15
145,JAMMU & KASHMIR,2004,Retired Person,0,0,0,0,0,0,0,0,0,0,0,0,0
146,JAMMU & KASHMIR,2004,Others (Please Specify),0,16,9,7,0,32,0,8,8,2,0,18,50
147,JAMMU & KASHMIR,2004,Total,0,27,16,8,0,51,0,29,29,3,0,61,112
148,JAMMU & KASHMIR,2004,Total Salaried,0,2,2,0,0,4,0,1,0,0,0,1,5
149,JAMMU & KASHMIR,2004,Total Self-employed,0,0,5,1,0,6,0,4,5,1,0,10,16
150,JHARKHAND,2004,House Wife,0,0,0,0,0,0,0,0,0,0,0,0,0
151,JHARKHAND,2004,Service (Government),0,0,0,0,0,0,0,0,0,0,0,0,0
152,JHARKHAND,2004,Service (Private),0,0,4,1,0,5,0,0,3,0,0,3,8
153,JHARKHAND,2004,Public Sector Undertaking,0,0,2,1,0,3,0,0,2,1,0,3,6
154,JHARKHAND,2004,Student,3,4,0,0,0,7,0,3,0,0,0,3,10
155,JHARKHAND,2004,Unemployed,0,8,8,11,0,27,0,1,1,0,0,2,29
156,JHARKHAND,2004,Self-employed (Business activity),0,0,2,1,0,3,0,0,1,0,0,1,4
157,JHARKHAND,2004,Professional Activity,0,4,1,2,2,9,0,0,0,0,0,0,9
158,JHARKHAND,2004,Farming/Agriculture Activity,0,4,14,3,0,21,0,0,0,0,0,0,21
159,JHARKHAND,2004,Others (Please Specify),0,18,10,6,0,34,0,10,0,2,0,12,46
160,JHARKHAND,2004,Retired Person,0,0,0,0,0,0,0,0,0,0,0,0,0
161,JHARKHAND,2004,Others (Please Specify),6,34,39,36,9,124,4,51,63,42,0,160,284
162,JHARKHAND,2004,Total,9,72,80,61,11,233,4,65,70,45,0,184,417
163,JHARKHAND,2004,Total Salaried,0,0,6,2,0,8,0,0,5,1,0,6,14
164,JHARKHAND,2004,Total Self-employed,0,26,27,12,2,67,0,10,1,2,0,13,80
165,KARNATAKA,2004,House Wife,0,0,0,0,0,0,0,736,609,300,138,1783,1783
166,KARNATAKA,2004,Service (Government),0,38,65,58,4,165,0,21,10,3,0,34,199
167,KARNATAKA,2004,Service (Private),5,286,358,192,46,887,1,104,77,29,7,218,1105
168,KARNATAKA,2004,Public Sector Undertaking,0,55,78,29,7,169,0,30,10,9,0,49,218
169,KARNATAKA,2004,Student,45,162,25,0,0,232,48,162,6,0,0,216,448
170,KARNATAKA,2004,Unemployed,4,179,185,101,57,526,2,38,24,7,14,85,611
171,KARNATAKA,2004,Self-employed (Business activity),9,153,207,82,20,471,3,4,8,8,0,23,494
172,KARNATAKA,2004,Professional Activity,0,33,35,14,3,85,0,0,0,0,0,0,85
173,KARNATAKA,2004,Farming/Agriculture Activity,1,464,661,432,148,1706,5,84,112,48,8,257,1963
174,KARNATAKA,2004,Others (Please Specify),16,601,782,479,177,2055,44,221,244,86,42,637,2692
175,KARNATAKA,2004,Retired Person,0,0,8,17,50,75,0,0,0,0,0,0,75
176,KARNATAKA,2004,Others (Please Specify),79,358,524,458,228,1647,43,288,131,107,48,617,2264
177,KARNATAKA,2004,Total,159,2329,2928,1862,740,8018,146,1688,1231,597,257,3919,11937
178,KARNATAKA,2004,Total Salaried,5,379,501,279,57,1221,1,155,97,41,7,301,1522
179,KARNATAKA,2004,Total Self-employed,26,1251,1685,1007,348,4317,52,309,364,142,50,917,5234
180,KERALA,2004,House Wife,0,0,0,0,0,0,0,288,484,413,328,1513,1513
181,KERALA,2004,Service (Government),0,4,39,40,0,83,0,1,3,1,0,5,88
182,KERALA,2004,Service (Private),0,38,101,70,11,220,0,13,9,4,2,28,248
183,KERALA,2004,Public Sector Undertaking,0,6,17,8,0,31,0,1,3,3,1,8,39
184,KERALA,2004,Student,37,106,0,0,0,143,38,153,2,0,0,193,336
185,KERALA,2004,Unemployed,2,282,299,208,215,1006,0,123,47,32,56,258,1264
186,KERALA,2004,Self-employed (Business activity),0,48,150,153,34,385,0,0,0,1,0,1,386
187,KERALA,2004,Professional Activity,0,39,57,46,8,150,0,4,2,0,0,6,156
188,KERALA,2004,Farming/Agriculture Activity,0,73,240,330,217,860,0,7,13,17,6,43,903
189,KERALA,2004,Others (Please Specify),2,356,774,920,482,2534,7,91,43,37,49,227,2761
190,KERALA,2004,Retired Person,0,0,0,17,67,84,0,0,0,1,8,9,93
191,KERALA,2004,Others (Please Specify),7,155,390,318,232,1102,8,48,48,27,33,164,1266
192,KERALA,2004,Total,48,1107,2067,2110,1266,6598,53,729,654,536,483,2455,9053
193,KERALA,2004,Total Salaried,0,48,157,118,11,334,0,15,15,8,3,41,375
194,KERALA,2004,Total Self-employed,2,516,1221,1449,741,3929,7,102,58,55,55,277,4206
195,MADHYA PRADESH,2004,House Wife,0,0,0,0,0,0,0,1244,584,198,86,2112,2112
196,MADHYA PRADESH,2004,Service (Government),0,62,70,31,7,170,0,15,13,6,0,34,204
197,MADHYA PRADESH,2004,Service (Private),1,115,142,65,11,334,0,39,21,1,0,61,395
198,MADHYA PRADESH,2004,Public Sector Undertaking,0,33,42,15,9,99,0,29,21,1,0,51,150
199,MADHYA PRADESH,2004,Student,64,88,1,0,0,153,38,73,0,0,0,111,264
200,MADHYA PRADESH,2004,Unemployed,1,159,70,20,0,250,0,20,11,1,0,32,282
201,MADHYA PRADESH,2004,Self-employed (Business activity),0,85,97,55,30,267,0,31,15,8,4,58,325
202,MADHYA PRADESH,2004,Professional Activity,0,42,46,57,16,161,0,6,8,7,6,27,188
203,MADHYA PRADESH,2004,Farming/Agriculture Activity,1,564,441,202,139,1347,9,143,83,38,18,291,1638
204,MADHYA PRADESH,2004,Others (Please Specify),18,193,217,126,83,637,48,118,52,56,43,317,954
205,MADHYA PRADESH,2004,Retired Person,0,0,0,0,14,14,0,0,0,0,0,0,14
206,MADHYA PRADESH,2004,Others (Please Specify),24,67,76,24,11,202,15,35,11,5,1,67,269
207,MADHYA PRADESH,2004,Total,109,1408,1202,595,320,3634,110,1753,819,321,158,3161,6795
208,MADHYA PRADESH,2004,Total Salaried,1,210,254,111,27,603,0,83,55,8,0,146,749
209,MADHYA PRADESH,2004,Total Self-employed,19,884,801,440,268,2412,57,298,158,109,71,693,3105
210,MAHARASHTRA,2004,House Wife,0,0,0,0,0,0,0,1768,1096,422,215,3501,3501
211,MAHARASHTRA,2004,Service (Government),0,38,97,66,0,201,0,23,13,7,0,43,244
212,MAHARASHTRA,2004,Service (Private),0,403,599,300,43,1345,0,61,30,9,1,101,1446
213,MAHARASHTRA,2004,Public Sector Undertaking,0,46,62,40,6,154,0,4,2,3,0,9,163
214,MAHARASHTRA,2004,Student,77,427,12,0,0,516,81,357,5,0,0,443,959
215,MAHARASHTRA,2004,Unemployed,0,514,396,99,9,1018,2,46,11,1,0,60,1078
216,MAHARASHTRA,2004,Self-employed (Business activity),0,134,201,130,40,505,0,9,12,5,1,27,532
217,MAHARASHTRA,2004,Professional Activity,0,79,123,82,26,310,0,5,4,0,0,9,319
218,MAHARASHTRA,2004,Farming/Agriculture Activity,3,909,1504,940,443,3799,3,155,107,59,24,348,4147
219,MAHARASHTRA,2004,Others (Please Specify),7,517,715,456,168,1863,5,136,71,29,24,265,2128
220,MAHARASHTRA,2004,Retired Person,0,0,0,16,105,121,0,0,0,0,2,2,123
221,MAHARASHTRA,2004,Others (Please Specify),0,13,29,9,20,71,2,9,2,1,4,18,89
222,MAHARASHTRA,2004,Total,87,3080,3738,2138,860,9903,93,2573,1353,536,271,4826,14729
223,MAHARASHTRA,2004,Total Salaried,0,487,758,406,49,1700,0,88,45,19,1,153,1853
224,MAHARASHTRA,2004,Total Self-employed,10,1639,2543,1608,677,6477,8,305,194,93,49,649,7126
225,MANIPUR,2004,House Wife,0,0,0,0,0,0,0,0,1,0,0,1,1
226,MANIPUR,2004,Service (Government),0,4,7,1,0,12,0,0,0,0,0,0,12
227,MANIPUR,2004,Service (Private),0,0,1,0,0,1,0,0,0,0,0,0,1
228,MANIPUR,2004,Public Sector Undertaking,0,0,0,0,0,0,0,0,0,0,0,0,0
229,MANIPUR,2004,Student,0,4,0,0,0,4,1,5,0,0,0,6,10
230,MANIPUR,2004,Unemployed,0,5,1,1,0,7,0,0,2,0,0,2,9
231,MANIPUR,2004,Self-employed (Business activity),0,2,1,0,0,3,0,0,0,0,0,0,3
232,MANIPUR,2004,Professional Activity,0,0,0,0,0,0,0,0,0,0,0,0,0
233,MANIPUR,2004,Farming/Agriculture Activity,0,0,1,1,0,2,0,0,0,0,0,0,2
234,MANIPUR,2004,Others (Please Specify),0,1,0,0,0,1,0,0,0,0,0,0,1
235,MANIPUR,2004,Retired Person,0,0,0,0,0,0,0,0,0,0,0,0,0
236,MANIPUR,2004,Others (Please Specify),0,1,1,0,0,2,0,0,0,0,0,0,2
237,MANIPUR,2004,Total,0,17,12,3,0,32,1,5,3,0,0,9,41
238,MANIPUR,2004,Total Salaried,0,4,8,1,0,13,0,0,0,0,0,0,13
239,MANIPUR,2004,Total Self-employed,0,3,2,1,0,6,0,0,0,0,0,0,6
240,MEGHALAYA,2004,House Wife,0,0,0,0,0,0,0,5,2,0,0,7,7
241,MEGHALAYA,2004,Service (Government),0,0,8,2,0,10,0,1,0,0,0,1,11
242,MEGHALAYA,2004,Service (Private),0,3,3,0,0,6,0,0,0,0,0,0,6
243,MEGHALAYA,2004,Public Sector Undertaking,0,1,1,0,0,2,0,0,0,0,0,0,2
244,MEGHALAYA,2004,Student,0,6,0,0,0,6,0,6,0,0,0,6,12
245,MEGHALAYA,2004,Unemployed,0,1,3,0,0,4,0,2,0,0,0,2,6
246,MEGHALAYA,2004,Self-employed (Business activity),0,0,0,0,0,0,0,0,0,0,0,0,0
247,MEGHALAYA,2004,Professional Activity,0,0,0,0,0,0,0,0,0,0,0,0,0
248,MEGHALAYA,2004,Farming/Agriculture Activity,0,0,3,6,2,11,0,0,0,0,0,0,11
249,MEGHALAYA,2004,Others (Please Specify),0,0,0,0,0,0,0,0,0,0,0,0,0
250,MEGHALAYA,2004,Retired Person,0,0,0,0,0,0,0,0,0,0,0,0,0
251,MEGHALAYA,2004,Others (Please Specify),0,0,0,0,0,0,0,0,0,0,0,0,0
252,MEGHALAYA,2004,Total,0,11,18,8,2,39,0,14,2,0,0,16,55
253,MEGHALAYA,2004,Total Salaried,0,4,12,2,0,18,0,1,0,0,0,1,19
254,MEGHALAYA,2004,Total Self-employed,0,0,3,6,2,11,0,0,0,0,0,0,11
255,MIZORAM,2004,House Wife,0,0,0,0,0,0,0,0,0,0,0,0,0
256,MIZORAM,2004,Service (Government),0,3,1,0,0,4,0,0,0,0,0,0,4
257,MIZORAM,2004,Service (Private),0,0,0,0,0,0,0,0,0,0,0,0,0
258,MIZORAM,2004,Public Sector Undertaking,0,0,4,1,0,5,0,0,0,0,0,0,5
259,MIZORAM,2004,Student,0,1,0,0,0,1,0,0,0,0,0,0,1
260,MIZORAM,2004,Unemployed,0,11,5,2,0,18,0,3,0,0,0,3,21
261,MIZORAM,2004,Self-employed (Business activity),0,0,0,0,0,0,0,0,0,0,0,0,0
262,MIZORAM,2004,Professional Activity,0,0,0,0,0,0,0,0,0,0,0,0,0
263,MIZORAM,2004,Farming/Agriculture Activity,0,0,1,1,0,2,0,0,0,0,0,0,2
264,MIZORAM,2004,Others (Please Specify),0,8,6,1,0,15,0,3,0,0,0,3,18
265,MIZORAM,2004,Retired Person,0,0,0,0,0,0,0,0,0,0,0,0,0
266,MIZORAM,2004,Others (Please Specify),0,6,0,2,0,8,0,0,1,0,0,1,9
267,MIZORAM,2004,Total,0,29,17,7,0,53,0,6,1,0,0,7,60
268,MIZORAM,2004,Total Salaried,0,3,5,1,0,9,0,0,0,0,0,0,9
269,MIZORAM,2004,Total Self-employed,0,8,7,2,0,17,0,3,0,0,0,3,20
270,NAGALAND,2004,House Wife,0,0,0,0,0,0,0,0,0,0,0,0,0
271,NAGALAND,2004,Service (Government),0,1,5,0,0,6,0,0,0,0,0,0,6
272,NAGALAND,2004,Service (Private),0,0,0,0,0,0,0,0,0,0,0,0,0
273,NAGALAND,2004,Public Sector Undertaking,0,2,0,0,0,2,0,0,0,0,0,0,2
274,NAGALAND,2004,Student,0,1,0,0,0,1,0,0,0,0,0,0,1
275,NAGALAND,2004,Unemployed,0,2,3,0,0,5,0,0,0,0,0,0,5
276,NAGALAND,2004,Self-employed (Business activity),0,0,0,0,0,0,0,0,0,0,0,0,0
277,NAGALAND,2004,Professional Activity,0,0,0,0,0,0,0,0,0,0,0,0,0
278,NAGALAND,2004,Farming/Agriculture Activity,0,0,0,0,0,0,0,0,0,0,0,0,0
279,NAGALAND,2004,Others (Please Specify),0,4,5,2,0,11,0,4,2,0,0,6,17
280,NAGALAND,2004,Retired Person,0,0,0,0,0,0,0,0,0,0,0,0,0
281,NAGALAND,2004,Others (Please Specify),0,0,0,0,0,0,0,0,0,0,0,0,0
282,NAGALAND,2004,Total,0,10,13,2,0,25,0,4,2,0,0,6,31
283,NAGALAND,2004,Total Salaried,0,3,5,0,0,8,0,0,0,0,0,0,8
284,NAGALAND,2004,Total Self-employed,0,4,5,2,0,11,0,4,2,0,0,6,17
285,ODISHA,2004,House Wife,0,0,0,0,0,0,0,291,214,103,12,620,620
286,ODISHA,2004,Service (Government),0,9,16,10,0,35,0,1,3,2,0,6,41
287,ODISHA,2004,Service (Private),0,30,75,52,5,162,0,25,20,4,10,59,221
288,ODISHA,2004,Public Sector Undertaking,0,22,24,24,0,70,0,9,9,3,0,21,91
289,ODISHA,2004,Student,36,91,18,0,0,145,28,87,6,0,0,121,266
290,ODISHA,2004,Unemployed,8,99,102,37,1,247,13,46,29,15,1,104,351
291,ODISHA,2004,Self-employed (Business activity),0,61,124,56,10,251,0,8,10,2,0,20,271
292,ODISHA,2004,Professional Activity,0,10,27,20,4,61,0,0,7,0,4,11,72
293,ODISHA,2004,Farming/Agriculture Activity,0,88,109,75,27,299,1,34,33,10,2,80,379
294,ODISHA,2004,Others (Please Specify),22,239,270,260,100,891,26,228,110,54,32,450,1341
295,ODISHA,2004,Retired Person,0,0,0,1,29,30,0,0,0,7,0,7,37
296,ODISHA,2004,Others (Please Specify),18,98,139,81,17,353,11,56,55,27,23,172,525
297,ODISHA,2004,Total,84,747,904,616,193,2544,79,785,496,227,84,1671,4215
298,ODISHA,2004,Total Salaried,0,61,115,86,5,267,0,35,32,9,10,86,353
299,ODISHA,2004,Total Self-employed,22,398,530,411,141,1502,27,270,160,66,38,561,2063
300,PUNJAB,2004,House Wife,0,0,0,0,0,0,0,29,25,3,5,62,62
301,PUNJAB,2004,Service (Government),0,4,11,1,0,16,0,0,0,0,0,0,16
302,PUNJAB,2004,Service (Private),0,14,11,6,0,31,2,6,2,0,0,10,41
303,PUNJAB,2004,Public Sector Undertaking,0,4,12,2,0,18,0,3,0,0,0,3,21
304,PUNJAB,2004,Student,4,5,0,0,0,9,11,6,0,0,0,17,26
305,PUNJAB,2004,Unemployed,0,13,10,23,0,46,0,6,4,0,0,10,56
306,PUNJAB,2004,Self-employed (Business activity),0,7,9,12,0,28,0,0,0,0,0,0,28
307,PUNJAB,2004,Professional Activity,0,11,8,5,2,26,0,0,0,0,0,0,26
308,PUNJAB,2004,Farming/Agriculture Activity,0,21,29,18,5,73,0,1,0,0,0,1,74
309,PUNJAB,2004,Others (Please Specify),0,54,61,21,16,152,0,2,2,0,0,4,156
310,PUNJAB,2004,Retired Person,0,0,0,5,3,8,0,0,0,0,0,0,8
311,PUNJAB,2004,Others (Please Specify),0,53,32,11,13,109,1,5,6,10,0,22,131
312,PUNJAB,2004,Total,4,186,183,104,39,516,14,58,39,13,5,129,645
313,PUNJAB,2004,Total Salaried,0,22,34,9,0,65,2,9,2,0,0,13,78
314,PUNJAB,2004,Total Self-employed,0,93,107,56,23,279,0,3,2,0,0,5,284
315,RAJASTHAN,2004,House Wife,0,0,0,0,0,0,10,370,333,123,32,868,868
316,RAJASTHAN,2004,Service (Government),0,4,13,7,0,24,0,1,1,0,0,2,26
317,RAJASTHAN,2004,Service (Private),0,103,126,47,2,278,0,12,6,6,0,24,302
318,RAJASTHAN,2004,Public Sector Undertaking,0,19,13,5,0,37,0,2,2,0,0,4,41
319,RAJASTHAN,2004,Student,30,60,8,0,0,98,10,36,3,0,0,49,147
320,RAJASTHAN,2004,Unemployed,0,85,79,14,4,182,0,3,1,1,0,5,187
321,RAJASTHAN,2004,Self-employed (Business activity),0,29,48,22,10,109,0,1,1,2,0,4,113
322,RAJASTHAN,2004,Professional Activity,0,11,11,7,3,32,0,0,0,0,0,0,32
323,RAJASTHAN,2004,Farming/Agriculture Activity,1,207,286,154,27,675,0,27,29,14,4,74,749
324,RAJASTHAN,2004,Others (Please Specify),5,162,157,113,34,471,3,43,19,17,2,84,555
325,RAJASTHAN,2004,Retired Person,0,0,0,2,0,2,0,0,0,0,0,0,2
326,RAJASTHAN,2004,Others (Please Specify),30,171,190,128,59,578,20,47,32,12,14,125,703
327,RAJASTHAN,2004,Total,66,851,931,499,139,2486,43,542,427,175,52,1239,3725
328,RAJASTHAN,2004,Total Salaried,0,126,152,59,2,339,0,15,9,6,0,30,369
329,RAJASTHAN,2004,Total Self-employed,6,409,502,296,74,1287,3,71,49,33,6,162,1449
330,SIKKIM,2004,House Wife,0,0,0,0,0,0,0,0,2,7,2,11,11
331,SIKKIM,2004,Service (Government),0,0,3,0,0,3,0,0,0,0,0,0,3
332,SIKKIM,2004,Service (Private),0,0,4,2,0,6,0,0,0,0,0,0,6
333,SIKKIM,2004,Public Sector Undertaking,0,0,0,0,0,0,0,0,0,0,0,0,0
334,SIKKIM,2004,Student,0,0,0,0,0,0,0,0,0,0,0,0,0
335,SIKKIM,2004,Unemployed,0,0,2,0,0,2,0,0,2,0,2,4,6
336,SIKKIM,2004,Self-employed (Business activity),0,0,0,0,0,0,0,0,0,0,0,0,0
337,SIKKIM,2004,Professional Activity,0,0,3,1,2,6,0,0,0,1,1,2,8
338,SIKKIM,2004,Farming/Agriculture Activity,0,0,3,6,21,30,0,0,4,7,8,19,49
339,SIKKIM,2004,Others (Please Specify),0,0,0,2,3,5,0,0,0,0,5,5,10
340,SIKKIM,2004,Retired Person,0,0,0,0,0,0,0,0,0,0,0,0,0
341,SIKKIM,2004,Others (Please Specify),0,0,2,2,0,4,0,0,1,0,0,1,5
342,SIKKIM,2004,Total,0,0,17,13,26,56,0,0,9,15,18,42,98
343,SIKKIM,2004,Total Salaried,0,0,7,2,0,9,0,0,0,0,0,0,9
344,SIKKIM,2004,Total Self-employed,0,0,6,9,26,41,0,0,4,8,14,26,67
345,TAMIL NADU,2004,House Wife,0,0,0,0,0,0,0,698,766,485,163,2112,2112
346,TAMIL NADU,2004,Service (Government),0,34,67,54,0,155,0,3,18,23,0,44,199
347,TAMIL NADU,2004,Service (Private),0,215,301,268,48,832,3,83,102,57,6,251,1083
348,TAMIL NADU,2004,Public Sector Undertaking,0,60,94,63,10,227,0,13,30,23,7,73,300
349,TAMIL NADU,2004,Student,74,158,15,0,0,247,55,163,7,1,0,226,473
350,TAMIL NADU,2004,Unemployed,7,358,435,350,91,1241,3,207,137,93,18,458,1699
351,TAMIL NADU,2004,Self-employed (Business activity),3,180,294,271,64,812,0,23,18,17,0,58,870
352,TAMIL NADU,2004,Professional Activity,2,77,102,75,19,275,0,26,22,8,1,57,332
353,TAMIL NADU,2004,Farming/Agriculture Activity,7,318,457,329,186,1297,13,124,98,45,22,302,1599
354,TAMIL NADU,2004,Others (Please Specify),6,372,497,360,191,1426,6,221,163,142,38,570,1996
355,TAMIL NADU,2004,Retired Person,0,0,0,5,84,89,0,0,0,2,15,17,106
356,TAMIL NADU,2004,Others (Please Specify),91,248,491,395,120,1345,96,253,194,125,57,725,2070
357,TAMIL NADU,2004,Total,190,2020,2753,2170,813,7946,176,1814,1555,1021,327,4893,12839
358,TAMIL NADU,2004,Total Salaried,0,309,462,385,58,1214,3,99,150,103,13,368,1582
359,TAMIL NADU,2004,Total Self-employed,18,947,1350,1035,460,3810,19,394,301,212,61,987,4797
360,TRIPURA,2004,House Wife,0,0,0,0,0,0,4,85,51,7,5,152,152
361,TRIPURA,2004,Service (Government),0,3,5,0,0,8,0,0,3,0,0,3,11
362,TRIPURA,2004,Service (Private),0,2,4,3,2,11,0,0,3,0,0,3,14
363,TRIPURA,2004,Public Sector Undertaking,0,0,2,2,0,4,0,0,0,0,0,0,4
364,TRIPURA,2004,Student,4,42,0,0,0,46,18,46,0,0,0,64,110
365,TRIPURA,2004,Unemployed,0,73,57,39,5,174,0,41,33,8,0,82,256
366,TRIPURA,2004,Self-employed (Business activity),0,12,11,5,3,31,0,2,0,0,0,2,33
367,TRIPURA,2004,Professional Activity,0,16,11,4,0,31,0,0,0,0,0,0,31
368,TRIPURA,2004,Farming/Agriculture Activity,0,5,7,2,1,15,0,0,0,0,0,0,15
369,TRIPURA,2004,Others (Please Specify),0,22,16,6,2,46,0,3,7,1,2,13,59
370,TRIPURA,2004,Retired Person,0,0,0,0,0,0,0,0,0,0,0,0,0
371,TRIPURA,2004,Others (Please Specify),1,29,21,16,0,67,0,6,8,4,0,18,85
372,TRIPURA,2004,Total,5,204,134,77,13,433,22,183,105,20,7,337,770
373,TRIPURA,2004,Total Salaried,0,5,11,5,2,23,0,0,6,0,0,6,29
374,TRIPURA,2004,Total Self-employed,0,55,45,17,6,123,0,5,7,1,2,15,138
375,UTTAR PRADESH,2004,House Wife,0,0,0,0,0,0,26,643,290,104,27,1090,1090
376,UTTAR PRADESH,2004,Service (Government),0,12,13,5,0,30,0,2,0,0,0,2,32
377,UTTAR PRADESH,2004,Service (Private),0,54,75,23,3,155,0,32,29,12,0,73,228
378,UTTAR PRADESH,2004,Public Sector Undertaking,0,42,26,13,2,83,0,14,14,9,0,37,120
379,UTTAR PRADESH,2004,Student,28,92,8,0,0,128,20,53,0,0,0,73,201
380,UTTAR PRADESH,2004,Unemployed,2,135,103,42,13,295,2,57,27,3,3,92,387
381,UTTAR PRADESH,2004,Self-employed (Business activity),0,38,54,24,1,117,0,3,5,2,0,10,127
382,UTTAR PRADESH,2004,Professional Activity,0,33,26,21,0,80,0,1,5,1,0,7,87
383,UTTAR PRADESH,2004,Farming/Agriculture Activity,8,128,151,93,21,401,0,51,31,9,4,95,496
384,UTTAR PRADESH,2004,Others (Please Specify),19,136,125,76,28,384,8,61,28,35,22,154,538
385,UTTAR PRADESH,2004,Retired Person,0,0,2,2,13,17,0,0,0,1,3,4,21
386,UTTAR PRADESH,2004,Others (Please Specify),28,67,64,56,49,264,11,5,17,8,5,46,310
387,UTTAR PRADESH,2004,Total,85,737,647,355,130,1954,67,922,446,184,64,1683,3637
388,UTTAR PRADESH,2004,Total Salaried,0,108,114,41,5,268,0,48,43,21,0,112,380
389,UTTAR PRADESH,2004,Total Self-employed,27,335,356,214,50,982,8,116,69,47,26,266,1248
390,UTTARAKHAND,2004,House Wife,0,0,0,0,0,0,0,37,18,8,0,63,63
391,UTTARAKHAND,2004,Service (Government),0,0,5,2,0,7,0,0,0,0,0,0,7
392,UTTARAKHAND,2004,Service (Private),0,10,6,2,0,18,0,2,1,0,0,3,21
393,UTTARAKHAND,2004,Public Sector Undertaking,0,0,0,0,0,0,0,0,0,0,0,0,0
394,UTTARAKHAND,2004,Student,1,6,0,0,0,7,0,9,0,0,0,9,16
395,UTTARAKHAND,2004,Unemployed,0,10,10,5,1,26,0,1,0,0,0,1,27
396,UTTARAKHAND,2004,Self-employed (Business activity),0,2,3,3,0,8,0,0,0,0,0,0,8
397,UTTARAKHAND,2004,Professional Activity,0,0,0,0,0,0,0,0,1,0,0,1,1
398,UTTARAKHAND,2004,Farming/Agriculture Activity,0,2,11,4,1,18,0,3,1,0,0,4,22
399,UTTARAKHAND,2004,Others (Please Specify),1,6,8,3,3,21,0,1,0,2,0,3,24
400,UTTARAKHAND,2004,Retired Person,0,0,1,0,0,1,0,0,0,0,0,0,1
401,UTTARAKHAND,2004,Others (Please Specify),6,23,9,2,2,42,2,2,1,0,0,5,47
402,UTTARAKHAND,2004,Total,8,59,53,21,7,148,2,55,22,10,0,89,237
403,UTTARAKHAND,2004,Total Salaried,0,10,11,4,0,25,0,2,1,0,0,3,28
404,UTTARAKHAND,2004,Total Self-employed,1,10,22,10,4,47,0,4,2,2,0,8,55
405,WEST BENGAL,2004,House Wife,0,0,0,0,0,0,0,1577,1224,480,71,3352,3352
406,WEST BENGAL,2004,Service (Government),0,15,65,45,0,125,0,9,11,6,0,26,151
407,WEST BENGAL,2004,Service (Private),0,122,263,212,0,597,0,37,20,20,0,77,674
408,WEST BENGAL,2004,Public Sector Undertaking,0,162,243,246,0,651,0,13,27,26,0,66,717
409,WEST BENGAL,2004,Student,119,318,11,0,0,448,145,212,4,0,0,361,809
410,WEST BENGAL,2004,Unemployed,0,371,270,72,0,713,0,68,74,16,0,158,871
411,WEST BENGAL,2004,Self-employed (Business activity),0,127,271,300,48,746,0,1,20,5,0,26,772
412,WEST BENGAL,2004,Professional Activity,0,71,70,136,9,286,0,2,4,2,1,9,295
413,WEST BENGAL,2004,Farming/Agriculture Activity,0,220,298,250,29,797,2,7,10,6,0,25,822
414,WEST BENGAL,2004,Others (Please Specify),27,357,368,256,107,1115,15,160,126,133,85,519,1634
415,WEST BENGAL,2004,Retired Person,0,0,0,0,218,218,0,0,0,3,10,13,231
416,WEST BENGAL,2004,Others (Please Specify),138,592,691,392,152,1965,127,284,416,219,85,1131,3096
417,WEST BENGAL,2004,Total,284,2355,2550,1909,563,7661,289,2370,1936,916,252,5763,13424
418,WEST BENGAL,2004,Total Salaried,0,299,571,503,0,1373,0,59,58,52,0,169,1542
419,WEST BENGAL,2004,Total Self-employed,27,775,1007,942,193,2944,17,170,160,146,86,579,3523
420,TOTAL (STATES),2004,House Wife,0,0,0,0,0,0,48,10395,7638,3356,1304,22741,22741
421,TOTAL (STATES),2004,Service (Government),0,365,753,433,17,1568,0,96,94,55,0,245,1813
422,TOTAL (STATES),2004,Service (Private),11,1831,2661,1572,209,6284,6,524,392,175,27,1124,7408
423,TOTAL (STATES),2004,Public Sector Undertaking,0,527,728,499,40,1794,0,135,154,82,8,379,2173
424,TOTAL (STATES),2004,Student,633,2227,170,0,0,3030,609,1755,44,1,1,2410,5440
425,TOTAL (STATES),2004,Unemployed,40,2938,2705,1381,428,7492,29,798,476,213,96,1612,9104
426,TOTAL (STATES),2004,Self-employed (Business activity),18,1385,2100,1472,395,5370,3,134,132,71,7,347,5717
427,TOTAL (STATES),2004,Professional Activity,5,695,921,655,142,2418,1,83,83,44,27,238,2656
428,TOTAL (STATES),2004,Farming/Agriculture Activity,26,4050,5947,4091,1672,15786,50,904,762,406,163,2285,18071
429,TOTAL (STATES),2004,Others (Please Specify),160,3978,5289,3954,1647,15028,203,1653,1142,748,408,4154,19182
430,TOTAL (STATES),2004,Retired Person,0,0,28,118,669,815,0,0,0,42,74,116,931
431,TOTAL (STATES),2004,Others (Please Specify),554,3132,4075,2642,1368,11771,475,1600,1327,831,413,4646,16417
432,TOTAL (STATES),2004,Total,1447,21128,25377,16817,6587,71356,1424,18077,12244,6024,2528,40297,111653
433,TOTAL (STATES),2004,Total Salaried,11,2723,4142,2504,266,9646,6,755,640,312,35,1748,11394
434,TOTAL (STATES),2004,Total Self-employed,209,10108,14257,10172,3856,38602,257,2774,2119,1269,605,7024,45626
435,A & N ISLANDS,2004,House Wife,0,0,0,0,0,0,0,10,11,3,1,25,25
436,A & N ISLANDS,2004,Service (Government),0,4,7,7,0,18,0,0,2,0,0,2,20
437,A & N ISLANDS,2004,Service (Private),0,13,13,6,4,36,0,1,0,0,0,1,37
438,A & N ISLANDS,2004,Public Sector Undertaking,0,0,0,0,0,0,0,0,0,0,0,0,0
439,A & N ISLANDS,2004,Student,0,8,0,0,0,8,1,7,0,0,0,8,16
440,A & N ISLANDS,2004,Unemployed,0,0,0,0,0,0,0,1,0,0,0,1,1
441,A & N ISLANDS,2004,Self-employed (Business activity),0,2,2,0,0,4,0,0,0,0,0,0,4
442,A & N ISLANDS,2004,Professional Activity,0,1,0,1,0,2,0,0,0,0,0,0,2
443,A & N ISLANDS,2004,Farming/Agriculture Activity,0,1,0,0,2,3,0,0,0,0,0,0,3
444,A & N ISLANDS,2004,Others (Please Specify),0,0,0,0,0,0,0,1,0,0,0,1,1
445,A & N ISLANDS,2004,Retired Person,0,0,0,0,2,2,0,0,0,0,0,0,2
446,A & N ISLANDS,2004,Others (Please Specify),0,5,2,0,1,8,0,3,0,0,0,3,11
447,A & N ISLANDS,2004,Total,0,34,24,14,9,81,1,23,13,3,1,41,122
448,A & N ISLANDS,2004,Total Salaried,0,17,20,13,4,54,0,1,2,0,0,3,57
449,A & N ISLANDS,2004,Total Self-employed,0,4,2,1,2,9,0,1,0,0,0,1,10
450,CHANDIGARH,2004,House Wife,0,0,0,0,0,0,0,10,2,0,0,12,12
451,CHANDIGARH,2004,Service (Government),0,0,3,0,0,3,0,0,0,1,0,1,4
452,CHANDIGARH,2004,Service (Private),0,6,4,1,0,11,0,0,0,0,0,0,11
453,CHANDIGARH,2004,Public Sector Undertaking,0,0,0,0,0,0,0,0,0,0,0,0,0
454,CHANDIGARH,2004,Student,0,5,0,0,0,5,0,8,0,0,0,8,13
455,CHANDIGARH,2004,Unemployed,0,8,3,1,0,12,0,1,0,0,0,1,13
456,CHANDIGARH,2004,Self-employed (Business activity),0,0,4,0,0,4,0,0,0,0,0,0,4
457,CHANDIGARH,2004,Professional Activity,0,0,0,1,0,1,0,0,0,0,0,0,1
458,CHANDIGARH,2004,Farming/Agriculture Activity,0,0,0,0,0,0,0,0,0,0,0,0,0
459,CHANDIGARH,2004,Others (Please Specify),0,3,5,4,0,12,0,0,0,0,0,0,12
460,CHANDIGARH,2004,Retired Person,0,0,0,0,0,0,0,0,0,0,0,0,0
461,CHANDIGARH,2004,Others (Please Specify),0,1,2,0,1,4,0,0,0,1,0,1,5
462,CHANDIGARH,2004,Total,0,23,21,7,1,52,0,19,2,2,0,23,75
463,CHANDIGARH,2004,Total Salaried,0,6,7,1,0,14,0,0,0,1,0,1,15
464,CHANDIGARH,2004,Total Self-employed,0,3,9,5,0,17,0,0,0,0,0,0,17
465,D & N HAVELI,2004,House Wife,0,0,0,0,0,0,0,9,5,1,1,16,16
466,D & N HAVELI,2004,Service (Government),0,0,0,0,0,0,0,0,0,0,0,0,0
467,D & N HAVELI,2004,Service (Private),0,2,1,1,0,4,0,1,0,0,0,1,5
468,D & N HAVELI,2004,Public Sector Undertaking,0,0,0,0,0,0,0,0,0,0,0,0,0
469,D & N HAVELI,2004,Student,0,0,0,0,0,0,0,2,0,0,0,2,2
470,D & N HAVELI,2004,Unemployed,0,2,1,0,0,3,0,0,0,0,0,0,3
471,D & N HAVELI,2004,Self-employed (Business activity),0,0,1,0,0,1,0,0,0,0,0,0,1
472,D & N HAVELI,2004,Professional Activity,0,0,0,0,0,0,0,0,0,0,0,0,0
473,D & N HAVELI,2004,Farming/Agriculture Activity,0,2,2,2,1,7,0,0,0,0,0,0,7
474,D & N HAVELI,2004,Others (Please Specify),0,1,1,1,2,5,0,0,0,0,0,0,5
475,D & N HAVELI,2004,Retired Person,0,0,0,0,0,0,0,0,0,0,0,0,0
476,D & N HAVELI,2004,Others (Please Specify),0,0,0,0,0,0,0,0,0,0,0,0,0
477,D & N HAVELI,2004,Total,0,7,6,4,3,20,0,12,5,1,1,19,39
478,D & N HAVELI,2004,Total Salaried,0,2,1,1,0,4,0,1,0,0,0,1,5
479,D & N HAVELI,2004,Total Self-employed,0,3,4,3,3,13,0,0,0,0,0,0,13
480,DAMAN & DIU,2004,House Wife,0,0,0,0,0,0,0,5,0,0,0,5,5
481,DAMAN & DIU,2004,Service (Government),0,0,0,0,0,0,0,0,0,0,0,0,0
482,DAMAN & DIU,2004,Service (Private),0,1,0,0,0,1,0,2,0,0,0,2,3
483,DAMAN & DIU,2004,Public Sector Undertaking,0,0,0,0,0,0,0,0,0,0,0,0,0
484,DAMAN & DIU,2004,Student,0,0,0,0,0,0,0,0,0,0,0,0,0
485,DAMAN & DIU,2004,Unemployed,0,0,0,0,0,0,0,0,0,0,0,0,0
486,DAMAN & DIU,2004,Self-employed (Business activity),0,0,0,0,0,0,0,0,0,0,0,0,0
487,DAMAN & DIU,2004,Professional Activity,0,0,0,0,0,0,0,0,0,0,0,0,0
488,DAMAN & DIU,2004,Farming/Agriculture Activity,0,0,1,1,0,2,0,0,0,0,0,0,2
489,DAMAN & DIU,2004,Others (Please Specify),0,0,0,0,0,0,0,0,0,0,0,0,0
490,DAMAN & DIU,2004,Retired Person,0,0,0,0,0,0,0,0,0,0,0,0,0
491,DAMAN & DIU,2004,Others (Please Specify),0,0,2,0,0,2,0,1,0,0,0,1,3
492,DAMAN & DIU,2004,Total,0,1,3,1,0,5,0,8,0,0,0,8,13
493,DAMAN & DIU,2004,Total Salaried,0,1,0,0,0,1,0,2,0,0,0,2,3
494,DAMAN & DIU,2004,Total Self-employed,0,0,1,1,0,2,0,0,0,0,0,0,2
495,DELHI (UT),2004,House Wife,0,0,0,0,0,0,0,158,78,16,14,266,266
496,DELHI (UT),2004,Service (Government),0,1,9,4,0,14,0,0,0,0,0,0,14
497,DELHI (UT),2004,Service (Private),0,88,84,24,3,199,0,4,2,0,0,6,205
498,DELHI (UT),2004,Public Sector Undertaking,0,5,3,2,1,11,0,3,1,0,0,4,15
499,DELHI (UT),2004,Student,15,42,0,0,0,57,12,41,0,0,0,53,110
500,DELHI (UT),2004,Unemployed,2,112,101,33,6,254,1,42,18,3,2,66,320
501,DELHI (UT),2004,Self-employed (Business activity),0,15,9,6,1,31,0,0,0,0,0,0,31
502,DELHI (UT),2004,Professional Activity,0,3,2,0,0,5,0,0,0,0,0,0,5
503,DELHI (UT),2004,Farming/Agriculture Activity,0,1,3,5,3,12,0,0,0,1,0,1,13
504,DELHI (UT),2004,Others (Please Specify),1,55,62,26,4,148,3,22,16,2,0,43,191
505,DELHI (UT),2004,Retired Person,0,0,0,0,2,2,0,0,0,0,0,0,2
506,DELHI (UT),2004,Others (Please Specify),1,20,25,20,0,66,1,13,2,2,0,18,84
507,DELHI (UT),2004,Total,19,342,298,120,20,799,17,283,117,24,16,457,1256
508,DELHI (UT),2004,Total Salaried,0,94,96,30,4,224,0,7,3,0,0,10,234
509,DELHI (UT),2004,Total Self-employed,1,74,76,37,8,196,3,22,16,3,0,44,240
510,LAKSHADWEEP,2004,House Wife,0,0,0,0,0,0,0,0,0,0,0,0,0
511,LAKSHADWEEP,2004,Service (Government),0,0,0,0,0,0,0,0,0,0,0,0,0
512,LAKSHADWEEP,2004,Service (Private),0,0,0,0,0,0,0,0,0,0,0,0,0
513,LAKSHADWEEP,2004,Public Sector Undertaking,0,0,0,0,0,0,0,0,0,0,0,0,0
514,LAKSHADWEEP,2004,Student,0,0,0,0,0,0,0,0,0,0,0,0,0
515,LAKSHADWEEP,2004,Unemployed,0,0,0,0,0,0,0,0,0,0,0,0,0
516,LAKSHADWEEP,2004,Self-employed (Business activity),0,0,0,0,0,0,0,0,0,0,0,0,0
517,LAKSHADWEEP,2004,Professional Activity,0,0,0,0,0,0,0,0,0,0,0,0,0
518,LAKSHADWEEP,2004,Farming/Agriculture Activity,0,0,0,0,0,0,0,0,0,0,0,0,0
519,LAKSHADWEEP,2004,Others (Please Specify),0,0,0,0,0,0,0,0,0,0,0,0,0
520,LAKSHADWEEP,2004,Retired Person,0,0,0,0,0,0,0,0,0,0,0,0,0
521,LAKSHADWEEP,2004,Others (Please Specify),0,0,0,0,0,0,0,0,0,0,0,0,0
522,LAKSHADWEEP,2004,Total,0,0,0,0,0,0,0,0,0,0,0,0,0
523,LAKSHADWEEP,2004,Total Salaried,0,0,0,0,0,0,0,0,0,0,0,0,0
524,LAKSHADWEEP,2004,Total Self-employed,0,0,0,0,0,0,0,0,0,0,0,0,0
525,PUDUCHERRY,2004,House Wife,0,0,0,0,0,0,0,38,45,14,8,105,105
526,PUDUCHERRY,2004,Service (Government),0,1,7,11,0,19,0,2,0,2,0,4,23
527,PUDUCHERRY,2004,Service (Private),0,13,10,5,0,28,0,3,0,0,0,3,31
528,PUDUCHERRY,2004,Public Sector Undertaking,0,0,0,0,0,0,0,0,0,0,0,0,0
529,PUDUCHERRY,2004,Student,1,7,0,0,0,8,4,17,0,0,0,21,29
530,PUDUCHERRY,2004,Unemployed,0,21,9,9,19,58,0,26,6,2,5,39,97
531,PUDUCHERRY,2004,Self-employed (Business activity),0,3,8,8,0,19,0,0,1,0,0,1,20
532,PUDUCHERRY,2004,Professional Activity,0,7,13,3,2,25,0,0,0,0,0,0,25
533,PUDUCHERRY,2004,Farming/Agriculture Activity,0,21,44,48,6,119,0,11,11,2,2,26,145
534,PUDUCHERRY,2004,Others (Please Specify),0,1,5,6,1,13,0,0,1,0,0,1,14
535,PUDUCHERRY,2004,Retired Person,0,0,0,2,2,4,0,0,0,0,0,0,4
536,PUDUCHERRY,2004,Others (Please Specify),0,8,25,10,2,45,0,0,1,0,0,1,46
537,PUDUCHERRY,2004,Total,1,82,121,102,32,338,4,97,65,20,15,201,539
538,PUDUCHERRY,2004,Total Salaried,0,14,17,16,0,47,0,5,0,2,0,7,54
539,PUDUCHERRY,2004,Total Self-employed,0,32,70,65,9,176,0,11,13,2,2,28,204
540,TOTAL (UTs),2004,House Wife,0,0,0,0,0,0,0,230,141,34,24,429,429
541,TOTAL (UTs),2004,Service (Government),0,6,26,22,0,54,0,2,2,3,0,7,61
542,TOTAL (UTs),2004,Service (Private),0,123,112,37,7,279,0,11,2,0,0,13,292
543,TOTAL (UTs),2004,Public Sector Undertaking,0,5,3,2,1,11,0,3,1,0,0,4,15
544,TOTAL (UTs),2004,Student,16,62,0,0,0,78,17,75,0,0,0,92,170
545,TOTAL (UTs),2004,Unemployed,2,143,114,43,25,327,1,70,24,5,7,107,434
546,TOTAL (UTs),2004,Self-employed (Business activity),0,20,24,14,1,59,0,0,1,0,0,1,60
547,TOTAL (UTs),2004,Professional Activity,0,11,15,5,2,33,0,0,0,0,0,0,33
548,TOTAL (UTs),2004,Farming/Agriculture Activity,0,25,50,56,12,143,0,11,11,3,2,27,170
549,TOTAL (UTs),2004,Others (Please Specify),1,60,73,37,7,178,3,23,17,2,0,45,223
550,TOTAL (UTs),2004,Retired Person,0,0,0,2,6,8,0,0,0,0,0,0,8
551,TOTAL (UTs),2004,Others (Please Specify),1,34,56,30,4,125,1,17,3,3,0,24,149
552,TOTAL (UTs),2004,Total,20,489,473,248,65,1295,22,442,202,50,33,749,2044
553,TOTAL (UTs),2004,Total Salaried,0,134,141,61,8,344,0,16,5,3,0,24,368
554,TOTAL (UTs),2004,Total Self-employed,1,116,162,112,22,413,3,34,29,5,2,73,486
555,TOTAL (ALL INDIA),2004,House Wife,0,0,0,0,0,0,48,10625,7779,3390,1328,23170,23170
556,TOTAL (ALL INDIA),2004,Service (Government),0,371,779,455,17,1622,0,98,96,58,0,252,1874
557,TOTAL (ALL INDIA),2004,Service (Private),11,1954,2773,1609,216,6563,6,535,394,175,27,1137,7700
558,TOTAL (ALL INDIA),2004,Public Sector Undertaking,0,532,731,501,41,1805,0,138,155,82,8,383,2188
559,TOTAL (ALL INDIA),2004,Student,649,2289,170,0,0,3108,626,1830,44,1,1,2502,5610
560,TOTAL (ALL INDIA),2004,Unemployed,42,3081,2819,1424,453,7819,30,868,500,218,103,1719,9538
561,TOTAL (ALL INDIA),2004,Self-employed (Business activity),18,1405,2124,1486,396,5429,3,134,133,71,7,348,5777
562,TOTAL (ALL INDIA),2004,Professional Activity,5,706,936,660,144,2451,1,83,83,44,27,238,2689
563,TOTAL (ALL INDIA),2004,Farming/Agriculture Activity,26,4075,5997,4147,1684,15929,50,915,773,409,165,2312,18241
564,TOTAL (ALL INDIA),2004,Others (Please Specify),161,4038,5362,3991,1654,15206,206,1676,1159,750,408,4199,19405
565,TOTAL (ALL INDIA),2004,Retired Person,0,0,28,120,675,823,0,0,0,42,74,116,939
566,TOTAL (ALL INDIA),2004,Others (Please Specify),555,3166,4131,2672,1372,11896,476,1617,1330,834,413,4670,16566
567,TOTAL (ALL INDIA),2004,Total,1467,21617,25850,17065,6652,72651,1446,18519,12446,6074,2561,41046,113697
568,TOTAL (ALL INDIA),2004,Total Salaried,11,2857,4283,2565,274,9990,6,771,645,315,35,1772,11762
569,TOTAL (ALL INDIA),2004,Total Self-employed,210,10224,14419,10284,3878,39015,260,2808,2148,1274,607,7097,46112
0,ANDHRA PRADESH,2005,House Wife,0,0,0,0,0,0,0,932,693,382,172,2179,2179
1,ANDHRA PRADESH,2005,Service (Government),0,10,43,57,0,110,0,6,24,0,0,30,140
2,ANDHRA PRADESH,2005,Service (Private),2,213,286,161,37,699,0,69,39,18,5,131,830
3,ANDHRA PRADESH,2005,Public Sector Undertaking,0,42,109,80,2,233,0,5,36,3,0,44,277
4,ANDHRA PRADESH,2005,Student,53,197,24,0,0,274,65,155,6,0,0,226,500
5,ANDHRA PRADESH,2005,Unemployed,1,169,160,52,48,430,0,70,10,0,0,80,510
6,ANDHRA PRADESH,2005,Self-employed (Business activity),2,238,304,244,94,882,0,53,31,27,4,115,997
7,ANDHRA PRADESH,2005,Professional Activity,0,37,61,43,41,182,1,26,8,3,0,38,220
8,ANDHRA PRADESH,2005,Farming/Agriculture Activity,6,481,729,578,223,2017,22,127,174,85,65,473,2490
9,ANDHRA PRADESH,2005,Others (Please Specify),25,357,443,256,168,1249,23,208,138,70,29,468,1717
10,ANDHRA PRADESH,2005,Retired Person,0,2,0,35,20,57,0,1,0,1,1,3,60
11,ANDHRA PRADESH,2005,Others (Please Specify),54,698,1019,650,311,2732,50,252,201,144,143,790,3522
12,ANDHRA PRADESH,2005,Total,143,2444,3178,2156,944,8865,161,1904,1360,733,419,4577,13442
13,ANDHRA PRADESH,2005,Total Salaried,2,265,438,298,39,1042,0,80,99,21,5,205,1247
14,ANDHRA PRADESH,2005,Total Self-employed,33,1113,1537,1121,526,4330,46,414,351,185,98,1094,5424
15,ARUNACHAL PRADESH,2005,House Wife,0,0,0,0,0,0,0,1,6,1,1,9,9
16,ARUNACHAL PRADESH,2005,Service (Government),0,0,3,0,0,3,0,1,0,0,0,1,4
17,ARUNACHAL PRADESH,2005,Service (Private),0,0,4,0,0,4,0,0,1,0,0,1,5
18,ARUNACHAL PRADESH,2005,Public Sector Undertaking,0,0,0,0,0,0,0,0,0,0,0,0,0
19,ARUNACHAL PRADESH,2005,Student,0,1,0,0,0,1,0,1,0,0,0,1,2
20,ARUNACHAL PRADESH,2005,Unemployed,0,1,2,1,0,4,0,1,0,0,0,1,5
21,ARUNACHAL PRADESH,2005,Self-employed (Business activity),0,5,11,1,1,18,0,1,0,0,0,1,19
22,ARUNACHAL PRADESH,2005,Professional Activity,0,1,0,0,0,1,0,0,0,0,0,0,1
23,ARUNACHAL PRADESH,2005,Farming/Agriculture Activity,0,5,8,2,3,18,0,5,2,0,0,7,25
24,ARUNACHAL PRADESH,2005,Others (Please Specify),0,0,0,0,0,0,0,0,0,0,0,0,0
25,ARUNACHAL PRADESH,2005,Retired Person,0,0,0,0,0,0,0,0,0,0,0,0,0
26,ARUNACHAL PRADESH,2005,Others (Please Specify),0,0,0,0,0,0,0,0,0,0,0,0,0
27,ARUNACHAL PRADESH,2005,Total,0,13,28,4,4,49,0,10,9,1,1,21,70
28,ARUNACHAL PRADESH,2005,Total Salaried,0,0,7,0,0,7,0,1,1,0,0,2,9
29,ARUNACHAL PRADESH,2005,Total Self-employed,0,11,19,3,4,37,0,6,2,0,0,8,45
30,ASSAM,2005,House Wife,0,0,0,0,0,0,0,281,206,76,3,566,566
31,ASSAM,2005,Service (Government),0,2,6,6,0,14,0,0,0,0,0,0,14
32,ASSAM,2005,Service (Private),0,17,17,9,0,43,0,8,2,0,0,10,53
33,ASSAM,2005,Public Sector Undertaking,0,20,17,19,0,56,0,4,0,0,0,4,60
34,ASSAM,2005,Student,16,87,0,0,0,103,18,33,0,0,0,51,154
35,ASSAM,2005,Unemployed,0,5,40,33,9,87,0,0,8,1,0,9,96
36,ASSAM,2005,Self-employed (Business activity),0,112,164,72,2,350,0,14,13,1,1,29,379
37,ASSAM,2005,Professional Activity,0,15,32,19,0,66,0,0,0,0,3,3,69
38,ASSAM,2005,Farming/Agriculture Activity,0,60,117,65,14,256,2,16,16,9,0,43,299
39,ASSAM,2005,Others (Please Specify),11,260,292,119,21,703,11,46,43,19,5,124,827
40,ASSAM,2005,Retired Person,0,0,0,3,6,9,0,0,0,0,2,2,11
41,ASSAM,2005,Others (Please Specify),9,65,106,63,21,264,6,23,11,10,4,54,318
42,ASSAM,2005,Total,36,643,791,408,73,1951,37,425,299,116,18,895,2846
43,ASSAM,2005,Total Salaried,0,39,40,34,0,113,0,12,2,0,0,14,127
44,ASSAM,2005,Total Self-employed,11,447,605,275,37,1375,13,76,72,29,9,199,1574
45,BIHAR,2005,House Wife,0,0,0,0,0,0,0,55,38,11,5,109,109
46,BIHAR,2005,Service (Government),0,0,3,2,0,5,0,1,0,0,0,1,6
47,BIHAR,2005,Service (Private),0,12,15,7,0,34,0,0,2,0,0,2,36
48,BIHAR,2005,Public Sector Undertaking,0,1,3,5,0,9,0,0,0,0,0,0,9
49,BIHAR,2005,Student,7,24,2,0,0,33,3,5,6,0,0,14,47
50,BIHAR,2005,Unemployed,0,11,5,4,3,23,0,5,0,0,0,5,28
51,BIHAR,2005,Self-employed (Business activity),0,7,6,4,1,18,0,0,0,0,0,0,18
52,BIHAR,2005,Professional Activity,0,8,7,4,0,19,0,0,0,0,0,0,19
53,BIHAR,2005,Farming/Agriculture Activity,1,5,17,8,1,32,0,3,2,2,0,7,39
54,BIHAR,2005,Others (Please Specify),1,11,9,1,0,22,0,5,2,2,0,9,31
55,BIHAR,2005,Retired Person,0,0,0,1,1,2,0,1,1,0,0,2,4
56,BIHAR,2005,Others (Please Specify),5,44,39,34,8,130,2,29,26,8,2,67,197
57,BIHAR,2005,Total,14,123,106,70,14,327,5,104,77,23,7,216,543
58,BIHAR,2005,Total Salaried,0,13,21,14,0,48,0,1,2,0,0,3,51
59,BIHAR,2005,Total Self-employed,2,31,39,17,2,91,0,8,4,4,0,16,107
60,CHHATTISGARH,2005,House Wife,0,0,0,0,0,0,8,433,283,115,52,891,891
61,CHHATTISGARH,2005,Service (Government),0,27,18,12,1,58,0,3,1,1,1,6,64
62,CHHATTISGARH,2005,Service (Private),14,48,64,44,8,178,2,6,7,2,0,17,195
63,CHHATTISGARH,2005,Public Sector Undertaking,0,20,11,2,0,33,0,9,3,3,0,15,48
64,CHHATTISGARH,2005,Student,19,91,6,0,0,116,21,46,5,0,0,72,188
65,CHHATTISGARH,2005,Unemployed,17,139,50,17,5,228,3,10,7,4,1,25,253
66,CHHATTISGARH,2005,Self-employed (Business activity),13,36,43,43,12,147,1,13,7,5,1,27,174
67,CHHATTISGARH,2005,Professional Activity,13,33,50,27,8,131,1,4,2,2,0,9,140
68,CHHATTISGARH,2005,Farming/Agriculture Activity,6,301,490,309,94,1200,0,81,76,44,11,212,1412
69,CHHATTISGARH,2005,Others (Please Specify),24,83,180,82,41,410,8,41,42,15,11,117,527
70,CHHATTISGARH,2005,Retired Person,0,7,1,0,3,11,0,0,0,0,1,1,12
71,CHHATTISGARH,2005,Others (Please Specify),54,277,261,140,61,793,29,96,32,18,9,184,977
72,CHHATTISGARH,2005,Total,160,1062,1174,676,233,3305,73,742,465,209,87,1576,4881
73,CHHATTISGARH,2005,Total Salaried,14,95,93,58,9,269,2,18,11,6,1,38,307
74,CHHATTISGARH,2005,Total Self-employed,56,453,763,461,155,1888,10,139,127,66,23,365,2253
75,GOA,2005,House Wife,0,0,0,0,0,0,0,18,8,13,8,47,47
76,GOA,2005,Service (Government),0,2,3,2,0,7,0,0,0,0,0,0,7
77,GOA,2005,Service (Private),0,13,25,8,0,46,0,4,2,0,0,6,52
78,GOA,2005,Public Sector Undertaking,0,2,3,1,0,6,0,0,0,0,0,0,6
79,GOA,2005,Student,2,6,0,0,0,8,1,6,0,0,0,7,15
80,GOA,2005,Unemployed,0,15,17,8,5,45,0,10,1,1,1,13,58
81,GOA,2005,Self-employed (Business activity),0,2,3,3,0,8,0,0,1,0,0,1,9
82,GOA,2005,Professional Activity,0,1,0,0,0,1,0,0,0,0,0,0,1
83,GOA,2005,Farming/Agriculture Activity,0,0,4,2,4,10,0,0,0,0,1,1,11
84,GOA,2005,Others (Please Specify),0,2,7,2,2,13,0,0,1,0,0,1,14
85,GOA,2005,Retired Person,0,0,0,3,1,4,0,0,0,0,1,1,5
86,GOA,2005,Others (Please Specify),0,11,23,11,4,49,1,4,2,1,0,8,57
87,GOA,2005,Total,2,54,85,40,16,197,2,42,15,15,11,85,282
88,GOA,2005,Total Salaried,0,17,31,11,0,59,0,4,2,0,0,6,65
89,GOA,2005,Total Self-employed,0,5,14,7,6,32,0,0,2,0,1,3,35
90,GUJARAT,2005,House Wife,0,0,0,0,0,0,0,548,498,203,71,1320,1320
91,GUJARAT,2005,Service (Government),0,21,35,17,0,73,0,1,1,2,0,4,77
92,GUJARAT,2005,Service (Private),0,135,191,97,5,428,0,32,19,5,0,56,484
93,GUJARAT,2005,Public Sector Undertaking,0,18,33,16,0,67,0,2,1,0,0,3,70
94,GUJARAT,2005,Student,16,82,7,0,0,105,21,99,0,0,0,120,225
95,GUJARAT,2005,Unemployed,1,151,140,75,5,372,1,26,8,3,2,40,412
96,GUJARAT,2005,Self-employed (Business activity),0,84,108,59,16,267,0,1,0,0,1,2,269
97,GUJARAT,2005,Professional Activity,0,120,115,68,17,320,0,10,3,0,0,13,333
98,GUJARAT,2005,Farming/Agriculture Activity,0,159,182,136,42,519,2,45,29,16,4,96,615
99,GUJARAT,2005,Others (Please Specify),3,139,173,67,10,392,2,34,18,9,5,68,460
100,GUJARAT,2005,Retired Person,0,0,1,35,68,104,0,0,0,5,23,28,132
101,GUJARAT,2005,Others (Please Specify),5,71,97,53,29,255,7,53,24,16,13,113,368
102,GUJARAT,2005,Total,25,980,1082,623,192,2902,33,851,601,259,119,1863,4765
103,GUJARAT,2005,Total Salaried,0,174,259,130,5,568,0,35,21,7,0,63,631
104,GUJARAT,2005,Total Self-employed,3,502,578,330,85,1498,4,90,50,25,10,179,1677
105,HARYANA,2005,House Wife,0,0,0,0,0,0,2,119,125,49,8,303,303
106,HARYANA,2005,Service (Government),0,14,16,7,0,37,0,1,5,0,0,6,43
107,HARYANA,2005,Service (Private),0,72,48,24,0,144,1,6,3,1,0,11,155
108,HARYANA,2005,Public Sector Undertaking,0,4,10,1,0,15,0,3,2,0,0,5,20
109,HARYANA,2005,Student,7,57,3,0,0,67,6,25,3,0,0,34,101
110,HARYANA,2005,Unemployed,5,64,54,17,6,146,0,7,4,1,1,13,159
111,HARYANA,2005,Self-employed (Business activity),0,10,38,15,8,71,0,0,0,0,0,0,71
112,HARYANA,2005,Professional Activity,0,6,11,0,1,18,1,0,0,0,0,1,19
113,HARYANA,2005,Farming/Agriculture Activity,1,37,57,23,10,128,2,6,2,2,0,12,140
114,HARYANA,2005,Others (Please Specify),5,83,68,34,12,202,2,11,3,3,0,19,221
115,HARYANA,2005,Retired Person,0,0,6,4,1,11,0,0,2,2,1,5,16
116,HARYANA,2005,Others (Please Specify),10,163,297,149,35,654,1,79,38,18,8,144,798
117,HARYANA,2005,Total,28,510,608,274,73,1493,15,257,187,76,18,553,2046
118,HARYANA,2005,Total Salaried,0,90,74,32,0,196,1,10,10,1,0,22,218
119,HARYANA,2005,Total Self-employed,6,136,174,72,31,419,5,17,5,5,0,32,451
120,HIMACHAL PRADESH,2005,House Wife,0,0,0,0,0,0,0,41,26,8,0,75,75
121,HIMACHAL PRADESH,2005,Service (Government),0,1,9,4,0,14,0,1,1,0,0,2,16
122,HIMACHAL PRADESH,2005,Service (Private),0,10,14,4,1,29,0,0,0,0,0,0,29
123,HIMACHAL PRADESH,2005,Public Sector Undertaking,0,1,5,1,0,7,0,1,0,0,0,1,8
124,HIMACHAL PRADESH,2005,Student,0,9,1,0,0,10,1,14,0,0,0,15,25
125,HIMACHAL PRADESH,2005,Unemployed,0,9,9,1,0,19,0,5,3,0,0,8,27
126,HIMACHAL PRADESH,2005,Self-employed (Business activity),0,2,3,2,0,7,0,0,0,0,0,0,7
127,HIMACHAL PRADESH,2005,Professional Activity,0,1,3,0,0,4,0,0,0,0,0,0,4
128,HIMACHAL PRADESH,2005,Farming/Agriculture Activity,0,8,3,7,2,20,0,0,0,0,0,0,20
129,HIMACHAL PRADESH,2005,Others (Please Specify),0,12,24,16,12,64,0,4,6,4,1,15,79
130,HIMACHAL PRADESH,2005,Retired Person,0,0,0,0,0,0,0,0,0,0,0,0,0
131,HIMACHAL PRADESH,2005,Others (Please Specify),2,16,15,7,0,40,0,15,11,1,2,29,69
132,HIMACHAL PRADESH,2005,Total,2,69,86,42,15,214,1,81,47,13,3,145,359
133,HIMACHAL PRADESH,2005,Total Salaried,0,12,28,9,1,50,0,2,1,0,0,3,53
134,HIMACHAL PRADESH,2005,Total Self-employed,0,23,33,25,14,95,0,4,6,4,1,15,110
135,JAMMU & KASHMIR,2005,House Wife,0,0,0,0,0,0,0,17,14,1,0,32,32
136,JAMMU & KASHMIR,2005,Service (Government),0,14,4,0,0,18,0,0,0,0,0,0,18
137,JAMMU & KASHMIR,2005,Service (Private),0,23,11,0,0,34,0,0,0,0,0,0,34
138,JAMMU & KASHMIR,2005,Public Sector Undertaking,0,0,0,0,0,0,0,0,0,0,0,0,0
139,JAMMU & KASHMIR,2005,Student,1,14,5,0,0,20,1,3,0,0,0,4,24
140,JAMMU & KASHMIR,2005,Unemployed,0,18,8,1,0,27,0,3,10,0,0,13,40
141,JAMMU & KASHMIR,2005,Self-employed (Business activity),0,0,0,0,0,0,0,0,0,0,0,0,0
142,JAMMU & KASHMIR,2005,Professional Activity,0,0,0,0,0,0,0,0,0,0,0,0,0
143,JAMMU & KASHMIR,2005,Farming/Agriculture Activity,0,1,0,0,0,1,0,1,0,0,0,1,2
144,JAMMU & KASHMIR,2005,Others (Please Specify),0,19,9,5,0,33,0,17,9,0,2,28,61
145,JAMMU & KASHMIR,2005,Retired Person,0,6,0,1,0,7,0,0,0,0,0,0,7
146,JAMMU & KASHMIR,2005,Others (Please Specify),2,18,22,10,4,56,3,13,3,0,1,20,76
147,JAMMU & KASHMIR,2005,Total,3,113,59,17,4,196,4,54,36,1,3,98,294
148,JAMMU & KASHMIR,2005,Total Salaried,0,37,15,0,0,52,0,0,0,0,0,0,52
149,JAMMU & KASHMIR,2005,Total Self-employed,0,20,9,5,0,34,0,18,9,0,2,29,63
150,JHARKHAND,2005,House Wife,0,0,0,0,0,0,0,57,76,22,3,158,158
151,JHARKHAND,2005,Service (Government),0,0,4,5,0,9,0,1,1,0,0,2,11
152,JHARKHAND,2005,Service (Private),0,14,13,6,0,33,0,0,9,0,0,9,42
153,JHARKHAND,2005,Public Sector Undertaking,0,2,3,0,0,5,0,1,0,0,0,1,6
154,JHARKHAND,2005,Student,2,53,14,0,0,69,6,14,9,0,0,29,98
155,JHARKHAND,2005,Unemployed,0,20,6,0,0,26,0,8,14,0,0,22,48
156,JHARKHAND,2005,Self-employed (Business activity),0,5,14,14,0,33,0,0,0,1,0,1,34
157,JHARKHAND,2005,Professional Activity,0,0,4,5,0,9,0,0,0,0,0,0,9
158,JHARKHAND,2005,Farming/Agriculture Activity,0,38,56,29,1,124,0,0,0,0,0,0,124
159,JHARKHAND,2005,Others (Please Specify),2,21,24,8,0,55,5,16,9,4,1,35,90
160,JHARKHAND,2005,Retired Person,0,0,0,0,3,3,0,0,0,0,0,0,3
161,JHARKHAND,2005,Others (Please Specify),4,28,49,66,10,157,2,15,10,1,0,28,185
162,JHARKHAND,2005,Total,8,181,187,133,14,523,13,112,128,28,4,285,808
163,JHARKHAND,2005,Total Salaried,0,16,20,11,0,47,0,2,10,0,0,12,59
164,JHARKHAND,2005,Total Self-employed,2,64,98,56,1,221,5,16,9,5,1,36,257
165,KARNATAKA,2005,House Wife,0,0,0,0,0,0,4,816,658,280,116,1874,1874
166,KARNATAKA,2005,Service (Government),0,32,41,66,0,139,0,9,7,5,0,21,160
167,KARNATAKA,2005,Service (Private),1,342,295,235,16,889,1,54,35,24,10,124,1013
168,KARNATAKA,2005,Public Sector Undertaking,0,57,60,56,11,184,0,11,13,10,0,34,218
169,KARNATAKA,2005,Student,35,137,15,2,0,189,32,134,13,0,0,179,368
170,KARNATAKA,2005,Unemployed,3,192,117,68,23,403,0,34,20,8,4,66,469
171,KARNATAKA,2005,Self-employed (Business activity),1,118,168,101,14,402,0,9,23,14,0,46,448
172,KARNATAKA,2005,Professional Activity,1,59,96,69,17,242,2,3,3,21,7,36,278
173,KARNATAKA,2005,Farming/Agriculture Activity,4,350,691,422,196,1663,0,58,91,61,10,220,1883
174,KARNATAKA,2005,Others (Please Specify),12,511,605,440,214,1782,6,208,126,94,57,491,2273
175,KARNATAKA,2005,Retired Person,0,1,2,8,24,35,0,2,0,3,0,5,40
176,KARNATAKA,2005,Others (Please Specify),47,462,601,485,184,1779,42,276,237,131,68,754,2533
177,KARNATAKA,2005,Total,104,2261,2691,1952,699,7707,87,1614,1226,651,272,3850,11557
178,KARNATAKA,2005,Total Salaried,1,431,396,357,27,1212,1,74,55,39,10,179,1391
179,KARNATAKA,2005,Total Self-employed,18,1038,1560,1032,441,4089,8,278,243,190,74,793,4882
180,KERALA,2005,House Wife,0,0,0,0,0,0,0,305,421,390,297,1413,1413
181,KERALA,2005,Service (Government),0,1,30,36,0,67,0,4,6,8,0,18,85
182,KERALA,2005,Service (Private),0,45,131,82,15,273,0,24,14,9,2,49,322
183,KERALA,2005,Public Sector Undertaking,0,6,17,23,0,46,0,6,1,3,0,10,56
184,KERALA,2005,Student,40,100,0,0,0,140,40,100,1,0,0,141,281
185,KERALA,2005,Unemployed,0,268,355,228,129,980,1,114,58,33,35,241,1221
186,KERALA,2005,Self-employed (Business activity),0,37,148,172,38,395,0,3,1,1,0,5,400
187,KERALA,2005,Professional Activity,0,31,65,48,7,151,0,7,3,1,0,11,162
188,KERALA,2005,Farming/Agriculture Activity,0,89,337,383,264,1073,1,3,17,17,7,45,1118
189,KERALA,2005,Others (Please Specify),1,453,699,815,469,2437,2,77,75,86,72,312,2749
190,KERALA,2005,Retired Person,0,0,0,31,61,92,0,0,1,1,10,12,104
191,KERALA,2005,Others (Please Specify),5,208,337,389,237,1176,6,47,34,27,43,157,1333
192,KERALA,2005,Total,46,1238,2119,2207,1220,6830,50,690,632,576,466,2414,9244
193,KERALA,2005,Total Salaried,0,52,178,141,15,386,0,34,21,20,2,77,463
194,KERALA,2005,Total Self-employed,1,610,1249,1418,778,4056,3,90,96,105,79,373,4429
195,MADHYA PRADESH,2005,House Wife,0,0,0,0,0,0,0,1114,523,178,77,1892,1892
196,MADHYA PRADESH,2005,Service (Government),0,7,19,17,0,43,0,6,4,1,0,11,54
197,MADHYA PRADESH,2005,Service (Private),0,73,64,26,5,168,0,40,5,1,1,47,215
198,MADHYA PRADESH,2005,Public Sector Undertaking,0,44,33,10,5,92,0,16,14,1,0,31,123
199,MADHYA PRADESH,2005,Student,34,95,1,0,0,130,18,51,0,0,0,69,199
200,MADHYA PRADESH,2005,Unemployed,0,108,62,36,6,212,0,17,8,2,0,27,239
201,MADHYA PRADESH,2005,Self-employed (Business activity),3,60,66,35,10,174,0,18,5,1,0,24,198
202,MADHYA PRADESH,2005,Professional Activity,2,30,77,19,3,131,0,17,4,6,3,30,161
203,MADHYA PRADESH,2005,Farming/Agriculture Activity,7,452,333,177,86,1055,4,108,64,12,5,193,1248
204,MADHYA PRADESH,2005,Others (Please Specify),15,193,236,104,68,616,26,96,36,9,9,176,792
205,MADHYA PRADESH,2005,Retired Person,0,0,0,0,8,8,0,0,0,0,0,0,8
206,MADHYA PRADESH,2005,Others (Please Specify),22,62,58,48,32,222,30,44,21,1,1,97,319
207,MADHYA PRADESH,2005,Total,83,1124,949,472,223,2851,78,1527,684,212,96,2597,5448
208,MADHYA PRADESH,2005,Total Salaried,0,124,116,53,10,303,0,62,23,3,1,89,392
209,MADHYA PRADESH,2005,Total Self-employed,27,735,712,335,167,1976,30,239,109,28,17,423,2399
210,MAHARASHTRA,2005,House Wife,0,0,0,0,0,0,3,1857,1084,409,229,3582,3582
211,MAHARASHTRA,2005,Service (Government),0,36,122,102,0,260,0,18,18,4,0,40,300
212,MAHARASHTRA,2005,Service (Private),0,456,650,340,39,1485,1,78,34,6,2,121,1606
213,MAHARASHTRA,2005,Public Sector Undertaking,0,30,39,33,3,105,0,9,3,1,0,13,118
214,MAHARASHTRA,2005,Student,53,346,3,0,0,402,55,327,0,0,0,382,784
215,MAHARASHTRA,2005,Unemployed,0,459,368,121,2,950,0,63,13,3,0,79,1029
216,MAHARASHTRA,2005,Self-employed (Business activity),0,98,188,81,17,384,0,4,1,1,0,6,390
217,MAHARASHTRA,2005,Professional Activity,0,97,151,102,27,377,0,7,2,4,3,16,393
218,MAHARASHTRA,2005,Farming/Agriculture Activity,4,826,1433,908,467,3638,2,127,76,58,25,288,3926
219,MAHARASHTRA,2005,Others (Please Specify),17,501,625,373,251,1767,15,117,57,59,19,267,2034
220,MAHARASHTRA,2005,Retired Person,0,0,0,15,99,114,0,0,0,1,6,7,121
221,MAHARASHTRA,2005,Others (Please Specify),1,28,52,26,14,121,3,6,8,3,2,22,143
222,MAHARASHTRA,2005,Total,75,2877,3631,2101,919,9603,79,2613,1296,549,286,4823,14426
223,MAHARASHTRA,2005,Total Salaried,0,522,811,475,42,1850,1,105,55,11,2,174,2024
224,MAHARASHTRA,2005,Total Self-employed,21,1522,2397,1464,762,6166,17,255,136,122,47,577,6743
225,MANIPUR,2005,House Wife,0,0,0,0,0,0,0,0,2,0,0,2,2
226,MANIPUR,2005,Service (Government),0,1,7,0,0,8,0,0,0,0,0,0,8
227,MANIPUR,2005,Service (Private),0,0,0,0,0,0,0,0,0,0,0,0,0
228,MANIPUR,2005,Public Sector Undertaking,0,0,0,0,0,0,0,0,0,0,0,0,0
229,MANIPUR,2005,Student,0,1,0,0,0,1,0,1,0,0,0,1,2
230,MANIPUR,2005,Unemployed,0,0,0,0,0,0,0,0,0,0,0,0,0
231,MANIPUR,2005,Self-employed (Business activity),0,1,2,1,0,4,0,0,0,0,0,0,4
232,MANIPUR,2005,Professional Activity,0,0,0,0,0,0,0,0,0,0,0,0,0
233,MANIPUR,2005,Farming/Agriculture Activity,0,0,2,0,0,2,0,0,0,0,0,0,2
234,MANIPUR,2005,Others (Please Specify),0,1,5,0,0,6,0,0,0,0,0,0,6
235,MANIPUR,2005,Retired Person,0,0,0,0,0,0,0,0,0,0,0,0,0
236,MANIPUR,2005,Others (Please Specify),0,1,1,0,0,2,0,1,0,0,0,1,3
237,MANIPUR,2005,Total,0,5,17,1,0,23,0,2,2,0,0,4,27
238,MANIPUR,2005,Total Salaried,0,1,7,0,0,8,0,0,0,0,0,0,8
239,MANIPUR,2005,Total Self-employed,0,2,9,1,0,12,0,0,0,0,0,0,12
240,MEGHALAYA,2005,House Wife,0,0,0,0,0,0,0,6,3,2,0,11,11
241,MEGHALAYA,2005,Service (Government),0,0,1,0,0,1,0,0,0,0,0,0,1
242,MEGHALAYA,2005,Service (Private),0,0,2,1,0,3,0,0,0,0,0,0,3
243,MEGHALAYA,2005,Public Sector Undertaking,0,0,0,1,0,1,0,0,0,0,0,0,1
244,MEGHALAYA,2005,Student,2,4,0,0,0,6,0,5,0,0,0,5,11
245,MEGHALAYA,2005,Unemployed,1,6,5,2,1,15,0,2,2,0,0,4,19
246,MEGHALAYA,2005,Self-employed (Business activity),0,2,1,0,0,3,0,0,0,0,0,0,3
247,MEGHALAYA,2005,Professional Activity,0,0,0,0,0,0,0,0,0,0,0,0,0
248,MEGHALAYA,2005,Farming/Agriculture Activity,0,1,2,0,1,4,0,0,0,0,0,0,4
249,MEGHALAYA,2005,Others (Please Specify),0,1,3,5,1,10,0,0,0,0,0,0,10
250,MEGHALAYA,2005,Retired Person,0,0,0,1,4,5,0,0,0,0,0,0,5
251,MEGHALAYA,2005,Others (Please Specify),0,2,0,0,0,2,0,0,0,0,1,1,3
252,MEGHALAYA,2005,Total,3,16,14,10,7,50,0,13,5,2,1,21,71
253,MEGHALAYA,2005,Total Salaried,0,0,3,2,0,5,0,0,0,0,0,0,5
254,MEGHALAYA,2005,Total Self-employed,0,4,6,5,2,17,0,0,0,0,0,0,17
255,MIZORAM,2005,House Wife,0,0,0,0,0,0,0,0,2,1,0,3,3
256,MIZORAM,2005,Service (Government),0,1,3,0,0,4,0,0,0,0,0,0,4
257,MIZORAM,2005,Service (Private),0,0,1,0,0,1,0,0,0,0,0,0,1
258,MIZORAM,2005,Public Sector Undertaking,0,0,0,0,0,0,0,0,0,0,0,0,0
259,MIZORAM,2005,Student,0,0,0,0,0,0,0,0,0,0,0,0,0
260,MIZORAM,2005,Unemployed,0,8,5,0,0,13,0,1,1,0,0,2,15
261,MIZORAM,2005,Self-employed (Business activity),0,0,0,0,0,0,0,0,0,0,0,0,0
262,MIZORAM,2005,Professional Activity,0,0,0,0,0,0,0,0,0,0,0,0,0
263,MIZORAM,2005,Farming/Agriculture Activity,0,0,0,0,0,0,0,0,0,0,0,0,0
264,MIZORAM,2005,Others (Please Specify),0,0,3,0,0,3,0,0,1,0,0,1,4
265,MIZORAM,2005,Retired Person,0,0,0,0,0,0,0,0,0,0,0,0,0
266,MIZORAM,2005,Others (Please Specify),2,10,8,4,2,26,0,2,0,0,0,2,28
267,MIZORAM,2005,Total,2,19,20,4,2,47,0,3,4,1,0,8,55
268,MIZORAM,2005,Total Salaried,0,1,4,0,0,5,0,0,0,0,0,0,5
269,MIZORAM,2005,Total Self-employed,0,0,3,0,0,3,0,0,1,0,0,1,4
270,NAGALAND,2005,House Wife,0,0,0,0,0,0,0,0,1,0,0,1,1
271,NAGALAND,2005,Service (Government),0,0,7,2,0,9,0,0,1,0,0,1,10
272,NAGALAND,2005,Service (Private),0,0,0,0,0,0,0,0,0,0,0,0,0
273,NAGALAND,2005,Public Sector Undertaking,0,0,0,0,0,0,0,0,0,0,0,0,0
274,NAGALAND,2005,Student,0,3,0,0,0,3,0,2,0,0,0,2,5
275,NAGALAND,2005,Unemployed,0,0,1,0,0,1,0,0,0,0,0,0,1
276,NAGALAND,2005,Self-employed (Business activity),0,0,1,0,0,1,0,0,0,0,0,0,1
277,NAGALAND,2005,Professional Activity,0,0,1,0,0,1,0,0,0,0,0,0,1
278,NAGALAND,2005,Farming/Agriculture Activity,0,0,0,0,0,0,0,0,0,0,0,0,0
279,NAGALAND,2005,Others (Please Specify),0,1,3,2,0,6,0,1,1,0,0,2,8
280,NAGALAND,2005,Retired Person,0,0,0,0,0,0,0,0,0,0,0,0,0
281,NAGALAND,2005,Others (Please Specify),0,0,0,0,0,0,0,0,0,0,0,0,0
282,NAGALAND,2005,Total,0,4,13,4,0,21,0,3,3,0,0,6,27
283,NAGALAND,2005,Total Salaried,0,0,7,2,0,9,0,0,1,0,0,1,10
284,NAGALAND,2005,Total Self-employed,0,1,5,2,0,8,0,1,1,0,0,2,10
285,ODISHA,2005,House Wife,0,0,0,0,0,0,0,247,237,89,14,587,587
286,ODISHA,2005,Service (Government),0,16,26,12,0,54,0,7,18,1,0,26,80
287,ODISHA,2005,Service (Private),0,31,25,31,1,88,0,33,32,20,3,88,176
288,ODISHA,2005,Public Sector Undertaking,0,29,34,25,1,89,0,7,8,8,0,23,112
289,ODISHA,2005,Student,28,111,10,0,0,149,26,85,2,0,0,113,262
290,ODISHA,2005,Unemployed,0,101,136,35,6,278,2,44,49,9,6,110,388
291,ODISHA,2005,Self-employed (Business activity),0,59,167,73,21,320,0,20,9,11,2,42,362
292,ODISHA,2005,Professional Activity,0,19,27,32,2,80,0,8,8,7,2,25,105
293,ODISHA,2005,Farming/Agriculture Activity,0,38,86,61,19,204,0,13,22,15,0,50,254
294,ODISHA,2005,Others (Please Specify),26,182,283,247,154,892,13,140,107,69,35,364,1256
295,ODISHA,2005,Retired Person,0,0,0,0,10,10,0,0,0,0,2,2,12
296,ODISHA,2005,Others (Please Specify),4,140,125,102,19,390,19,82,80,34,9,224,614
297,ODISHA,2005,Total,58,726,919,618,233,2554,60,686,572,263,73,1654,4208
298,ODISHA,2005,Total Salaried,0,76,85,68,2,231,0,47,58,29,3,137,368
299,ODISHA,2005,Total Self-employed,26,298,563,413,196,1496,13,181,146,102,39,481,1977
300,PUNJAB,2005,House Wife,0,0,0,0,0,0,0,33,28,15,1,77,77
301,PUNJAB,2005,Service (Government),0,2,6,6,1,15,0,1,0,0,0,1,16
302,PUNJAB,2005,Service (Private),0,19,16,0,0,35,0,0,0,0,0,0,35
303,PUNJAB,2005,Public Sector Undertaking,0,0,2,0,0,2,0,0,0,0,0,0,2
304,PUNJAB,2005,Student,0,16,0,1,0,17,0,4,0,0,0,4,21
305,PUNJAB,2005,Unemployed,0,25,13,8,1,47,1,1,3,0,0,5,52
306,PUNJAB,2005,Self-employed (Business activity),0,14,24,17,3,58,0,2,2,1,0,5,63
307,PUNJAB,2005,Professional Activity,0,4,4,5,1,14,0,0,0,0,0,0,14
308,PUNJAB,2005,Farming/Agriculture Activity,0,24,0,17,6,47,0,0,0,0,0,0,47
309,PUNJAB,2005,Others (Please Specify),0,55,55,28,10,148,0,1,2,0,0,3,151
310,PUNJAB,2005,Retired Person,0,0,0,3,5,8,0,0,0,0,0,0,8
311,PUNJAB,2005,Others (Please Specify),0,5,47,27,12,91,1,0,5,4,1,11,102
312,PUNJAB,2005,Total,0,164,167,112,39,482,2,42,40,20,2,106,588
313,PUNJAB,2005,Total Salaried,0,21,24,6,1,52,0,1,0,0,0,1,53
314,PUNJAB,2005,Total Self-employed,0,97,83,67,20,267,0,3,4,1,0,8,275
315,RAJASTHAN,2005,House Wife,0,0,0,0,0,0,13,459,408,201,19,1100,1100
316,RAJASTHAN,2005,Service (Government),0,9,19,10,0,38,0,0,0,0,0,0,38
317,RAJASTHAN,2005,Service (Private),0,108,107,58,2,275,0,8,3,0,0,11,286
318,RAJASTHAN,2005,Public Sector Undertaking,0,15,9,6,0,30,0,2,2,0,0,4,34
319,RAJASTHAN,2005,Student,19,56,0,0,0,75,13,22,2,0,0,37,112
320,RAJASTHAN,2005,Unemployed,3,57,32,6,2,100,0,2,0,0,0,2,102
321,RAJASTHAN,2005,Self-employed (Business activity),0,46,51,20,3,120,0,0,0,0,0,0,120
322,RAJASTHAN,2005,Professional Activity,0,12,13,2,0,27,0,0,0,0,0,0,27
323,RAJASTHAN,2005,Farming/Agriculture Activity,11,138,210,65,12,436,0,6,14,5,0,25,461
324,RAJASTHAN,2005,Others (Please Specify),17,199,215,90,17,538,6,28,10,4,1,49,587
325,RAJASTHAN,2005,Retired Person,0,0,0,2,2,4,0,0,0,0,0,0,4
326,RAJASTHAN,2005,Others (Please Specify),38,292,469,317,99,1215,18,47,24,2,1,92,1307
327,RAJASTHAN,2005,Total,88,932,1125,576,137,2858,50,574,463,212,21,1320,4178
328,RAJASTHAN,2005,Total Salaried,0,132,135,74,2,343,0,10,5,0,0,15,358
329,RAJASTHAN,2005,Total Self-employed,28,395,489,177,32,1121,6,34,24,9,1,74,1195
330,SIKKIM,2005,House Wife,0,0,0,0,0,0,0,10,7,1,2,20,20
331,SIKKIM,2005,Service (Government),0,0,2,0,0,2,0,0,0,0,0,0,2
332,SIKKIM,2005,Service (Private),0,2,0,0,0,2,0,0,3,0,0,3,5
333,SIKKIM,2005,Public Sector Undertaking,0,0,0,0,0,0,0,0,0,0,0,0,0
334,SIKKIM,2005,Student,2,2,1,0,0,5,2,3,0,0,0,5,10
335,SIKKIM,2005,Unemployed,0,2,2,0,0,4,0,0,0,0,0,0,4
336,SIKKIM,2005,Self-employed (Business activity),0,0,0,0,0,0,0,0,1,0,0,1,1
337,SIKKIM,2005,Professional Activity,0,0,0,0,0,0,0,0,0,0,0,0,0
338,SIKKIM,2005,Farming/Agriculture Activity,0,15,7,8,4,34,0,1,3,3,0,7,41
339,SIKKIM,2005,Others (Please Specify),0,3,5,3,0,11,0,0,2,1,3,6,17
340,SIKKIM,2005,Retired Person,0,0,0,0,0,0,0,0,0,0,0,0,0
341,SIKKIM,2005,Others (Please Specify),0,2,0,2,0,4,0,0,3,2,0,5,9
342,SIKKIM,2005,Total,2,26,17,13,4,62,2,14,19,7,5,47,109
343,SIKKIM,2005,Total Salaried,0,2,2,0,0,4,0,0,3,0,0,3,7
344,SIKKIM,2005,Total Self-employed,0,18,12,11,4,45,0,1,6,4,3,14,59
345,TAMIL NADU,2005,House Wife,0,0,0,0,0,0,0,647,737,493,181,2058,2058
346,TAMIL NADU,2005,Service (Government),0,35,63,58,3,159,0,5,16,11,0,32,191
347,TAMIL NADU,2005,Service (Private),0,259,357,280,51,947,3,115,93,33,5,249,1196
348,TAMIL NADU,2005,Public Sector Undertaking,0,48,88,59,10,205,0,14,30,23,8,75,280
349,TAMIL NADU,2005,Student,73,173,15,0,0,261,59,203,7,1,0,270,531
350,TAMIL NADU,2005,Unemployed,7,390,426,267,84,1174,5,249,141,76,40,511,1685
351,TAMIL NADU,2005,Self-employed (Business activity),0,195,301,243,54,793,0,42,28,37,18,125,918
352,TAMIL NADU,2005,Professional Activity,0,72,93,73,8,246,0,21,13,4,2,40,286
353,TAMIL NADU,2005,Farming/Agriculture Activity,11,217,369,263,142,1002,5,102,73,40,33,253,1255
354,TAMIL NADU,2005,Others (Please Specify),4,351,524,368,183,1430,6,193,126,120,36,481,1911
355,TAMIL NADU,2005,Retired Person,0,0,0,10,84,94,0,0,0,0,8,8,102
356,TAMIL NADU,2005,Others (Please Specify),52,226,471,346,101,1196,94,144,101,85,43,467,1663
357,TAMIL NADU,2005,Total,147,1966,2707,1967,720,7507,172,1735,1365,923,374,4569,12076
358,TAMIL NADU,2005,Total Salaried,0,342,508,397,64,1311,3,134,139,67,13,356,1667
359,TAMIL NADU,2005,Total Self-employed,15,835,1287,947,387,3471,11,358,240,201,89,899,4370
360,TRIPURA,2005,House Wife,0,0,0,0,0,0,0,47,38,15,4,104,104
361,TRIPURA,2005,Service (Government),0,3,13,7,0,23,0,5,3,2,0,10,33
362,TRIPURA,2005,Service (Private),0,8,15,11,0,34,0,6,5,3,0,14,48
363,TRIPURA,2005,Public Sector Undertaking,0,8,9,5,0,22,0,3,4,5,0,12,34
364,TRIPURA,2005,Student,6,22,1,0,0,29,8,28,4,0,0,40,69
365,TRIPURA,2005,Unemployed,0,33,25,14,0,72,0,11,3,2,2,18,90
366,TRIPURA,2005,Self-employed (Business activity),0,34,19,3,6,62,0,0,0,0,0,0,62
367,TRIPURA,2005,Professional Activity,0,8,15,13,5,41,0,0,0,0,0,0,41
368,TRIPURA,2005,Farming/Agriculture Activity,0,14,6,6,3,29,0,0,0,0,0,0,29
369,TRIPURA,2005,Others (Please Specify),3,10,9,11,7,40,5,29,16,5,2,57,97
370,TRIPURA,2005,Retired Person,0,0,0,7,7,14,0,0,0,0,0,0,14
371,TRIPURA,2005,Others (Please Specify),1,9,15,6,4,35,3,45,5,6,0,59,94
372,TRIPURA,2005,Total,10,149,127,83,32,401,16,174,78,38,8,314,715
373,TRIPURA,2005,Total Salaried,0,19,37,23,0,79,0,14,12,10,0,36,115
374,TRIPURA,2005,Total Self-employed,3,66,49,33,21,172,5,29,16,5,2,57,229
375,UTTAR PRADESH,2005,House Wife,0,0,0,0,0,0,0,547,348,119,0,1014,1014
376,UTTAR PRADESH,2005,Service (Government),0,8,16,11,0,35,0,8,3,2,0,13,48
377,UTTAR PRADESH,2005,Service (Private),3,74,54,27,6,164,25,29,0,5,36,95,259
378,UTTAR PRADESH,2005,Public Sector Undertaking,0,18,32,22,0,72,0,23,18,11,0,52,124
379,UTTAR PRADESH,2005,Student,19,105,16,0,0,140,12,60,7,0,0,79,219
380,UTTAR PRADESH,2005,Unemployed,2,69,91,26,7,195,0,39,24,9,0,72,267
381,UTTAR PRADESH,2005,Self-employed (Business activity),2,68,76,42,32,220,2,1,5,0,0,8,228
382,UTTAR PRADESH,2005,Professional Activity,1,13,17,24,6,61,0,1,2,0,0,3,64
383,UTTAR PRADESH,2005,Farming/Agriculture Activity,3,108,164,103,44,422,1,41,27,15,16,100,522
384,UTTAR PRADESH,2005,Others (Please Specify),13,71,106,78,37,305,11,90,27,31,8,167,472
385,UTTAR PRADESH,2005,Retired Person,0,0,0,3,3,6,0,0,0,2,1,3,9
386,UTTAR PRADESH,2005,Others (Please Specify),15,33,41,33,30,152,8,25,12,14,12,71,223
387,UTTAR PRADESH,2005,Total,58,567,613,369,165,1772,59,864,473,208,73,1677,3449
388,UTTAR PRADESH,2005,Total Salaried,3,100,102,60,6,271,25,60,21,18,36,160,431
389,UTTAR PRADESH,2005,Total Self-employed,19,260,363,247,119,1008,14,133,61,46,24,278,1286
390,UTTARAKHAND,2005,House Wife,0,0,0,0,0,0,0,44,20,3,0,67,67
391,UTTARAKHAND,2005,Service (Government),0,2,3,2,0,7,0,0,0,0,0,0,7
392,UTTARAKHAND,2005,Service (Private),0,7,7,3,0,17,0,2,1,0,0,3,20
393,UTTARAKHAND,2005,Public Sector Undertaking,0,3,3,0,0,6,0,1,0,0,0,1,7
394,UTTARAKHAND,2005,Student,0,8,0,0,0,8,3,3,0,0,0,6,14
395,UTTARAKHAND,2005,Unemployed,0,19,18,6,0,43,0,0,1,0,0,1,44
396,UTTARAKHAND,2005,Self-employed (Business activity),0,7,16,2,1,26,0,0,0,0,0,0,26
397,UTTARAKHAND,2005,Professional Activity,0,2,4,4,0,10,0,0,0,0,0,0,10
398,UTTARAKHAND,2005,Farming/Agriculture Activity,0,4,4,5,2,15,0,3,3,3,0,9,24
399,UTTARAKHAND,2005,Others (Please Specify),0,8,8,4,0,20,0,1,0,1,0,2,22
400,UTTARAKHAND,2005,Retired Person,0,0,0,1,2,3,0,0,0,0,0,0,3
401,UTTARAKHAND,2005,Others (Please Specify),0,16,3,2,4,25,1,0,1,2,0,4,29
402,UTTARAKHAND,2005,Total,0,76,66,29,9,180,4,54,26,9,0,93,273
403,UTTARAKHAND,2005,Total Salaried,0,12,13,5,0,30,0,3,1,0,0,4,34
404,UTTARAKHAND,2005,Total Self-employed,0,21,32,15,3,71,0,4,3,4,0,11,82
405,WEST BENGAL,2005,House Wife,0,0,0,0,0,0,0,1834,1296,830,195,4155,4155
406,WEST BENGAL,2005,Service (Government),0,46,70,48,0,164,0,2,9,9,0,20,184
407,WEST BENGAL,2005,Service (Private),0,418,464,237,0,1119,0,94,104,47,0,245,1364
408,WEST BENGAL,2005,Public Sector Undertaking,0,97,222,152,0,471,0,32,12,2,0,46,517
409,WEST BENGAL,2005,Student,141,285,27,0,0,453,164,102,12,0,0,278,731
410,WEST BENGAL,2005,Unemployed,0,617,301,10,0,928,0,152,63,6,0,221,1149
411,WEST BENGAL,2005,Self-employed (Business activity),0,212,351,307,34,904,0,11,56,8,21,96,1000
412,WEST BENGAL,2005,Professional Activity,0,57,133,148,8,346,0,3,1,2,0,6,352
413,WEST BENGAL,2005,Farming/Agriculture Activity,0,233,293,282,45,853,0,12,60,30,10,112,965
414,WEST BENGAL,2005,Others (Please Specify),0,372,610,528,202,1712,4,193,86,133,42,458,2170
415,WEST BENGAL,2005,Retired Person,0,0,0,0,212,212,0,0,0,0,15,15,227
416,WEST BENGAL,2005,Others (Please Specify),73,625,430,296,28,1452,37,345,220,111,36,749,2201
417,WEST BENGAL,2005,Total,214,2962,2901,2008,529,8614,205,2780,1919,1178,319,6401,15015
418,WEST BENGAL,2005,Total Salaried,0,561,756,437,0,1754,0,128,125,58,0,311,2065
419,WEST BENGAL,2005,Total Self-employed,0,874,1387,1265,289,3815,4,219,203,173,73,672,4487
420,TOTAL (STATES),2005,House Wife,0,0,0,0,0,0,30,10468,7786,3907,1458,23649,23649
421,TOTAL (STATES),2005,Service (Government),0,290,592,489,5,1376,0,80,118,46,1,245,1621
422,TOTAL (STATES),2005,Service (Private),20,2399,2876,1691,186,7172,33,608,413,174,64,1292,8464
423,TOTAL (STATES),2005,Public Sector Undertaking,0,465,742,517,32,1756,0,149,147,70,8,374,2130
424,TOTAL (STATES),2005,Student,575,2085,151,3,0,2814,575,1531,77,1,0,2184,4998
425,TOTAL (STATES),2005,Unemployed,40,2956,2448,1036,342,6822,13,874,451,158,92,1588,8410
426,TOTAL (STATES),2005,Self-employed (Business activity),21,1452,2273,1554,367,5667,3,192,183,108,48,534,6201
427,TOTAL (STATES),2005,Professional Activity,17,626,979,705,151,2478,5,107,49,50,20,231,2709
428,TOTAL (STATES),2005,Farming/Agriculture Activity,54,3604,5600,3859,1685,14802,41,758,751,417,187,2154,16956
429,TOTAL (STATES),2005,Others (Please Specify),179,3899,5223,3686,1879,14866,145,1556,943,738,338,3720,18586
430,TOTAL (STATES),2005,Retired Person,0,16,10,163,624,813,0,4,4,15,71,94,907
431,TOTAL (STATES),2005,Others (Please Specify),405,3512,4586,3266,1249,13018,363,1643,1109,639,399,4153,17171
432,TOTAL (STATES),2005,Total,1311,21304,25480,16969,6520,71584,1208,17970,12031,6323,2686,40218,111802
433,TOTAL (STATES),2005,Total Salaried,20,3154,4210,2697,223,10304,33,837,678,290,73,1911,12215
434,TOTAL (STATES),2005,Total Self-employed,271,9581,14075,9804,4082,37813,194,2613,1926,1313,593,6639,44452
435,A & N ISLANDS,2005,House Wife,0,0,0,0,0,0,0,11,7,10,4,32,32
436,A & N ISLANDS,2005,Service (Government),0,1,5,7,0,13,0,0,0,0,0,0,13
437,A & N ISLANDS,2005,Service (Private),0,9,12,14,12,47,0,4,0,0,0,4,51
438,A & N ISLANDS,2005,Public Sector Undertaking,0,0,0,0,0,0,0,0,0,0,0,0,0
439,A & N ISLANDS,2005,Student,2,3,0,0,0,5,3,4,0,0,0,7,12
440,A & N ISLANDS,2005,Unemployed,0,1,1,1,0,3,0,8,0,0,1,9,12
441,A & N ISLANDS,2005,Self-employed (Business activity),3,1,0,0,1,5,0,0,0,0,0,0,5
442,A & N ISLANDS,2005,Professional Activity,0,0,0,0,0,0,0,0,0,0,0,0,0
443,A & N ISLANDS,2005,Farming/Agriculture Activity,0,0,2,1,4,7,0,0,1,0,0,1,8
444,A & N ISLANDS,2005,Others (Please Specify),0,0,4,2,0,6,0,0,0,0,0,0,6
445,A & N ISLANDS,2005,Retired Person,0,0,0,0,0,0,0,0,0,0,0,0,0
446,A & N ISLANDS,2005,Others (Please Specify),0,0,0,0,0,0,0,0,0,0,0,0,0
447,A & N ISLANDS,2005,Total,5,15,24,25,17,86,3,27,8,10,5,53,139
448,A & N ISLANDS,2005,Total Salaried,0,10,17,21,12,60,0,4,0,0,0,4,64
449,A & N ISLANDS,2005,Total Self-employed,3,1,6,3,5,18,0,0,1,0,0,1,19
450,CHANDIGARH,2005,House Wife,0,0,0,0,0,0,0,6,5,3,0,14,14
451,CHANDIGARH,2005,Service (Government),0,1,0,1,0,2,0,0,0,1,0,1,3
452,CHANDIGARH,2005,Service (Private),0,5,6,6,0,17,0,1,0,0,0,1,18
453,CHANDIGARH,2005,Public Sector Undertaking,0,0,5,0,0,5,0,0,0,0,0,0,5
454,CHANDIGARH,2005,Student,1,2,0,0,0,3,0,3,0,0,0,3,6
455,CHANDIGARH,2005,Unemployed,0,12,3,0,0,15,0,2,0,0,0,2,17
456,CHANDIGARH,2005,Self-employed (Business activity),0,8,2,1,0,11,0,0,0,0,0,0,11
457,CHANDIGARH,2005,Professional Activity,0,0,0,0,0,0,0,0,0,0,0,0,0
458,CHANDIGARH,2005,Farming/Agriculture Activity,0,0,0,0,0,0,0,0,0,0,0,0,0
459,CHANDIGARH,2005,Others (Please Specify),0,5,2,2,0,9,0,3,1,0,0,4,13
460,CHANDIGARH,2005,Retired Person,0,0,0,0,0,0,0,0,0,0,0,0,0
461,CHANDIGARH,2005,Others (Please Specify),1,0,0,0,0,1,1,0,0,0,0,1,2
462,CHANDIGARH,2005,Total,2,33,18,10,0,63,1,15,6,4,0,26,89
463,CHANDIGARH,2005,Total Salaried,0,6,11,7,0,24,0,1,0,1,0,2,26
464,CHANDIGARH,2005,Total Self-employed,0,13,4,3,0,20,0,3,1,0,0,4,24
465,D & N HAVELI,2005,House Wife,0,0,0,0,0,0,0,7,7,7,1,22,22
466,D & N HAVELI,2005,Service (Government),0,0,0,0,0,0,0,2,1,0,0,3,3
467,D & N HAVELI,2005,Service (Private),0,3,1,0,0,4,0,0,0,0,0,0,4
468,D & N HAVELI,2005,Public Sector Undertaking,0,0,0,0,0,0,0,0,0,0,0,0,0
469,D & N HAVELI,2005,Student,0,0,0,0,0,0,0,0,0,0,0,0,0
470,D & N HAVELI,2005,Unemployed,0,1,1,0,0,2,0,0,0,0,0,0,2
471,D & N HAVELI,2005,Self-employed (Business activity),0,0,0,0,0,0,0,0,0,0,0,0,0
472,D & N HAVELI,2005,Professional Activity,0,0,0,0,0,0,0,0,0,0,0,0,0
473,D & N HAVELI,2005,Farming/Agriculture Activity,0,3,6,4,0,13,0,0,0,0,0,0,13
474,D & N HAVELI,2005,Others (Please Specify),0,0,0,0,0,0,0,0,0,0,0,0,0
475,D & N HAVELI,2005,Retired Person,0,0,0,0,0,0,0,0,0,0,0,0,0
476,D & N HAVELI,2005,Others (Please Specify),0,9,5,2,6,22,0,3,0,0,0,3,25
477,D & N HAVELI,2005,Total,0,16,13,6,6,41,0,12,8,7,1,28,69
478,D & N HAVELI,2005,Total Salaried,0,3,1,0,0,4,0,2,1,0,0,3,7
479,D & N HAVELI,2005,Total Self-employed,0,3,6,4,0,13,0,0,0,0,0,0,13
480,DAMAN & DIU,2005,House Wife,0,0,0,0,0,0,0,2,2,0,0,4,4
481,DAMAN & DIU,2005,Service (Government),0,0,0,0,0,0,0,0,0,0,0,0,0
482,DAMAN & DIU,2005,Service (Private),0,6,1,1,0,8,0,0,0,0,0,0,8
483,DAMAN & DIU,2005,Public Sector Undertaking,0,0,0,1,0,1,0,0,0,0,0,0,1
484,DAMAN & DIU,2005,Student,1,0,0,0,0,1,0,0,0,0,0,0,1
485,DAMAN & DIU,2005,Unemployed,0,0,0,4,0,4,0,0,0,0,0,0,4
486,DAMAN & DIU,2005,Self-employed (Business activity),0,0,1,0,0,1,0,0,0,0,0,0,1
487,DAMAN & DIU,2005,Professional Activity,0,0,0,0,0,0,0,0,0,0,0,0,0
488,DAMAN & DIU,2005,Farming/Agriculture Activity,0,0,0,0,0,0,0,0,0,0,0,0,0
489,DAMAN & DIU,2005,Others (Please Specify),0,3,1,4,0,8,0,0,0,0,0,0,8
490,DAMAN & DIU,2005,Retired Person,0,0,0,0,0,0,0,0,0,0,0,0,0
491,DAMAN & DIU,2005,Others (Please Specify),0,1,1,0,0,2,0,3,0,0,0,3,5
492,DAMAN & DIU,2005,Total,1,10,4,10,0,25,0,5,2,0,0,7,32
493,DAMAN & DIU,2005,Total Salaried,0,6,1,2,0,9,0,0,0,0,0,0,9
494,DAMAN & DIU,2005,Total Self-employed,0,3,2,4,0,9,0,0,0,0,0,0,9
495,DELHI (UT),2005,House Wife,0,0,0,0,0,0,0,162,102,23,7,294,294
496,DELHI (UT),2005,Service (Government),0,7,18,11,0,36,0,3,0,1,0,4,40
497,DELHI (UT),2005,Service (Private),0,76,58,29,2,165,1,14,3,0,0,18,183
498,DELHI (UT),2005,Public Sector Undertaking,0,1,2,1,0,4,0,1,0,0,0,1,5
499,DELHI (UT),2005,Student,4,50,5,0,0,59,5,33,1,0,0,39,98
500,DELHI (UT),2005,Unemployed,1,109,69,24,6,209,2,25,5,0,0,32,241
501,DELHI (UT),2005,Self-employed (Business activity),0,7,8,0,1,16,0,0,0,0,0,0,16
502,DELHI (UT),2005,Professional Activity,0,0,1,3,1,5,0,1,0,0,0,1,6
503,DELHI (UT),2005,Farming/Agriculture Activity,0,1,5,1,0,7,0,0,0,0,0,0,7
504,DELHI (UT),2005,Others (Please Specify),0,54,44,17,7,122,0,11,12,1,0,24,146
505,DELHI (UT),2005,Retired Person,0,0,0,0,3,3,0,0,0,0,0,0,3
506,DELHI (UT),2005,Others (Please Specify),3,65,54,25,4,151,5,31,17,1,1,55,206
507,DELHI (UT),2005,Total,8,370,264,111,24,777,13,281,140,26,8,468,1245
508,DELHI (UT),2005,Total Salaried,0,84,78,41,2,205,1,18,3,1,0,23,228
509,DELHI (UT),2005,Total Self-employed,0,62,58,21,9,150,0,12,12,1,0,25,175
510,LAKSHADWEEP,2005,House Wife,0,0,0,0,0,0,0,0,0,0,0,0,0
511,LAKSHADWEEP,2005,Service (Government),0,0,0,0,0,0,0,0,0,0,0,0,0
512,LAKSHADWEEP,2005,Service (Private),0,0,0,0,0,0,0,0,0,0,0,0,0
513,LAKSHADWEEP,2005,Public Sector Undertaking,0,0,0,0,0,0,0,0,0,0,0,0,0
514,LAKSHADWEEP,2005,Student,0,0,0,0,0,0,0,0,0,0,0,0,0
515,LAKSHADWEEP,2005,Unemployed,0,0,0,0,0,0,0,0,0,0,0,0,0
516,LAKSHADWEEP,2005,Self-employed (Business activity),0,0,0,0,0,0,0,0,0,0,0,0,0
517,LAKSHADWEEP,2005,Professional Activity,0,0,0,0,0,0,0,0,0,0,0,0,0
518,LAKSHADWEEP,2005,Farming/Agriculture Activity,0,0,0,0,0,0,0,0,0,0,0,0,0
519,LAKSHADWEEP,2005,Others (Please Specify),0,0,0,0,0,0,0,0,0,0,0,0,0
520,LAKSHADWEEP,2005,Retired Person,0,0,0,0,0,0,0,0,0,0,0,0,0
521,LAKSHADWEEP,2005,Others (Please Specify),0,0,0,0,0,0,0,0,0,0,0,0,0
522,LAKSHADWEEP,2005,Total,0,0,0,0,0,0,0,0,0,0,0,0,0
523,LAKSHADWEEP,2005,Total Salaried,0,0,0,0,0,0,0,0,0,0,0,0,0
524,LAKSHADWEEP,2005,Total Self-employed,0,0,0,0,0,0,0,0,0,0,0,0,0
525,PUDUCHERRY,2005,House Wife,0,0,0,0,0,0,0,48,51,18,9,126,126
526,PUDUCHERRY,2005,Service (Government),0,1,5,6,0,12,0,0,0,1,0,1,13
527,PUDUCHERRY,2005,Service (Private),0,16,33,25,1,75,0,10,1,0,0,11,86
528,PUDUCHERRY,2005,Public Sector Undertaking,0,0,1,0,1,2,0,0,0,0,0,0,2
529,PUDUCHERRY,2005,Student,1,5,1,0,0,7,2,14,0,0,0,16,23
530,PUDUCHERRY,2005,Unemployed,0,22,12,21,16,71,0,28,2,0,11,41,112
531,PUDUCHERRY,2005,Self-employed (Business activity),0,2,5,1,2,10,0,0,0,0,0,0,10
532,PUDUCHERRY,2005,Professional Activity,0,1,5,2,0,8,0,0,0,0,0,0,8
533,PUDUCHERRY,2005,Farming/Agriculture Activity,0,28,65,45,6,144,0,1,2,0,0,3,147
534,PUDUCHERRY,2005,Others (Please Specify),0,0,0,0,0,0,0,0,0,0,0,0,0
535,PUDUCHERRY,2005,Retired Person,0,0,0,1,3,4,0,0,0,0,0,0,4
536,PUDUCHERRY,2005,Others (Please Specify),0,0,2,4,1,7,0,0,0,0,0,0,7
537,PUDUCHERRY,2005,Total,1,75,129,105,30,340,2,101,56,19,20,198,538
538,PUDUCHERRY,2005,Total Salaried,0,17,39,31,2,89,0,10,1,1,0,12,101
539,PUDUCHERRY,2005,Total Self-employed,0,31,75,48,8,162,0,1,2,0,0,3,165
540,TOTAL (UTs),2005,House Wife,0,0,0,0,0,0,0,236,174,61,21,492,492
541,TOTAL (UTs),2005,Service (Government),0,10,28,25,0,63,0,5,1,3,0,9,72
542,TOTAL (UTs),2005,Service (Private),0,115,111,75,15,316,1,29,4,0,0,34,350
543,TOTAL (UTs),2005,Public Sector Undertaking,0,1,8,2,1,12,0,1,0,0,0,1,13
544,TOTAL (UTs),2005,Student,9,60,6,0,0,75,10,54,1,0,0,65,140
545,TOTAL (UTs),2005,Unemployed,1,145,86,50,22,304,2,63,7,0,12,84,388
546,TOTAL (UTs),2005,Self-employed (Business activity),3,18,16,2,4,43,0,0,0,0,0,0,43
547,TOTAL (UTs),2005,Professional Activity,0,1,6,5,1,13,0,1,0,0,0,1,14
548,TOTAL (UTs),2005,Farming/Agriculture Activity,0,32,78,51,10,171,0,1,3,0,0,4,175
549,TOTAL (UTs),2005,Others (Please Specify),0,62,51,25,7,145,0,14,13,1,0,28,173
550,TOTAL (UTs),2005,Retired Person,0,0,0,1,6,7,0,0,0,0,0,0,7
551,TOTAL (UTs),2005,Others (Please Specify),4,75,62,31,11,183,6,37,17,1,1,62,245
552,TOTAL (UTs),2005,Total,17,519,452,267,77,1332,19,441,220,66,34,780,2112
553,TOTAL (UTs),2005,Total Salaried,0,126,147,102,16,391,1,35,5,3,0,44,435
554,TOTAL (UTs),2005,Total Self-employed,3,113,151,83,22,372,0,16,16,1,0,33,405
555,TOTAL (ALL INDIA),2005,House Wife,0,0,0,0,0,0,30,10704,7960,3968,1479,24141,24141
556,TOTAL (ALL INDIA),2005,Service (Government),0,300,620,514,5,1439,0,85,119,49,1,254,1693
557,TOTAL (ALL INDIA),2005,Service (Private),20,2514,2987,1766,201,7488,34,637,417,174,64,1326,8814
558,TOTAL (ALL INDIA),2005,Public Sector Undertaking,0,466,750,519,33,1768,0,150,147,70,8,375,2143
559,TOTAL (ALL INDIA),2005,Student,584,2145,157,3,0,2889,585,1585,78,1,0,2249,5138
560,TOTAL (ALL INDIA),2005,Unemployed,41,3101,2534,1086,364,7126,15,937,458,158,104,1672,8798
561,TOTAL (ALL INDIA),2005,Self-employed (Business activity),24,1470,2289,1556,371,5710,3,192,183,108,48,534,6244
562,TOTAL (ALL INDIA),2005,Professional Activity,17,627,985,710,152,2491,5,108,49,50,20,232,2723
563,TOTAL (ALL INDIA),2005,Farming/Agriculture Activity,54,3636,5678,3910,1695,14973,41,759,754,417,187,2158,17131
564,TOTAL (ALL INDIA),2005,Others (Please Specify),179,3961,5274,3711,1886,15011,145,1570,956,739,338,3748,18759
565,TOTAL (ALL INDIA),2005,Retired Person,0,16,10,164,630,820,0,4,4,15,71,94,914
566,TOTAL (ALL INDIA),2005,Others (Please Specify),409,3587,4648,3297,1260,13201,369,1680,1126,640,400,4215,17416
567,TOTAL (ALL INDIA),2005,Total,1328,21823,25932,17236,6597,72916,1227,18411,12251,6389,2720,40998,113914
568,TOTAL (ALL INDIA),2005,Total Salaried,20,3280,4357,2799,239,10695,34,872,683,293,73,1955,12650
569,TOTAL (ALL INDIA),2005,Total Self-employed,274,9694,14226,9887,4104,38185,194,2629,1942,1314,593,6672,44857
0,ANDHRA PRADESH,2006,House Wife,0,0,0,0,0,0,2,994,750,303,107,2156,2156
1,ANDHRA PRADESH,2006,Service (Government),4,51,84,44,0,183,0,19,26,3,0,48,231
2,ANDHRA PRADESH,2006,Service (Private),0,157,240,159,20,576,0,30,35,6,0,71,647
3,ANDHRA PRADESH,2006,Public Sector Undertaking,0,67,69,48,6,190,0,1,10,3,0,14,204
4,ANDHRA PRADESH,2006,Student,55,216,12,4,0,287,53,168,4,0,0,225,512
5,ANDHRA PRADESH,2006,Unemployed,0,169,132,70,0,371,0,34,24,0,0,58,429
6,ANDHRA PRADESH,2006,Self-employed (Business activity),0,263,305,214,60,842,0,15,12,21,4,52,894
7,ANDHRA PRADESH,2006,Professional Activity,0,66,240,197,49,552,1,12,8,0,1,22,574
8,ANDHRA PRADESH,2006,Farming/Agriculture Activity,15,505,777,489,214,2000,14,241,210,115,27,607,2607
9,ANDHRA PRADESH,2006,Others (Please Specify),46,505,651,430,191,1823,71,269,145,83,110,678,2501
10,ANDHRA PRADESH,2006,Retired Person,0,1,3,9,38,51,0,0,5,0,1,6,57
11,ANDHRA PRADESH,2006,Others (Please Specify),49,696,765,368,110,1988,54,204,128,49,41,476,2464
12,ANDHRA PRADESH,2006,Total,169,2696,3278,2032,688,8863,195,1987,1357,583,291,4413,13276
13,ANDHRA PRADESH,2006,Total Salaried,4,275,393,251,26,949,0,50,71,12,0,133,1082
14,ANDHRA PRADESH,2006,Total Self-employed,61,1339,1973,1330,514,5217,86,537,375,219,142,1359,6576
15,ARUNACHAL PRADESH,2006,House Wife,0,0,0,0,0,0,0,7,11,3,0,21,21
16,ARUNACHAL PRADESH,2006,Service (Government),0,2,9,7,0,18,0,0,1,0,0,1,19
17,ARUNACHAL PRADESH,2006,Service (Private),0,11,12,4,1,28,0,0,0,0,0,0,28
18,ARUNACHAL PRADESH,2006,Public Sector Undertaking,0,0,0,0,0,0,0,0,0,0,0,0,0
19,ARUNACHAL PRADESH,2006,Student,1,1,0,0,0,2,2,6,0,0,0,8,10
20,ARUNACHAL PRADESH,2006,Unemployed,0,3,5,1,0,9,0,0,0,0,0,0,9
21,ARUNACHAL PRADESH,2006,Self-employed (Business activity),0,2,2,1,0,5,0,0,0,0,0,0,5
22,ARUNACHAL PRADESH,2006,Professional Activity,0,0,0,0,0,0,0,0,0,0,0,0,0
23,ARUNACHAL PRADESH,2006,Farming/Agriculture Activity,0,1,2,1,0,4,0,0,0,0,0,0,4
24,ARUNACHAL PRADESH,2006,Others (Please Specify),0,8,12,3,0,23,1,2,0,0,0,3,26
25,ARUNACHAL PRADESH,2006,Retired Person,0,0,0,0,0,0,0,0,0,0,0,0,0
26,ARUNACHAL PRADESH,2006,Others (Please Specify),0,0,3,4,0,7,0,0,0,0,0,0,7
27,ARUNACHAL PRADESH,2006,Total,1,28,45,21,1,96,3,15,12,3,0,33,129
28,ARUNACHAL PRADESH,2006,Total Salaried,0,13,21,11,1,46,0,0,1,0,0,1,47
29,ARUNACHAL PRADESH,2006,Total Self-employed,0,11,16,5,0,32,1,2,0,0,0,3,35
30,ASSAM,2006,House Wife,0,0,0,0,0,0,0,258,247,68,6,579,579
31,ASSAM,2006,Service (Government),0,6,6,5,0,17,0,0,0,0,0,0,17
32,ASSAM,2006,Service (Private),0,14,19,5,0,38,0,4,3,1,0,8,46
33,ASSAM,2006,Public Sector Undertaking,0,18,10,11,0,39,0,9,5,0,0,14,53
34,ASSAM,2006,Student,27,127,3,0,0,157,19,32,2,0,0,53,210
35,ASSAM,2006,Unemployed,0,0,15,24,2,41,0,0,0,0,0,0,41
36,ASSAM,2006,Self-employed (Business activity),0,148,199,118,1,466,0,28,13,6,0,47,513
37,ASSAM,2006,Professional Activity,1,26,82,29,0,138,0,0,0,0,0,0,138
38,ASSAM,2006,Farming/Agriculture Activity,0,82,139,54,20,295,2,2,13,10,0,27,322
39,ASSAM,2006,Others (Please Specify),9,261,310,106,23,709,4,27,35,14,8,88,797
40,ASSAM,2006,Retired Person,0,2,1,2,5,10,0,0,0,0,0,0,10
41,ASSAM,2006,Others (Please Specify),7,69,69,31,30,206,7,53,30,8,1,99,305
42,ASSAM,2006,Total,44,753,853,385,81,2116,32,413,348,107,15,915,3031
43,ASSAM,2006,Total Salaried,0,38,35,21,0,94,0,13,8,1,0,22,116
44,ASSAM,2006,Total Self-employed,10,517,730,307,44,1608,6,57,61,30,8,162,1770
45,BIHAR,2006,House Wife,0,0,0,0,0,0,0,56,68,12,1,137,137
46,BIHAR,2006,Service (Government),0,1,3,2,0,6,0,1,3,0,0,4,10
47,BIHAR,2006,Service (Private),0,5,9,1,0,15,0,0,0,1,0,1,16
48,BIHAR,2006,Public Sector Undertaking,0,1,1,0,0,2,0,0,5,0,0,5,7
49,BIHAR,2006,Student,10,30,3,0,0,43,8,14,5,0,0,27,70
50,BIHAR,2006,Unemployed,0,8,9,0,1,18,1,4,2,1,0,8,26
51,BIHAR,2006,Self-employed (Business activity),0,7,8,1,0,16,0,1,7,0,0,8,24
52,BIHAR,2006,Professional Activity,0,1,2,0,0,3,0,0,0,1,0,1,4
53,BIHAR,2006,Farming/Agriculture Activity,0,13,21,2,2,38,0,4,4,0,0,8,46
54,BIHAR,2006,Others (Please Specify),0,13,15,13,1,42,1,13,16,3,0,33,75
55,BIHAR,2006,Retired Person,0,0,0,0,1,1,0,0,0,0,1,1,2
56,BIHAR,2006,Others (Please Specify),18,44,31,16,6,115,14,30,19,20,3,86,201
57,BIHAR,2006,Total,28,123,102,35,11,299,24,123,129,38,5,319,618
58,BIHAR,2006,Total Salaried,0,7,13,3,0,23,0,1,8,1,0,10,33
59,BIHAR,2006,Total Self-employed,0,34,46,16,3,99,1,18,27,4,0,50,149
60,CHHATTISGARH,2006,House Wife,0,0,0,0,0,0,3,393,248,83,45,772,772
61,CHHATTISGARH,2006,Service (Government),0,6,13,11,1,31,0,1,2,1,0,4,35
62,CHHATTISGARH,2006,Service (Private),0,24,60,43,0,127,0,4,5,0,0,9,136
63,CHHATTISGARH,2006,Public Sector Undertaking,0,0,14,2,0,16,0,0,1,0,0,1,17
64,CHHATTISGARH,2006,Student,23,84,0,0,0,107,16,69,0,0,0,85,192
65,CHHATTISGARH,2006,Unemployed,0,93,41,10,0,144,1,5,1,1,0,8,152
66,CHHATTISGARH,2006,Self-employed (Business activity),0,29,63,17,4,113,0,12,2,8,0,22,135
67,CHHATTISGARH,2006,Professional Activity,1,25,38,13,6,83,0,0,0,0,0,0,83
68,CHHATTISGARH,2006,Farming/Agriculture Activity,6,377,481,245,103,1212,20,115,83,41,12,271,1483
69,CHHATTISGARH,2006,Others (Please Specify),24,179,178,105,21,507,17,84,28,23,4,156,663
70,CHHATTISGARH,2006,Retired Person,0,0,0,0,1,1,0,0,0,0,0,0,1
71,CHHATTISGARH,2006,Others (Please Specify),58,250,197,144,70,719,39,92,58,31,18,238,957
72,CHHATTISGARH,2006,Total,112,1067,1085,590,206,3060,96,775,428,188,79,1566,4626
73,CHHATTISGARH,2006,Total Salaried,0,30,87,56,1,174,0,5,8,1,0,14,188
74,CHHATTISGARH,2006,Total Self-employed,31,610,760,380,134,1915,37,211,113,72,16,449,2364
75,GOA,2006,House Wife,0,0,0,0,0,0,0,12,16,13,10,51,51
76,GOA,2006,Service (Government),0,2,1,0,0,3,0,0,0,0,0,0,3
77,GOA,2006,Service (Private),0,20,18,11,0,49,0,3,1,0,0,4,53
78,GOA,2006,Public Sector Undertaking,0,0,0,0,0,0,0,0,0,0,0,0,0
79,GOA,2006,Student,1,7,0,0,0,8,4,8,0,0,0,12,20
80,GOA,2006,Unemployed,0,19,22,8,2,51,0,10,2,0,0,12,63
81,GOA,2006,Self-employed (Business activity),0,2,2,5,0,9,0,0,0,0,0,0,9
82,GOA,2006,Professional Activity,0,0,0,0,0,0,0,0,0,0,0,0,0
83,GOA,2006,Farming/Agriculture Activity,0,0,5,0,0,5,0,0,0,0,0,0,5
84,GOA,2006,Others (Please Specify),0,1,5,4,3,13,0,1,0,0,0,1,14
85,GOA,2006,Retired Person,0,0,0,2,6,8,0,0,0,0,0,0,8
86,GOA,2006,Others (Please Specify),0,9,16,10,2,37,2,6,3,0,1,12,49
87,GOA,2006,Total,1,60,69,40,13,183,6,40,22,13,11,92,275
88,GOA,2006,Total Salaried,0,22,19,11,0,52,0,3,1,0,0,4,56
89,GOA,2006,Total Self-employed,0,3,12,9,3,27,0,1,0,0,0,1,28
90,GUJARAT,2006,House Wife,0,0,0,0,0,0,0,651,469,219,57,1396,1396
91,GUJARAT,2006,Service (Government),0,8,22,14,1,45,0,5,3,1,0,9,54
92,GUJARAT,2006,Service (Private),0,141,215,102,3,461,0,37,25,8,0,70,531
93,GUJARAT,2006,Public Sector Undertaking,0,13,17,10,1,41,0,10,4,1,0,15,56
94,GUJARAT,2006,Student,24,100,13,0,0,137,17,85,1,0,0,103,240
95,GUJARAT,2006,Unemployed,0,162,154,86,8,410,0,19,22,5,0,46,456
96,GUJARAT,2006,Self-employed (Business activity),0,73,108,68,8,257,0,1,5,0,0,6,263
97,GUJARAT,2006,Professional Activity,0,126,141,87,16,370,2,10,12,5,0,29,399
98,GUJARAT,2006,Farming/Agriculture Activity,0,101,175,116,19,411,3,24,29,14,6,76,487
99,GUJARAT,2006,Others (Please Specify),2,165,176,110,24,477,3,48,23,9,3,86,563
100,GUJARAT,2006,Retired Person,0,2,1,24,86,113,0,0,0,7,50,57,170
101,GUJARAT,2006,Others (Please Specify),4,95,112,77,38,326,3,35,21,29,6,94,420
102,GUJARAT,2006,Total,30,986,1134,694,204,3048,28,925,614,298,122,1987,5035
103,GUJARAT,2006,Total Salaried,0,162,254,126,5,547,0,52,32,10,0,94,641
104,GUJARAT,2006,Total Self-employed,2,465,600,381,67,1515,8,83,69,28,9,197,1712
105,HARYANA,2006,House Wife,0,0,0,0,0,0,2,152,110,40,15,319,319
106,HARYANA,2006,Service (Government),0,13,28,8,0,49,0,5,5,0,0,10,59
107,HARYANA,2006,Service (Private),0,129,127,58,7,321,0,12,23,15,4,54,375
108,HARYANA,2006,Public Sector Undertaking,0,14,50,14,0,78,0,16,5,0,0,21,99
109,HARYANA,2006,Student,8,75,3,0,0,86,10,30,0,0,0,40,126
110,HARYANA,2006,Unemployed,1,81,105,51,5,243,0,5,7,2,1,15,258
111,HARYANA,2006,Self-employed (Business activity),0,17,33,25,14,89,0,4,8,0,0,12,101
112,HARYANA,2006,Professional Activity,0,10,8,6,0,24,0,2,0,0,0,2,26
113,HARYANA,2006,Farming/Agriculture Activity,0,48,78,35,20,181,0,6,2,1,0,9,190
114,HARYANA,2006,Others (Please Specify),2,88,75,40,13,218,0,2,5,5,3,15,233
115,HARYANA,2006,Retired Person,1,20,18,10,5,54,0,1,0,0,0,1,55
116,HARYANA,2006,Others (Please Specify),13,115,176,91,28,423,9,17,12,8,6,52,475
117,HARYANA,2006,Total,25,610,701,338,92,1766,21,252,177,71,29,550,2316
118,HARYANA,2006,Total Salaried,0,156,205,80,7,448,0,33,33,15,4,85,533
119,HARYANA,2006,Total Self-employed,2,163,194,106,47,512,0,14,15,6,3,38,550
120,HIMACHAL PRADESH,2006,House Wife,0,0,0,0,0,0,0,31,22,21,4,78,78
121,HIMACHAL PRADESH,2006,Service (Government),0,7,8,6,0,21,0,0,0,1,0,1,22
122,HIMACHAL PRADESH,2006,Service (Private),0,12,19,15,1,47,0,6,1,3,0,10,57
123,HIMACHAL PRADESH,2006,Public Sector Undertaking,0,10,24,4,2,40,0,1,0,0,0,1,41
124,HIMACHAL PRADESH,2006,Student,4,14,2,0,0,20,1,18,1,0,0,20,40
125,HIMACHAL PRADESH,2006,Unemployed,0,10,13,8,1,32,0,0,0,0,0,0,32
126,HIMACHAL PRADESH,2006,Self-employed (Business activity),0,3,7,3,4,17,0,0,0,0,0,0,17
127,HIMACHAL PRADESH,2006,Professional Activity,0,0,3,1,0,4,0,0,0,0,0,0,4
128,HIMACHAL PRADESH,2006,Farming/Agriculture Activity,0,7,11,3,1,22,0,0,0,0,0,0,22
129,HIMACHAL PRADESH,2006,Others (Please Specify),0,2,0,0,0,2,0,0,0,0,0,0,2
130,HIMACHAL PRADESH,2006,Retired Person,0,0,0,0,1,1,0,0,0,0,0,0,1
131,HIMACHAL PRADESH,2006,Others (Please Specify),0,25,34,25,11,95,0,11,19,12,4,46,141
132,HIMACHAL PRADESH,2006,Total,4,90,121,65,21,301,1,67,43,37,8,156,457
133,HIMACHAL PRADESH,2006,Total Salaried,0,29,51,25,3,108,0,7,1,4,0,12,120
134,HIMACHAL PRADESH,2006,Total Self-employed,0,12,21,7,5,45,0,0,0,0,0,0,45
135,JAMMU & KASHMIR,2006,House Wife,0,0,0,0,0,0,0,20,20,2,0,42,42
136,JAMMU & KASHMIR,2006,Service (Government),0,11,9,4,0,24,0,2,1,0,0,3,27
137,JAMMU & KASHMIR,2006,Service (Private),0,2,2,3,1,8,0,2,1,1,0,4,12
138,JAMMU & KASHMIR,2006,Public Sector Undertaking,0,1,0,1,0,2,0,0,0,0,0,0,2
139,JAMMU & KASHMIR,2006,Student,0,7,0,0,0,7,0,15,0,0,0,15,22
140,JAMMU & KASHMIR,2006,Unemployed,0,15,11,0,0,26,0,6,1,1,0,8,34
141,JAMMU & KASHMIR,2006,Self-employed (Business activity),0,1,1,0,0,2,0,0,0,0,0,0,2
142,JAMMU & KASHMIR,2006,Professional Activity,0,0,0,0,0,0,0,5,0,0,0,5,5
143,JAMMU & KASHMIR,2006,Farming/Agriculture Activity,1,10,12,6,1,30,0,2,1,1,0,4,34
144,JAMMU & KASHMIR,2006,Others (Please Specify),0,6,6,7,1,20,0,8,5,4,0,17,37
145,JAMMU & KASHMIR,2006,Retired Person,0,0,0,0,2,2,0,0,0,0,0,0,2
146,JAMMU & KASHMIR,2006,Others (Please Specify),0,11,15,4,1,31,0,8,4,0,0,12,43
147,JAMMU & KASHMIR,2006,Total,1,64,56,25,6,152,0,68,33,9,0,110,262
148,JAMMU & KASHMIR,2006,Total Salaried,0,14,11,8,1,34,0,4,2,1,0,7,41
149,JAMMU & KASHMIR,2006,Total Self-employed,1,17,19,13,2,52,0,15,6,5,0,26,78
150,JHARKHAND,2006,House Wife,0,0,0,0,0,0,1,94,70,23,2,190,190
151,JHARKHAND,2006,Service (Government),0,5,5,10,0,20,0,0,6,0,0,6,26
152,JHARKHAND,2006,Service (Private),0,20,12,8,0,40,0,2,5,1,0,8,48
153,JHARKHAND,2006,Public Sector Undertaking,0,1,0,0,0,1,0,0,0,0,0,0,1
154,JHARKHAND,2006,Student,10,58,1,2,0,71,5,35,0,0,0,40,111
155,JHARKHAND,2006,Unemployed,0,31,37,12,1,81,1,6,7,0,0,14,95
156,JHARKHAND,2006,Self-employed (Business activity),0,12,4,2,0,18,0,1,0,1,0,2,20
157,JHARKHAND,2006,Professional Activity,0,5,24,5,0,34,0,0,0,0,0,0,34
158,JHARKHAND,2006,Farming/Agriculture Activity,0,19,53,30,1,103,0,0,0,0,0,0,103
159,JHARKHAND,2006,Others (Please Specify),4,21,18,7,3,53,2,2,0,0,0,4,57
160,JHARKHAND,2006,Retired Person,0,2,1,0,6,9,0,0,0,0,0,0,9
161,JHARKHAND,2006,Others (Please Specify),7,16,38,19,11,91,6,18,32,13,2,71,162
162,JHARKHAND,2006,Total,21,190,193,95,22,521,15,158,120,38,4,335,856
163,JHARKHAND,2006,Total Salaried,0,26,17,18,0,61,0,2,11,1,0,14,75
164,JHARKHAND,2006,Total Self-employed,4,57,99,44,4,208,2,3,0,1,0,6,214
165,KARNATAKA,2006,House Wife,0,0,0,0,0,0,0,697,649,369,136,1851,1851
166,KARNATAKA,2006,Service (Government),0,68,71,75,0,214,0,11,6,7,0,24,238
167,KARNATAKA,2006,Service (Private),2,285,362,343,46,1038,0,65,48,28,3,144,1182
168,KARNATAKA,2006,Public Sector Undertaking,0,47,41,43,5,136,0,16,9,8,1,34,170
169,KARNATAKA,2006,Student,25,173,15,14,3,230,38,174,5,0,0,217,447
170,KARNATAKA,2006,Unemployed,0,162,146,59,31,398,0,53,14,16,7,90,488
171,KARNATAKA,2006,Self-employed (Business activity),2,133,140,101,20,396,1,15,22,4,2,44,440
172,KARNATAKA,2006,Professional Activity,12,64,76,44,14,210,1,4,4,2,2,13,223
173,KARNATAKA,2006,Farming/Agriculture Activity,2,348,576,395,129,1450,5,90,97,56,22,270,1720
174,KARNATAKA,2006,Others (Please Specify),14,377,622,480,206,1699,6,145,109,72,29,361,2060
175,KARNATAKA,2006,Retired Person,0,0,1,6,21,28,0,0,0,0,1,1,29
176,KARNATAKA,2006,Others (Please Specify),94,650,790,465,250,2249,80,483,362,128,62,1115,3364
177,KARNATAKA,2006,Total,151,2307,2840,2025,725,8048,131,1753,1325,690,265,4164,12212
178,KARNATAKA,2006,Total Salaried,2,400,474,461,51,1388,0,92,63,43,4,202,1590
179,KARNATAKA,2006,Total Self-employed,30,922,1414,1020,369,3755,13,254,232,134,55,688,4443
180,KERALA,2006,House Wife,0,0,0,0,0,0,0,289,404,388,269,1350,1350
181,KERALA,2006,Service (Government),0,3,31,41,0,75,0,2,5,7,0,14,89
182,KERALA,2006,Service (Private),0,75,148,134,13,370,0,27,27,7,1,62,432
183,KERALA,2006,Public Sector Undertaking,0,3,29,22,4,58,0,4,7,7,2,20,78
184,KERALA,2006,Student,45,71,0,0,0,116,53,102,0,0,0,155,271
185,KERALA,2006,Unemployed,1,210,348,283,157,999,0,101,54,29,34,218,1217
186,KERALA,2006,Self-employed (Business activity),0,41,138,156,38,373,0,3,0,1,0,4,377
187,KERALA,2006,Professional Activity,0,43,82,69,16,210,0,8,7,5,0,20,230
188,KERALA,2006,Farming/Agriculture Activity,0,86,273,420,249,1028,0,9,26,37,24,96,1124
189,KERALA,2006,Others (Please Specify),5,389,685,710,524,2313,6,103,86,79,83,357,2670
190,KERALA,2006,Retired Person,0,0,8,38,65,111,0,0,0,5,12,17,128
191,KERALA,2006,Others (Please Specify),3,145,249,326,207,930,1,34,24,37,34,130,1060
192,KERALA,2006,Total,54,1066,1991,2199,1273,6583,60,682,640,602,459,2443,9026
193,KERALA,2006,Total Salaried,0,81,208,197,17,503,0,33,39,21,3,96,599
194,KERALA,2006,Total Self-employed,5,559,1178,1355,827,3924,6,123,119,122,107,477,4401
195,MADHYA PRADESH,2006,House Wife,0,0,0,0,0,0,13,1026,595,184,83,1901,1901
196,MADHYA PRADESH,2006,Service (Government),1,18,22,27,0,68,0,20,8,0,0,28,96
197,MADHYA PRADESH,2006,Service (Private),2,64,72,51,9,198,0,49,15,4,1,69,267
198,MADHYA PRADESH,2006,Public Sector Undertaking,2,37,45,17,4,105,2,14,4,4,0,24,129
199,MADHYA PRADESH,2006,Student,36,140,12,5,5,198,36,111,15,5,0,167,365
200,MADHYA PRADESH,2006,Unemployed,2,124,76,52,20,274,0,9,6,7,0,22,296
201,MADHYA PRADESH,2006,Self-employed (Business activity),3,46,84,46,20,199,0,6,2,0,0,8,207
202,MADHYA PRADESH,2006,Professional Activity,0,62,58,25,8,153,0,3,5,2,2,12,165
203,MADHYA PRADESH,2006,Farming/Agriculture Activity,20,349,448,241,120,1178,5,110,62,18,2,197,1375
204,MADHYA PRADESH,2006,Others (Please Specify),14,198,244,148,71,675,12,103,61,18,14,208,883
205,MADHYA PRADESH,2006,Retired Person,0,0,0,1,8,9,0,0,0,0,0,0,9
206,MADHYA PRADESH,2006,Others (Please Specify),16,129,166,101,34,446,15,108,117,43,13,296,742
207,MADHYA PRADESH,2006,Total,96,1167,1227,714,299,3503,83,1559,890,285,115,2932,6435
208,MADHYA PRADESH,2006,Total Salaried,5,119,139,95,13,371,2,83,27,8,1,121,492
209,MADHYA PRADESH,2006,Total Self-employed,37,655,834,460,219,2205,17,222,130,38,18,425,2630
210,MAHARASHTRA,2006,House Wife,0,0,0,0,0,0,1,1911,1067,409,265,3653,3653
211,MAHARASHTRA,2006,Service (Government),0,95,202,135,0,432,0,19,25,6,0,50,482
212,MAHARASHTRA,2006,Service (Private),0,400,536,271,34,1241,0,64,27,11,2,104,1345
213,MAHARASHTRA,2006,Public Sector Undertaking,0,37,78,40,5,160,0,5,6,1,0,12,172
214,MAHARASHTRA,2006,Student,54,389,1,0,0,444,70,368,0,0,0,438,882
215,MAHARASHTRA,2006,Unemployed,4,388,341,108,31,872,2,52,12,6,0,72,944
216,MAHARASHTRA,2006,Self-employed (Business activity),0,148,203,98,23,472,0,8,10,0,1,19,491
217,MAHARASHTRA,2006,Professional Activity,0,156,287,159,51,653,0,25,23,7,1,56,709
218,MAHARASHTRA,2006,Farming/Agriculture Activity,7,942,1589,1032,541,4111,3,142,113,57,27,342,4453
219,MAHARASHTRA,2006,Others (Please Specify),3,463,712,409,170,1757,6,82,77,28,21,214,1971
220,MAHARASHTRA,2006,Retired Person,0,0,1,25,106,132,0,0,0,0,8,8,140
221,MAHARASHTRA,2006,Others (Please Specify),0,70,92,49,25,236,3,7,6,0,0,16,252
222,MAHARASHTRA,2006,Total,68,3088,4042,2326,986,10510,85,2683,1366,525,325,4984,15494
223,MAHARASHTRA,2006,Total Salaried,0,532,816,446,39,1833,0,88,58,18,2,166,1999
224,MAHARASHTRA,2006,Total Self-employed,10,1709,2791,1698,785,6993,9,257,223,92,50,631,7624
225,MANIPUR,2006,House Wife,0,0,0,0,0,0,0,2,1,0,0,3,3
226,MANIPUR,2006,Service (Government),0,3,8,2,0,13,0,0,0,0,0,0,13
227,MANIPUR,2006,Service (Private),0,0,0,0,0,0,0,0,0,0,0,0,0
228,MANIPUR,2006,Public Sector Undertaking,0,0,0,0,0,0,0,0,0,0,0,0,0
229,MANIPUR,2006,Student,0,4,0,0,0,4,0,9,0,0,0,9,13
230,MANIPUR,2006,Unemployed,0,0,2,2,1,5,0,0,0,0,0,0,5
231,MANIPUR,2006,Self-employed (Business activity),0,0,0,0,0,0,0,0,0,0,0,0,0
232,MANIPUR,2006,Professional Activity,0,0,0,0,0,0,0,0,0,0,0,0,0
233,MANIPUR,2006,Farming/Agriculture Activity,0,0,0,0,0,0,0,0,0,0,0,0,0
234,MANIPUR,2006,Others (Please Specify),0,0,0,1,0,1,0,0,0,0,0,0,1
235,MANIPUR,2006,Retired Person,0,0,0,0,0,0,0,0,0,0,0,0,0
236,MANIPUR,2006,Others (Please Specify),0,0,1,0,0,1,0,0,0,0,0,0,1
237,MANIPUR,2006,Total,0,7,11,5,1,24,0,11,1,0,0,12,36
238,MANIPUR,2006,Total Salaried,0,3,8,2,0,13,0,0,0,0,0,0,13
239,MANIPUR,2006,Total Self-employed,0,0,0,1,0,1,0,0,0,0,0,0,1
240,MEGHALAYA,2006,House Wife,0,0,0,0,0,0,0,6,5,0,0,11,11
241,MEGHALAYA,2006,Service (Government),0,3,5,0,0,8,0,0,0,0,0,0,8
242,MEGHALAYA,2006,Service (Private),0,1,2,2,0,5,0,0,0,0,0,0,5
243,MEGHALAYA,2006,Public Sector Undertaking,0,0,1,0,0,1,0,0,0,0,0,0,1
244,MEGHALAYA,2006,Student,1,3,0,0,0,4,1,5,0,0,0,6,10
245,MEGHALAYA,2006,Unemployed,0,9,1,0,0,10,0,2,0,0,0,2,12
246,MEGHALAYA,2006,Self-employed (Business activity),0,15,3,0,0,18,0,0,0,0,0,0,18
247,MEGHALAYA,2006,Professional Activity,0,0,0,0,0,0,0,0,0,0,0,0,0
248,MEGHALAYA,2006,Farming/Agriculture Activity,0,1,1,1,0,3,0,0,0,0,0,0,3
249,MEGHALAYA,2006,Others (Please Specify),0,5,5,1,3,14,0,3,0,0,0,3,17
250,MEGHALAYA,2006,Retired Person,0,0,0,0,0,0,0,0,0,0,0,0,0
251,MEGHALAYA,2006,Others (Please Specify),0,3,1,1,1,6,0,1,0,0,0,1,7
252,MEGHALAYA,2006,Total,1,40,19,5,4,69,1,17,5,0,0,23,92
253,MEGHALAYA,2006,Total Salaried,0,4,8,2,0,14,0,0,0,0,0,0,14
254,MEGHALAYA,2006,Total Self-employed,0,21,9,2,3,35,0,3,0,0,0,3,38
255,MIZORAM,2006,House Wife,0,0,0,0,0,0,0,1,0,3,0,4,4
256,MIZORAM,2006,Service (Government),0,2,2,1,0,5,0,0,0,0,0,0,5
257,MIZORAM,2006,Service (Private),0,3,0,0,0,3,0,0,0,0,0,0,3
258,MIZORAM,2006,Public Sector Undertaking,0,3,0,0,0,3,0,0,0,0,0,0,3
259,MIZORAM,2006,Student,0,2,2,0,0,4,0,0,0,0,0,0,4
260,MIZORAM,2006,Unemployed,0,5,0,1,0,6,0,0,0,0,0,0,6
261,MIZORAM,2006,Self-employed (Business activity),0,0,0,0,0,0,0,0,0,0,0,0,0
262,MIZORAM,2006,Professional Activity,0,0,0,0,0,0,0,0,0,0,0,0,0
263,MIZORAM,2006,Farming/Agriculture Activity,0,0,1,0,0,1,0,0,0,0,0,0,1
264,MIZORAM,2006,Others (Please Specify),0,2,0,1,2,5,0,0,0,0,0,0,5
265,MIZORAM,2006,Retired Person,0,0,0,0,0,0,0,0,0,0,0,0,0
266,MIZORAM,2006,Others (Please Specify),0,14,17,0,2,33,0,4,2,0,0,6,39
267,MIZORAM,2006,Total,0,31,22,3,4,60,0,5,2,3,0,10,70
268,MIZORAM,2006,Total Salaried,0,8,2,1,0,11,0,0,0,0,0,0,11
269,MIZORAM,2006,Total Self-employed,0,2,1,1,2,6,0,0,0,0,0,0,6
270,NAGALAND,2006,House Wife,0,0,0,0,0,0,0,0,4,1,0,5,5
271,NAGALAND,2006,Service (Government),0,3,2,0,0,5,0,0,0,0,0,0,5
272,NAGALAND,2006,Service (Private),0,0,0,0,0,0,0,0,0,0,0,0,0
273,NAGALAND,2006,Public Sector Undertaking,0,0,0,0,0,0,0,0,0,0,0,0,0
274,NAGALAND,2006,Student,0,1,1,0,0,2,0,0,0,0,0,0,2
275,NAGALAND,2006,Unemployed,1,4,2,0,0,7,0,0,0,0,0,0,7
276,NAGALAND,2006,Self-employed (Business activity),0,0,0,1,0,1,0,0,0,0,0,0,1
277,NAGALAND,2006,Professional Activity,0,0,0,0,0,0,0,0,0,0,0,0,0
278,NAGALAND,2006,Farming/Agriculture Activity,0,0,0,1,0,1,0,1,0,0,0,1,2
279,NAGALAND,2006,Others (Please Specify),0,1,1,1,0,3,0,2,0,0,0,2,5
280,NAGALAND,2006,Retired Person,0,0,0,0,0,0,0,0,0,0,0,0,0
281,NAGALAND,2006,Others (Please Specify),0,0,0,0,0,0,0,1,0,0,0,1,1
282,NAGALAND,2006,Total,1,9,6,3,0,19,0,4,4,1,0,9,28
283,NAGALAND,2006,Total Salaried,0,3,2,0,0,5,0,0,0,0,0,0,5
284,NAGALAND,2006,Total Self-employed,0,1,1,3,0,5,0,3,0,0,0,3,8
285,ODISHA,2006,House Wife,0,0,0,0,0,0,0,254,191,64,22,531,531
286,ODISHA,2006,Service (Government),0,6,8,4,0,18,0,4,1,0,0,5,23
287,ODISHA,2006,Service (Private),0,45,51,30,7,133,0,37,32,23,0,92,225
288,ODISHA,2006,Public Sector Undertaking,0,8,16,8,0,32,0,8,9,0,0,17,49
289,ODISHA,2006,Student,18,80,14,0,0,112,29,98,32,0,0,159,271
290,ODISHA,2006,Unemployed,0,128,136,32,11,307,0,57,33,10,0,100,407
291,ODISHA,2006,Self-employed (Business activity),0,58,118,66,16,258,1,13,10,10,0,34,292
292,ODISHA,2006,Professional Activity,2,23,29,26,3,83,1,12,2,2,0,17,100
293,ODISHA,2006,Farming/Agriculture Activity,2,76,79,53,31,241,0,7,12,15,8,42,283
294,ODISHA,2006,Others (Please Specify),11,202,270,184,85,752,19,147,156,84,29,435,1187
295,ODISHA,2006,Retired Person,0,0,0,2,16,18,0,0,0,0,1,1,19
296,ODISHA,2006,Others (Please Specify),10,115,149,88,57,419,9,110,87,39,14,259,678
297,ODISHA,2006,Total,43,741,870,493,226,2373,59,747,565,247,74,1692,4065
298,ODISHA,2006,Total Salaried,0,59,75,42,7,183,0,49,42,23,0,114,297
299,ODISHA,2006,Total Self-employed,15,359,496,329,135,1334,21,179,180,111,37,528,1862
300,PUNJAB,2006,House Wife,0,0,0,0,0,0,1,49,45,15,0,110,110
301,PUNJAB,2006,Service (Government),0,5,7,4,0,16,0,0,0,0,0,0,16
302,PUNJAB,2006,Service (Private),0,23,25,7,1,56,0,3,1,0,0,4,60
303,PUNJAB,2006,Public Sector Undertaking,0,1,2,2,0,5,0,1,0,0,0,1,6
304,PUNJAB,2006,Student,2,15,1,0,0,18,2,11,0,0,0,13,31
305,PUNJAB,2006,Unemployed,0,29,22,8,7,66,0,2,0,0,0,2,68
306,PUNJAB,2006,Self-employed (Business activity),0,6,10,6,1,23,0,0,0,0,0,0,23
307,PUNJAB,2006,Professional Activity,0,18,10,12,7,47,0,0,0,0,0,0,47
308,PUNJAB,2006,Farming/Agriculture Activity,0,27,28,22,8,85,0,0,0,0,0,0,85
309,PUNJAB,2006,Others (Please Specify),3,38,47,28,5,121,1,6,2,0,0,9,130
310,PUNJAB,2006,Retired Person,0,0,0,0,1,1,0,0,0,0,0,0,1
311,PUNJAB,2006,Others (Please Specify),6,54,59,35,18,172,12,7,1,1,2,23,195
312,PUNJAB,2006,Total,11,216,211,124,48,610,16,79,49,16,2,162,772
313,PUNJAB,2006,Total Salaried,0,29,34,13,1,77,0,4,1,0,0,5,82
314,PUNJAB,2006,Total Self-employed,3,89,95,68,21,276,1,6,2,0,0,9,285
315,RAJASTHAN,2006,House Wife,0,0,0,0,0,0,9,487,415,151,31,1093,1093
316,RAJASTHAN,2006,Service (Government),0,5,21,14,0,40,0,0,0,0,0,0,40
317,RAJASTHAN,2006,Service (Private),0,119,153,65,1,338,0,6,5,0,0,11,349
318,RAJASTHAN,2006,Public Sector Undertaking,0,13,11,5,0,29,0,2,2,0,0,4,33
319,RAJASTHAN,2006,Student,15,53,2,0,0,70,15,49,0,0,0,64,134
320,RAJASTHAN,2006,Unemployed,0,59,23,14,1,97,0,0,0,0,0,0,97
321,RAJASTHAN,2006,Self-employed (Business activity),0,58,78,32,3,171,0,5,0,0,0,5,176
322,RAJASTHAN,2006,Professional Activity,0,8,8,3,0,19,0,0,0,0,0,0,19
323,RAJASTHAN,2006,Farming/Agriculture Activity,2,85,147,101,21,356,0,16,18,4,1,39,395
324,RAJASTHAN,2006,Others (Please Specify),2,228,306,136,33,705,6,26,13,9,1,55,760
325,RAJASTHAN,2006,Retired Person,0,0,0,2,0,2,0,0,1,0,0,1,3
326,RAJASTHAN,2006,Others (Please Specify),40,288,423,257,75,1083,16,18,15,22,10,81,1164
327,RAJASTHAN,2006,Total,59,916,1172,629,134,2910,46,609,469,186,43,1353,4263
328,RAJASTHAN,2006,Total Salaried,0,137,185,84,1,407,0,8,7,0,0,15,422
329,RAJASTHAN,2006,Total Self-employed,4,379,539,272,57,1251,6,47,31,13,2,99,1350
330,SIKKIM,2006,House Wife,0,0,0,0,0,0,0,0,10,1,4,15,15
331,SIKKIM,2006,Service (Government),0,4,0,0,0,4,0,0,0,0,0,0,4
332,SIKKIM,2006,Service (Private),0,6,5,2,0,13,0,0,1,0,0,1,14
333,SIKKIM,2006,Public Sector Undertaking,0,0,0,0,0,0,0,0,0,0,0,0,0
334,SIKKIM,2006,Student,4,20,0,0,0,24,3,10,2,0,0,15,39
335,SIKKIM,2006,Unemployed,0,0,10,8,0,18,0,0,0,0,0,0,18
336,SIKKIM,2006,Self-employed (Business activity),0,0,3,0,0,3,0,0,0,0,0,0,3
337,SIKKIM,2006,Professional Activity,0,0,0,0,0,0,0,0,0,0,0,0,0
338,SIKKIM,2006,Farming/Agriculture Activity,0,10,13,4,0,27,0,8,0,0,0,8,35
339,SIKKIM,2006,Others (Please Specify),0,9,0,0,0,9,0,8,0,0,0,8,17
340,SIKKIM,2006,Retired Person,0,0,0,0,0,0,0,0,0,0,0,0,0
341,SIKKIM,2006,Others (Please Specify),0,0,0,0,0,0,0,0,0,0,0,0,0
342,SIKKIM,2006,Total,4,49,31,14,0,98,3,26,13,1,4,47,145
343,SIKKIM,2006,Total Salaried,0,10,5,2,0,17,0,0,1,0,0,1,18
344,SIKKIM,2006,Total Self-employed,0,19,16,4,0,39,0,16,0,0,0,16,55
345,TAMIL NADU,2006,House Wife,0,0,0,0,0,0,0,830,947,451,126,2354,2354
346,TAMIL NADU,2006,Service (Government),0,20,89,45,1,155,0,10,8,7,5,30,185
347,TAMIL NADU,2006,Service (Private),0,279,449,291,73,1092,0,462,101,58,7,628,1720
348,TAMIL NADU,2006,Public Sector Undertaking,0,49,107,60,29,245,0,15,11,59,1,86,331
349,TAMIL NADU,2006,Student,26,65,8,0,0,99,36,84,7,0,0,127,226
350,TAMIL NADU,2006,Unemployed,0,364,116,170,96,746,0,240,122,86,33,481,1227
351,TAMIL NADU,2006,Self-employed (Business activity),0,135,779,174,30,1118,0,8,76,3,0,87,1205
352,TAMIL NADU,2006,Professional Activity,0,0,0,0,0,0,0,0,0,0,0,0,0
353,TAMIL NADU,2006,Farming/Agriculture Activity,0,78,147,82,35,342,0,23,40,19,2,84,426
354,TAMIL NADU,2006,Others (Please Specify),0,757,700,822,281,2560,0,224,180,107,70,581,3141
355,TAMIL NADU,2006,Retired Person,0,0,0,10,77,87,0,0,0,0,15,15,102
356,TAMIL NADU,2006,Others (Please Specify),0,249,402,281,133,1065,44,99,129,80,47,399,1464
357,TAMIL NADU,2006,Total,26,1996,2797,1935,755,7509,80,1995,1621,870,306,4872,12381
358,TAMIL NADU,2006,Total Salaried,0,348,645,396,103,1492,0,487,120,124,13,744,2236
359,TAMIL NADU,2006,Total Self-employed,0,970,1626,1078,346,4020,0,255,296,129,72,752,4772
360,TRIPURA,2006,House Wife,0,0,0,0,0,0,0,72,48,10,3,133,133
361,TRIPURA,2006,Service (Government),0,1,5,4,0,10,0,0,0,0,0,0,10
362,TRIPURA,2006,Service (Private),0,2,3,2,0,7,0,0,0,0,0,0,7
363,TRIPURA,2006,Public Sector Undertaking,0,2,2,2,0,6,0,0,0,0,0,0,6
364,TRIPURA,2006,Student,4,27,12,0,0,43,7,31,3,0,0,41,84
365,TRIPURA,2006,Unemployed,0,19,23,3,0,45,0,13,4,0,0,17,62
366,TRIPURA,2006,Self-employed (Business activity),0,2,7,5,4,18,0,0,0,0,0,0,18
367,TRIPURA,2006,Professional Activity,0,3,4,0,0,7,0,0,0,0,0,0,7
368,TRIPURA,2006,Farming/Agriculture Activity,0,0,5,2,0,7,0,0,0,0,0,0,7
369,TRIPURA,2006,Others (Please Specify),2,7,22,10,6,47,0,3,2,1,0,6,53
370,TRIPURA,2006,Retired Person,0,0,0,0,0,0,0,0,0,0,0,0,0
371,TRIPURA,2006,Others (Please Specify),5,82,84,50,17,238,4,49,61,23,3,140,378
372,TRIPURA,2006,Total,11,145,167,78,27,428,11,168,118,34,6,337,765
373,TRIPURA,2006,Total Salaried,0,5,10,8,0,23,0,0,0,0,0,0,23
374,TRIPURA,2006,Total Self-employed,2,12,38,17,10,79,0,3,2,1,0,6,85
375,UTTAR PRADESH,2006,House Wife,0,0,0,0,0,0,8,446,186,39,31,710,710
376,UTTAR PRADESH,2006,Service (Government),0,52,34,20,9,115,0,13,8,8,3,32,147
377,UTTAR PRADESH,2006,Service (Private),2,79,53,18,3,155,0,27,28,3,0,58,213
378,UTTAR PRADESH,2006,Public Sector Undertaking,0,9,15,4,0,28,0,13,5,1,0,19,47
379,UTTAR PRADESH,2006,Student,14,88,0,0,0,102,5,62,2,0,0,69,171
380,UTTAR PRADESH,2006,Unemployed,1,58,116,17,9,201,0,24,14,1,1,40,241
381,UTTAR PRADESH,2006,Self-employed (Business activity),0,44,40,36,29,149,0,7,8,3,2,20,169
382,UTTAR PRADESH,2006,Professional Activity,0,33,20,14,3,70,0,6,3,8,0,17,87
383,UTTAR PRADESH,2006,Farming/Agriculture Activity,1,125,150,49,21,346,6,27,22,6,4,65,411
384,UTTAR PRADESH,2006,Others (Please Specify),36,125,102,63,20,346,24,69,71,25,9,198,544
385,UTTAR PRADESH,2006,Retired Person,0,0,0,4,3,7,0,0,0,0,0,0,7
386,UTTAR PRADESH,2006,Others (Please Specify),11,16,143,51,21,242,11,43,15,26,15,110,352
387,UTTAR PRADESH,2006,Total,65,629,673,276,118,1761,54,737,362,120,65,1338,3099
388,UTTAR PRADESH,2006,Total Salaried,2,140,102,42,12,298,0,53,41,12,3,109,407
389,UTTAR PRADESH,2006,Total Self-employed,37,327,312,162,73,911,30,109,104,42,15,300,1211
390,UTTARAKHAND,2006,House Wife,0,0,0,0,0,0,0,43,33,8,2,86,86
391,UTTARAKHAND,2006,Service (Government),0,4,7,2,0,13,0,0,0,1,0,1,14
392,UTTARAKHAND,2006,Service (Private),0,4,9,4,1,18,0,3,4,1,1,9,27
393,UTTARAKHAND,2006,Public Sector Undertaking,0,1,3,2,0,6,0,3,2,1,0,6,12
394,UTTARAKHAND,2006,Student,0,4,0,0,0,4,1,6,3,0,0,10,14
395,UTTARAKHAND,2006,Unemployed,0,6,6,5,2,19,0,2,2,1,0,5,24
396,UTTARAKHAND,2006,Self-employed (Business activity),0,5,8,6,2,21,0,2,0,0,0,2,23
397,UTTARAKHAND,2006,Professional Activity,0,0,4,2,0,6,0,2,1,0,0,3,9
398,UTTARAKHAND,2006,Farming/Agriculture Activity,0,10,12,10,1,33,0,9,8,1,0,18,51
399,UTTARAKHAND,2006,Others (Please Specify),0,3,4,5,3,15,1,1,0,0,0,2,17
400,UTTARAKHAND,2006,Retired Person,0,0,0,0,4,4,0,0,0,0,0,0,4
401,UTTARAKHAND,2006,Others (Please Specify),0,14,17,3,0,34,3,6,2,0,0,11,45
402,UTTARAKHAND,2006,Total,0,51,70,39,13,173,5,77,55,13,3,153,326
403,UTTARAKHAND,2006,Total Salaried,0,9,19,8,1,37,0,6,6,3,1,16,53
404,UTTARAKHAND,2006,Total Self-employed,0,18,28,23,6,75,1,14,9,1,0,25,100
405,WEST BENGAL,2006,House Wife,0,0,0,0,0,0,0,2263,1584,1111,62,5020,5020
406,WEST BENGAL,2006,Service (Government),0,20,81,62,0,163,0,8,16,12,0,36,199
407,WEST BENGAL,2006,Service (Private),0,93,339,256,0,688,0,36,65,29,0,130,818
408,WEST BENGAL,2006,Public Sector Undertaking,0,265,388,123,0,776,0,33,25,21,0,79,855
409,WEST BENGAL,2006,Student,146,491,2,0,0,639,184,317,1,0,0,502,1141
410,WEST BENGAL,2006,Unemployed,0,928,639,0,0,1567,0,144,37,0,0,181,1748
411,WEST BENGAL,2006,Self-employed (Business activity),0,338,688,335,39,1400,0,10,33,8,0,51,1451
412,WEST BENGAL,2006,Professional Activity,0,182,242,279,35,738,0,23,12,3,0,38,776
413,WEST BENGAL,2006,Farming/Agriculture Activity,0,196,455,256,56,963,0,85,105,31,5,226,1189
414,WEST BENGAL,2006,Others (Please Specify),0,521,627,562,113,1823,0,78,34,18,158,288,2111
415,WEST BENGAL,2006,Retired Person,0,0,0,0,297,297,0,0,0,0,46,46,343
416,WEST BENGAL,2006,Others (Please Specify),4,3,14,20,25,66,0,1,1,1,5,8,74
417,WEST BENGAL,2006,Total,150,3037,3475,1893,565,9120,184,2998,1913,1234,276,6605,15725
418,WEST BENGAL,2006,Total Salaried,0,378,808,441,0,1627,0,77,106,62,0,245,1872
419,WEST BENGAL,2006,Total Self-employed,0,1237,2012,1432,243,4924,0,196,184,60,163,603,5527
420,TOTAL (STATES),2006,House Wife,0,0,0,0,0,0,40,11044,8215,3991,1281,24571,24571
421,TOTAL (STATES),2006,Service (Government),5,424,783,547,12,1771,0,120,124,54,8,306,2077
422,TOTAL (STATES),2006,Service (Private),6,2013,2940,1885,221,7065,0,879,453,200,19,1551,8616
423,TOTAL (STATES),2006,Public Sector Undertaking,2,600,923,418,56,1999,2,151,110,106,4,373,2372
424,TOTAL (STATES),2006,Student,553,2345,107,25,8,3038,615,1917,83,5,0,2620,5658
425,TOTAL (STATES),2006,Unemployed,10,3084,2551,1032,386,7063,5,788,364,166,76,1399,8462
426,TOTAL (STATES),2006,Self-employed (Business activity),5,1586,3031,1516,316,6454,2,139,208,65,9,423,6877
427,TOTAL (STATES),2006,Professional Activity,16,851,1358,971,208,3404,5,112,77,35,6,235,3639
428,TOTAL (STATES),2006,Farming/Agriculture Activity,56,3496,5678,3650,1593,14473,58,921,845,426,140,2390,16863
429,TOTAL (STATES),2006,Others (Please Specify),177,4574,5793,4386,1802,16732,180,1456,1048,582,542,3808,20540
430,TOTAL (STATES),2006,Retired Person,1,27,34,135,749,946,0,1,6,12,135,154,1100
431,TOTAL (STATES),2006,Others (Please Specify),345,3162,4063,2516,1172,11258,332,1445,1148,570,287,3782,15040
432,TOTAL (STATES),2006,Total,1176,22162,27261,17081,6523,74203,1239,18973,12681,6212,2507,41612,115815
433,TOTAL (STATES),2006,Total Salaried,13,3037,4646,2850,289,10835,2,1150,687,360,31,2230,13065
434,TOTAL (STATES),2006,Total Self-employed,254,10507,15860,10523,3919,41063,245,2628,2178,1108,697,6856,47919
435,A & N ISLANDS,2006,House Wife,0,0,0,0,0,0,0,18,10,3,2,33,33
436,A & N ISLANDS,2006,Service (Government),0,3,4,4,0,11,0,0,0,0,0,0,11
437,A & N ISLANDS,2006,Service (Private),0,10,28,18,6,62,0,1,0,0,0,1,63
438,A & N ISLANDS,2006,Public Sector Undertaking,0,0,0,0,0,0,0,0,0,0,0,0,0
439,A & N ISLANDS,2006,Student,1,0,0,0,0,1,1,2,0,0,0,3,4
440,A & N ISLANDS,2006,Unemployed,0,2,0,0,0,2,0,0,0,0,0,0,2
441,A & N ISLANDS,2006,Self-employed (Business activity),0,2,0,2,0,4,0,0,0,0,0,0,4
442,A & N ISLANDS,2006,Professional Activity,0,0,0,0,0,0,0,0,0,0,0,0,0
443,A & N ISLANDS,2006,Farming/Agriculture Activity,0,2,2,1,1,6,0,0,0,0,0,0,6
444,A & N ISLANDS,2006,Others (Please Specify),0,0,0,0,0,0,0,0,0,0,0,0,0
445,A & N ISLANDS,2006,Retired Person,0,0,0,0,0,0,0,0,0,0,0,0,0
446,A & N ISLANDS,2006,Others (Please Specify),3,2,0,0,5,10,0,0,0,0,0,0,10
447,A & N ISLANDS,2006,Total,4,21,34,25,12,96,1,21,10,3,2,37,133
448,A & N ISLANDS,2006,Total Salaried,0,13,32,22,6,73,0,1,0,0,0,1,74
449,A & N ISLANDS,2006,Total Self-employed,0,4,2,3,1,10,0,0,0,0,0,0,10
450,CHANDIGARH,2006,House Wife,0,0,0,0,0,0,0,3,6,1,1,11,11
451,CHANDIGARH,2006,Service (Government),0,2,3,2,0,7,0,0,0,0,0,0,7
452,CHANDIGARH,2006,Service (Private),0,5,8,0,0,13,0,2,0,0,0,2,15
453,CHANDIGARH,2006,Public Sector Undertaking,0,0,0,0,0,0,0,0,0,0,0,0,0
454,CHANDIGARH,2006,Student,0,11,0,0,0,11,2,7,0,0,0,9,20
455,CHANDIGARH,2006,Unemployed,0,7,15,1,0,23,0,2,0,0,0,2,25
456,CHANDIGARH,2006,Self-employed (Business activity),0,0,0,0,1,1,0,0,0,0,0,0,1
457,CHANDIGARH,2006,Professional Activity,0,0,0,0,0,0,0,0,0,0,0,0,0
458,CHANDIGARH,2006,Farming/Agriculture Activity,0,1,0,0,0,1,0,0,0,0,0,0,1
459,CHANDIGARH,2006,Others (Please Specify),0,0,0,0,0,0,0,0,0,0,0,0,0
460,CHANDIGARH,2006,Retired Person,0,0,0,0,0,0,0,0,0,0,0,0,0
461,CHANDIGARH,2006,Others (Please Specify),0,0,0,0,0,0,0,0,0,0,0,0,0
462,CHANDIGARH,2006,Total,0,26,26,3,1,56,2,14,6,1,1,24,80
463,CHANDIGARH,2006,Total Salaried,0,7,11,2,0,20,0,2,0,0,0,2,22
464,CHANDIGARH,2006,Total Self-employed,0,1,0,0,1,2,0,0,0,0,0,0,2
465,D & N HAVELI,2006,House Wife,0,0,0,0,0,0,0,7,6,2,2,17,17
466,D & N HAVELI,2006,Service (Government),0,0,0,0,0,0,0,0,0,0,0,0,0
467,D & N HAVELI,2006,Service (Private),0,2,0,0,1,3,0,0,0,0,0,0,3
468,D & N HAVELI,2006,Public Sector Undertaking,0,0,0,0,0,0,0,0,0,0,0,0,0
469,D & N HAVELI,2006,Student,0,2,0,0,0,2,0,0,0,0,0,0,2
470,D & N HAVELI,2006,Unemployed,0,3,2,0,0,5,1,1,0,0,0,2,7
471,D & N HAVELI,2006,Self-employed (Business activity),0,0,1,0,0,1,0,0,0,0,0,0,1
472,D & N HAVELI,2006,Professional Activity,0,0,0,0,0,0,0,0,0,0,0,0,0
473,D & N HAVELI,2006,Farming/Agriculture Activity,0,1,2,3,6,12,0,0,0,0,0,0,12
474,D & N HAVELI,2006,Others (Please Specify),0,0,0,0,0,0,0,0,0,0,0,0,0
475,D & N HAVELI,2006,Retired Person,0,0,0,0,0,0,0,0,0,0,0,0,0
476,D & N HAVELI,2006,Others (Please Specify),0,0,0,0,0,0,0,0,0,0,0,0,0
477,D & N HAVELI,2006,Total,0,8,5,3,7,23,1,8,6,2,2,19,42
478,D & N HAVELI,2006,Total Salaried,0,2,0,0,1,3,0,0,0,0,0,0,3
479,D & N HAVELI,2006,Total Self-employed,0,1,3,3,6,13,0,0,0,0,0,0,13
480,DAMAN & DIU,2006,House Wife,0,0,0,0,0,0,0,3,0,0,0,3,3
481,DAMAN & DIU,2006,Service (Government),0,0,0,0,0,0,0,0,0,0,0,0,0
482,DAMAN & DIU,2006,Service (Private),0,6,2,0,0,8,0,0,0,0,0,0,8
483,DAMAN & DIU,2006,Public Sector Undertaking,0,0,0,0,0,0,0,0,0,0,0,0,0
484,DAMAN & DIU,2006,Student,0,1,0,0,0,1,1,1,0,0,0,2,3
485,DAMAN & DIU,2006,Unemployed,0,0,0,0,0,0,0,0,0,0,0,0,0
486,DAMAN & DIU,2006,Self-employed (Business activity),0,0,1,0,0,1,0,0,0,0,0,0,1
487,DAMAN & DIU,2006,Professional Activity,0,0,0,0,0,0,0,0,0,0,0,0,0
488,DAMAN & DIU,2006,Farming/Agriculture Activity,0,0,0,0,0,0,0,0,0,0,0,0,0
489,DAMAN & DIU,2006,Others (Please Specify),0,0,2,0,0,2,0,0,0,0,0,0,2
490,DAMAN & DIU,2006,Retired Person,0,0,0,0,0,0,0,0,0,0,0,0,0
491,DAMAN & DIU,2006,Others (Please Specify),0,0,0,1,1,2,2,0,1,0,0,3,5
492,DAMAN & DIU,2006,Total,0,7,5,1,1,14,3,4,1,0,0,8,22
493,DAMAN & DIU,2006,Total Salaried,0,6,2,0,0,8,0,0,0,0,0,0,8
494,DAMAN & DIU,2006,Total Self-employed,0,0,3,0,0,3,0,0,0,0,0,0,3
495,DELHI (UT),2006,House Wife,0,0,0,0,0,0,0,194,111,24,2,331,331
496,DELHI (UT),2006,Service (Government),0,4,15,8,0,27,0,1,3,0,0,4,31
497,DELHI (UT),2006,Service (Private),0,116,94,37,1,248,0,15,2,0,0,17,265
498,DELHI (UT),2006,Public Sector Undertaking,0,10,11,1,0,22,1,2,0,0,0,3,25
499,DELHI (UT),2006,Student,3,52,0,0,0,55,9,53,1,0,0,63,118
500,DELHI (UT),2006,Unemployed,1,150,90,33,3,277,1,32,5,0,2,40,317
501,DELHI (UT),2006,Self-employed (Business activity),0,7,13,1,1,22,0,6,1,0,0,7,29
502,DELHI (UT),2006,Professional Activity,0,1,1,2,0,4,0,0,0,0,0,0,4
503,DELHI (UT),2006,Farming/Agriculture Activity,0,0,3,0,0,3,0,0,0,0,0,0,3
504,DELHI (UT),2006,Others (Please Specify),4,69,82,44,12,211,2,21,23,2,0,48,259
505,DELHI (UT),2006,Retired Person,0,9,5,2,1,17,0,0,0,0,0,0,17
506,DELHI (UT),2006,Others (Please Specify),1,31,26,11,5,74,3,11,2,2,1,19,93
507,DELHI (UT),2006,Total,9,449,340,139,23,960,16,335,148,28,5,532,1492
508,DELHI (UT),2006,Total Salaried,0,130,120,46,1,297,1,18,5,0,0,24,321
509,DELHI (UT),2006,Total Self-employed,4,77,99,47,13,240,2,27,24,2,0,55,295
510,LAKSHADWEEP,2006,House Wife,0,0,0,0,0,0,0,1,0,0,0,1,1
511,LAKSHADWEEP,2006,Service (Government),0,0,1,0,0,1,0,0,0,0,0,0,1
512,LAKSHADWEEP,2006,Service (Private),0,0,0,0,0,0,0,0,0,0,0,0,0
513,LAKSHADWEEP,2006,Public Sector Undertaking,0,0,0,0,0,0,0,0,0,0,0,0,0
514,LAKSHADWEEP,2006,Student,0,0,0,0,0,0,0,0,0,0,0,0,0
515,LAKSHADWEEP,2006,Unemployed,0,0,0,0,0,0,0,0,0,0,0,0,0
516,LAKSHADWEEP,2006,Self-employed (Business activity),0,0,0,0,0,0,0,0,0,0,0,0,0
517,LAKSHADWEEP,2006,Professional Activity,0,0,0,0,0,0,0,0,0,0,0,0,0
518,LAKSHADWEEP,2006,Farming/Agriculture Activity,0,0,0,0,0,0,0,0,0,0,0,0,0
519,LAKSHADWEEP,2006,Others (Please Specify),0,0,0,0,0,0,0,0,0,0,0,0,0
520,LAKSHADWEEP,2006,Retired Person,0,0,0,0,0,0,0,0,0,0,0,0,0
521,LAKSHADWEEP,2006,Others (Please Specify),0,0,0,0,0,0,0,0,0,0,0,0,0
522,LAKSHADWEEP,2006,Total,0,0,1,0,0,1,0,1,0,0,0,1,2
523,LAKSHADWEEP,2006,Total Salaried,0,0,1,0,0,1,0,0,0,0,0,0,1
524,LAKSHADWEEP,2006,Total Self-employed,0,0,0,0,0,0,0,0,0,0,0,0,0
525,PUDUCHERRY,2006,House Wife,0,0,0,0,0,0,0,47,31,10,8,96,96
526,PUDUCHERRY,2006,Service (Government),0,1,9,7,0,17,0,1,2,0,0,3,20
527,PUDUCHERRY,2006,Service (Private),0,18,29,15,2,64,0,5,2,0,0,7,71
528,PUDUCHERRY,2006,Public Sector Undertaking,0,0,1,2,1,4,0,0,0,0,0,0,4
529,PUDUCHERRY,2006,Student,5,10,0,0,0,15,8,29,0,0,0,37,52
530,PUDUCHERRY,2006,Unemployed,0,14,8,9,14,45,0,20,1,2,5,28,73
531,PUDUCHERRY,2006,Self-employed (Business activity),0,4,10,6,1,21,0,0,0,0,0,0,21
532,PUDUCHERRY,2006,Professional Activity,0,0,0,0,0,0,0,0,0,0,0,0,0
533,PUDUCHERRY,2006,Farming/Agriculture Activity,0,35,76,50,8,169,0,1,2,3,0,6,175
534,PUDUCHERRY,2006,Others (Please Specify),0,0,1,0,0,1,0,0,0,0,0,0,1
535,PUDUCHERRY,2006,Retired Person,0,0,0,0,2,2,0,0,0,0,0,0,2
536,PUDUCHERRY,2006,Others (Please Specify),0,2,3,4,2,11,0,0,0,0,0,0,11
537,PUDUCHERRY,2006,Total,5,84,137,93,30,349,8,103,38,15,13,177,526
538,PUDUCHERRY,2006,Total Salaried,0,19,39,24,3,85,0,6,4,0,0,10,95
539,PUDUCHERRY,2006,Total Self-employed,0,39,87,56,9,191,0,1,2,3,0,6,197
540,TOTAL (UTs),2006,House Wife,0,0,0,0,0,0,0,273,164,40,15,492,492
541,TOTAL (UTs),2006,Service (Government),0,10,32,21,0,63,0,2,5,0,0,7,70
542,TOTAL (UTs),2006,Service (Private),0,157,161,70,10,398,0,23,4,0,0,27,425
543,TOTAL (UTs),2006,Public Sector Undertaking,0,10,12,3,1,26,1,2,0,0,0,3,29
544,TOTAL (UTs),2006,Student,9,76,0,0,0,85,21,92,1,0,0,114,199
545,TOTAL (UTs),2006,Unemployed,1,176,115,43,17,352,2,55,6,2,7,72,424
546,TOTAL (UTs),2006,Self-employed (Business activity),0,13,25,9,3,50,0,6,1,0,0,7,57
547,TOTAL (UTs),2006,Professional Activity,0,1,1,2,0,4,0,0,0,0,0,0,4
548,TOTAL (UTs),2006,Farming/Agriculture Activity,0,39,83,54,15,191,0,1,2,3,0,6,197
549,TOTAL (UTs),2006,Others (Please Specify),4,69,85,44,12,214,2,21,23,2,0,48,262
550,TOTAL (UTs),2006,Retired Person,0,9,5,2,3,19,0,0,0,0,0,0,19
551,TOTAL (UTs),2006,Others (Please Specify),4,35,29,16,13,97,5,11,3,2,1,22,119
552,TOTAL (UTs),2006,Total,18,595,548,264,74,1499,31,486,209,49,23,798,2297
553,TOTAL (UTs),2006,Total Salaried,0,177,205,94,11,487,1,27,9,0,0,37,524
554,TOTAL (UTs),2006,Total Self-employed,4,122,194,109,30,459,2,28,26,5,0,61,520
555,TOTAL (ALL INDIA),2006,House Wife,0,0,0,0,0,0,40,11317,8379,4031,1296,25063,25063
556,TOTAL (ALL INDIA),2006,Service (Government),5,434,815,568,12,1834,0,122,129,54,8,313,2147
557,TOTAL (ALL INDIA),2006,Service (Private),6,2170,3101,1955,231,7463,0,902,457,200,19,1578,9041
558,TOTAL (ALL INDIA),2006,Public Sector Undertaking,2,610,935,421,57,2025,3,153,110,106,4,376,2401
559,TOTAL (ALL INDIA),2006,Student,562,2421,107,25,8,3123,636,2009,84,5,0,2734,5857
560,TOTAL (ALL INDIA),2006,Unemployed,11,3260,2666,1075,403,7415,7,843,370,168,83,1471,8886
561,TOTAL (ALL INDIA),2006,Self-employed (Business activity),5,1599,3056,1525,319,6504,2,145,209,65,9,430,6934
562,TOTAL (ALL INDIA),2006,Professional Activity,16,852,1359,973,208,3408,5,112,77,35,6,235,3643
563,TOTAL (ALL INDIA),2006,Farming/Agriculture Activity,56,3535,5761,3704,1608,14664,58,922,847,429,140,2396,17060
564,TOTAL (ALL INDIA),2006,Others (Please Specify),181,4643,5878,4430,1814,16946,182,1477,1071,584,542,3856,20802
565,TOTAL (ALL INDIA),2006,Retired Person,1,36,39,137,752,965,0,1,6,12,135,154,1119
566,TOTAL (ALL INDIA),2006,Others (Please Specify),349,3197,4092,2532,1185,11355,337,1456,1151,572,288,3804,15159
567,TOTAL (ALL INDIA),2006,Total,1194,22757,27809,17345,6597,75702,1270,19459,12890,6261,2530,42410,118112
568,TOTAL (ALL INDIA),2006,Total Salaried,13,3214,4851,2944,300,11322,3,1177,696,360,31,2267,13589
569,TOTAL (ALL INDIA),2006,Total Self-employed,258,10629,16054,10632,3949,41522,247,2656,2204,1113,697,6917,48439
0,ANDHRA PRADESH,2007,House Wife,0,0,0,0,0,0,0,1105,811,405,159,2480,2480
1,ANDHRA PRADESH,2007,Service (Government),0,71,86,63,0,220,1,26,19,9,0,55,275
2,ANDHRA PRADESH,2007,Service (Private),6,239,490,266,102,1103,3,41,105,72,49,270,1373
3,ANDHRA PRADESH,2007,Public Sector Undertaking,0,46,99,62,3,210,4,8,13,4,0,29,239
4,ANDHRA PRADESH,2007,Student,63,327,27,3,0,420,80,193,6,0,0,279,699
5,ANDHRA PRADESH,2007,Unemployed,0,120,146,74,0,340,7,43,10,3,0,63,403
6,ANDHRA PRADESH,2007,Self-employed (Business activity),0,262,374,249,40,925,0,16,16,22,1,55,980
7,ANDHRA PRADESH,2007,Professional Activity,2,110,151,109,49,421,7,31,17,3,0,58,479
8,ANDHRA PRADESH,2007,Farming/Agriculture Activity,5,325,620,421,137,1508,20,113,90,53,13,289,1797
9,ANDHRA PRADESH,2007,Others (Please Specify),9,636,913,563,341,2462,32,283,166,126,61,668,3130
10,ANDHRA PRADESH,2007,Retired Person,0,1,7,4,55,67,0,0,0,6,5,11,78
11,ANDHRA PRADESH,2007,Others (Please Specify),36,799,747,490,201,2273,40,280,197,101,58,676,2949
12,ANDHRA PRADESH,2007,Total,121,2936,3660,2304,928,9949,194,2139,1450,804,346,4933,14882
13,ANDHRA PRADESH,2007,Total Salaried,6,356,675,391,105,1533,8,75,137,85,49,354,1887
14,ANDHRA PRADESH,2007,Total Self-employed,16,1333,2058,1342,567,5316,59,443,289,204,75,1070,6386
15,ARUNACHAL PRADESH,2007,House Wife,0,0,0,0,0,0,0,2,8,0,0,10,10
16,ARUNACHAL PRADESH,2007,Service (Government),0,0,5,4,0,9,0,0,0,0,0,0,9
17,ARUNACHAL PRADESH,2007,Service (Private),0,10,5,2,1,18,0,1,0,0,0,1,19
18,ARUNACHAL PRADESH,2007,Public Sector Undertaking,0,0,0,0,0,0,0,0,0,0,0,0,0
19,ARUNACHAL PRADESH,2007,Student,1,2,0,0,0,3,2,6,0,0,0,8,11
20,ARUNACHAL PRADESH,2007,Unemployed,1,11,12,1,0,25,0,1,1,0,0,2,27
21,ARUNACHAL PRADESH,2007,Self-employed (Business activity),0,1,1,2,0,4,0,0,0,0,0,0,4
22,ARUNACHAL PRADESH,2007,Professional Activity,0,1,0,0,0,1,0,0,0,0,0,0,1
23,ARUNACHAL PRADESH,2007,Farming/Agriculture Activity,0,4,9,1,0,14,0,1,0,0,0,1,15
24,ARUNACHAL PRADESH,2007,Others (Please Specify),0,6,10,0,0,16,1,3,0,1,0,5,21
25,ARUNACHAL PRADESH,2007,Retired Person,0,0,0,0,2,2,0,0,0,0,0,0,2
26,ARUNACHAL PRADESH,2007,Others (Please Specify),0,4,2,0,0,6,2,0,1,1,0,4,10
27,ARUNACHAL PRADESH,2007,Total,2,39,44,10,3,98,5,14,10,2,0,31,129
28,ARUNACHAL PRADESH,2007,Total Salaried,0,10,10,6,1,27,0,1,0,0,0,1,28
29,ARUNACHAL PRADESH,2007,Total Self-employed,0,12,20,3,0,35,1,4,0,1,0,6,41
30,ASSAM,2007,House Wife,0,0,0,0,0,0,0,188,214,95,19,516,516
31,ASSAM,2007,Service (Government),0,6,7,2,0,15,0,0,2,0,0,2,17
32,ASSAM,2007,Service (Private),0,9,11,10,0,30,0,7,3,2,0,12,42
33,ASSAM,2007,Public Sector Undertaking,0,13,52,8,1,74,0,9,8,2,0,19,93
34,ASSAM,2007,Student,29,90,0,0,0,119,23,62,3,1,1,90,209
35,ASSAM,2007,Unemployed,0,7,2,15,6,30,0,5,1,0,0,6,36
36,ASSAM,2007,Self-employed (Business activity),0,105,182,88,2,377,1,35,13,2,0,51,428
37,ASSAM,2007,Professional Activity,0,30,86,34,0,150,0,0,0,0,0,0,150
38,ASSAM,2007,Farming/Agriculture Activity,0,90,111,67,8,276,0,0,2,0,0,2,278
39,ASSAM,2007,Others (Please Specify),1,300,279,233,24,837,5,61,49,9,8,132,969
40,ASSAM,2007,Retired Person,0,0,0,0,7,7,0,0,0,0,0,0,7
41,ASSAM,2007,Others (Please Specify),8,54,69,50,20,201,4,60,36,9,7,116,317
42,ASSAM,2007,Total,38,704,799,507,68,2116,33,427,331,120,35,946,3062
43,ASSAM,2007,Total Salaried,0,28,70,20,1,119,0,16,13,4,0,33,152
44,ASSAM,2007,Total Self-employed,1,525,658,422,34,1640,6,96,64,11,8,185,1825
45,BIHAR,2007,House Wife,0,0,0,0,0,0,0,63,73,29,6,171,171
46,BIHAR,2007,Service (Government),0,2,2,4,0,8,0,0,0,0,0,0,8
47,BIHAR,2007,Service (Private),0,12,9,15,0,36,0,0,0,0,0,0,36
48,BIHAR,2007,Public Sector Undertaking,0,4,5,8,2,19,0,0,0,0,0,0,19
49,BIHAR,2007,Student,14,34,7,1,0,56,26,32,1,0,0,59,115
50,BIHAR,2007,Unemployed,0,36,12,14,3,65,0,9,10,0,0,19,84
51,BIHAR,2007,Self-employed (Business activity),0,2,1,4,1,8,0,2,1,0,0,3,11
52,BIHAR,2007,Professional Activity,1,1,0,1,0,3,0,0,0,0,0,0,3
53,BIHAR,2007,Farming/Agriculture Activity,1,29,27,19,2,78,0,0,8,0,0,8,86
54,BIHAR,2007,Others (Please Specify),1,50,34,25,11,121,3,35,7,14,8,67,188
55,BIHAR,2007,Retired Person,0,0,0,1,2,3,0,0,0,0,0,0,3
56,BIHAR,2007,Others (Please Specify),16,42,49,23,7,137,15,55,17,8,9,104,241
57,BIHAR,2007,Total,33,212,146,115,28,534,44,196,117,51,23,431,965
58,BIHAR,2007,Total Salaried,0,18,16,27,2,63,0,0,0,0,0,0,63
59,BIHAR,2007,Total Self-employed,3,82,62,49,14,210,3,37,16,14,8,78,288
60,CHHATTISGARH,2007,House Wife,0,0,0,0,0,0,3,423,270,106,46,848,848
61,CHHATTISGARH,2007,Service (Government),0,9,12,13,0,34,0,1,3,0,0,4,38
62,CHHATTISGARH,2007,Service (Private),0,74,83,51,5,213,0,9,9,2,0,20,233
63,CHHATTISGARH,2007,Public Sector Undertaking,0,8,11,3,0,22,0,1,1,0,0,2,24
64,CHHATTISGARH,2007,Student,32,94,46,0,0,172,26,78,3,0,0,107,279
65,CHHATTISGARH,2007,Unemployed,0,119,43,11,4,177,1,9,4,0,0,14,191
66,CHHATTISGARH,2007,Self-employed (Business activity),0,36,64,24,8,132,0,1,2,0,0,3,135
67,CHHATTISGARH,2007,Professional Activity,0,31,43,18,11,103,0,2,2,1,1,6,109
68,CHHATTISGARH,2007,Farming/Agriculture Activity,2,359,458,310,135,1264,5,136,96,78,14,329,1593
69,CHHATTISGARH,2007,Others (Please Specify),2,131,151,139,87,510,4,43,65,28,14,154,664
70,CHHATTISGARH,2007,Retired Person,0,0,0,1,1,2,0,0,0,0,0,0,2
71,CHHATTISGARH,2007,Others (Please Specify),42,186,212,118,69,627,20,28,21,17,10,96,723
72,CHHATTISGARH,2007,Total,78,1047,1123,688,320,3256,59,731,476,232,85,1583,4839
73,CHHATTISGARH,2007,Total Salaried,0,91,106,67,5,269,0,11,13,2,0,26,295
74,CHHATTISGARH,2007,Total Self-employed,4,557,716,491,241,2009,9,182,165,107,29,492,2501
75,GOA,2007,House Wife,0,0,0,0,0,0,0,24,20,11,4,59,59
76,GOA,2007,Service (Government),0,0,2,1,0,3,0,0,1,2,0,3,6
77,GOA,2007,Service (Private),0,19,23,11,2,55,0,7,1,1,0,9,64
78,GOA,2007,Public Sector Undertaking,0,0,0,0,0,0,0,0,0,0,0,0,0
79,GOA,2007,Student,1,10,3,0,0,14,1,3,0,0,0,4,18
80,GOA,2007,Unemployed,0,16,29,15,7,67,0,12,2,0,0,14,81
81,GOA,2007,Self-employed (Business activity),0,3,7,4,2,16,0,0,0,0,0,0,16
82,GOA,2007,Professional Activity,0,1,0,0,0,1,0,0,0,0,0,0,1
83,GOA,2007,Farming/Agriculture Activity,0,0,0,0,0,0,0,0,0,0,0,0,0
84,GOA,2007,Others (Please Specify),0,2,1,0,1,4,0,0,0,0,0,0,4
85,GOA,2007,Retired Person,0,0,0,4,6,10,0,0,0,0,0,0,10
86,GOA,2007,Others (Please Specify),0,3,4,1,0,8,1,1,1,0,0,3,11
87,GOA,2007,Total,1,54,69,36,18,178,2,47,25,14,4,92,270
88,GOA,2007,Total Salaried,0,19,25,12,2,58,0,7,2,3,0,12,70
89,GOA,2007,Total Self-employed,0,6,8,4,3,21,0,0,0,0,0,0,21
90,GUJARAT,2007,House Wife,0,0,0,0,0,0,2,729,540,235,107,1613,1613
91,GUJARAT,2007,Service (Government),0,29,37,19,0,85,0,8,7,4,1,20,105
92,GUJARAT,2007,Service (Private),0,190,215,105,6,516,1,26,19,8,1,55,571
93,GUJARAT,2007,Public Sector Undertaking,0,37,59,42,2,140,0,7,7,1,0,15,155
94,GUJARAT,2007,Student,23,123,6,3,0,155,26,102,17,3,0,148,303
95,GUJARAT,2007,Unemployed,1,179,182,73,8,443,1,23,22,9,2,57,500
96,GUJARAT,2007,Self-employed (Business activity),0,69,110,80,11,270,0,4,2,0,0,6,276
97,GUJARAT,2007,Professional Activity,0,179,173,79,23,454,0,16,15,5,1,37,491
98,GUJARAT,2007,Farming/Agriculture Activity,0,60,128,81,20,289,0,12,8,5,3,28,317
99,GUJARAT,2007,Others (Please Specify),2,195,232,101,24,554,0,48,26,11,7,92,646
100,GUJARAT,2007,Retired Person,0,20,23,34,98,175,0,7,0,14,28,49,224
101,GUJARAT,2007,Others (Please Specify),7,108,101,56,22,294,5,30,25,16,9,85,379
102,GUJARAT,2007,Total,33,1189,1266,673,214,3375,35,1012,688,311,159,2205,5580
103,GUJARAT,2007,Total Salaried,0,256,311,166,8,741,1,41,33,13,2,90,831
104,GUJARAT,2007,Total Self-employed,2,503,643,341,78,1567,0,80,51,21,11,163,1730
105,HARYANA,2007,House Wife,0,0,0,0,0,0,0,193,110,37,16,356,356
106,HARYANA,2007,Service (Government),0,18,25,20,1,64,0,12,3,0,0,15,79
107,HARYANA,2007,Service (Private),0,99,95,28,2,224,0,18,4,0,0,22,246
108,HARYANA,2007,Public Sector Undertaking,0,29,42,4,0,75,0,5,6,1,0,12,87
109,HARYANA,2007,Student,8,68,4,0,0,80,4,34,3,1,0,42,122
110,HARYANA,2007,Unemployed,2,111,108,32,6,259,0,5,12,6,0,23,282
111,HARYANA,2007,Self-employed (Business activity),0,24,30,23,9,86,0,0,1,1,0,2,88
112,HARYANA,2007,Professional Activity,0,5,23,29,0,57,0,0,0,0,0,0,57
113,HARYANA,2007,Farming/Agriculture Activity,0,68,63,37,11,179,0,0,0,0,0,0,179
114,HARYANA,2007,Others (Please Specify),1,50,37,24,9,121,1,10,23,6,2,42,163
115,HARYANA,2007,Retired Person,0,13,26,16,18,73,0,1,0,0,1,2,75
116,HARYANA,2007,Others (Please Specify),17,175,267,127,48,634,3,35,10,13,4,65,699
117,HARYANA,2007,Total,28,660,720,340,104,1852,8,313,172,65,23,581,2433
118,HARYANA,2007,Total Salaried,0,146,162,52,3,363,0,35,13,1,0,49,412
119,HARYANA,2007,Total Self-employed,1,147,153,113,29,443,1,10,24,7,2,44,487
120,HIMACHAL PRADESH,2007,House Wife,0,0,0,0,0,0,0,31,16,5,4,56,56
121,HIMACHAL PRADESH,2007,Service (Government),0,2,7,2,0,11,0,0,0,0,0,0,11
122,HIMACHAL PRADESH,2007,Service (Private),0,18,21,6,1,46,0,1,2,1,0,4,50
123,HIMACHAL PRADESH,2007,Public Sector Undertaking,0,4,3,4,1,12,0,1,2,0,0,3,15
124,HIMACHAL PRADESH,2007,Student,2,11,0,0,0,13,0,20,2,0,0,22,35
125,HIMACHAL PRADESH,2007,Unemployed,0,12,7,3,1,23,0,2,2,0,0,4,27
126,HIMACHAL PRADESH,2007,Self-employed (Business activity),0,6,10,7,2,25,0,1,2,0,0,3,28
127,HIMACHAL PRADESH,2007,Professional Activity,0,2,4,1,1,8,0,0,1,1,0,2,10
128,HIMACHAL PRADESH,2007,Farming/Agriculture Activity,0,0,11,3,0,14,0,0,1,0,0,1,15
129,HIMACHAL PRADESH,2007,Others (Please Specify),0,20,17,9,20,66,0,5,7,3,8,23,89
130,HIMACHAL PRADESH,2007,Retired Person,0,0,0,0,1,1,0,0,0,0,0,0,1
131,HIMACHAL PRADESH,2007,Others (Please Specify),0,17,18,3,1,39,0,11,11,1,3,26,65
132,HIMACHAL PRADESH,2007,Total,2,92,98,38,28,258,0,72,46,11,15,144,402
133,HIMACHAL PRADESH,2007,Total Salaried,0,24,31,12,2,69,0,2,4,1,0,7,76
134,HIMACHAL PRADESH,2007,Total Self-employed,0,28,42,20,23,113,0,6,11,4,8,29,142
135,JAMMU & KASHMIR,2007,House Wife,0,0,0,0,0,0,0,26,21,4,2,53,53
136,JAMMU & KASHMIR,2007,Service (Government),0,5,6,1,0,12,0,1,1,0,0,2,14
137,JAMMU & KASHMIR,2007,Service (Private),0,2,5,3,0,10,0,1,0,0,0,1,11
138,JAMMU & KASHMIR,2007,Public Sector Undertaking,0,4,1,0,0,5,0,2,0,0,0,2,7
139,JAMMU & KASHMIR,2007,Student,0,13,1,0,0,14,0,10,0,0,0,10,24
140,JAMMU & KASHMIR,2007,Unemployed,0,16,5,4,0,25,0,3,0,0,0,3,28
141,JAMMU & KASHMIR,2007,Self-employed (Business activity),0,1,1,1,0,3,0,0,0,0,0,0,3
142,JAMMU & KASHMIR,2007,Professional Activity,0,2,1,0,0,3,0,0,0,0,0,0,3
143,JAMMU & KASHMIR,2007,Farming/Agriculture Activity,0,9,10,9,3,31,0,1,1,0,0,2,33
144,JAMMU & KASHMIR,2007,Others (Please Specify),0,4,11,0,1,16,0,1,0,0,0,1,17
145,JAMMU & KASHMIR,2007,Retired Person,0,0,1,1,2,4,0,0,0,0,0,0,4
146,JAMMU & KASHMIR,2007,Others (Please Specify),0,9,15,4,2,30,0,6,1,0,0,7,37
147,JAMMU & KASHMIR,2007,Total,0,65,57,23,8,153,0,51,24,4,2,81,234
148,JAMMU & KASHMIR,2007,Total Salaried,0,11,12,4,0,27,0,4,1,0,0,5,32
149,JAMMU & KASHMIR,2007,Total Self-employed,0,16,23,10,4,53,0,2,1,0,0,3,56
150,JHARKHAND,2007,House Wife,0,0,0,0,0,0,3,87,77,30,8,205,205
151,JHARKHAND,2007,Service (Government),0,6,5,6,2,19,0,0,0,1,0,1,20
152,JHARKHAND,2007,Service (Private),4,28,36,9,3,80,0,0,4,0,0,4,84
153,JHARKHAND,2007,Public Sector Undertaking,0,0,0,0,0,0,0,0,0,0,0,0,0
154,JHARKHAND,2007,Student,24,33,10,0,0,67,10,23,2,0,0,35,102
155,JHARKHAND,2007,Unemployed,0,40,26,12,1,79,0,8,8,0,0,16,95
156,JHARKHAND,2007,Self-employed (Business activity),1,15,19,14,0,49,0,0,3,1,0,4,53
157,JHARKHAND,2007,Professional Activity,0,2,27,10,1,40,0,0,2,0,0,2,42
158,JHARKHAND,2007,Farming/Agriculture Activity,0,28,40,28,5,101,1,7,3,1,0,12,113
159,JHARKHAND,2007,Others (Please Specify),0,22,24,21,5,72,1,22,18,6,2,49,121
160,JHARKHAND,2007,Retired Person,0,0,1,0,18,19,0,0,0,0,0,0,19
161,JHARKHAND,2007,Others (Please Specify),17,87,128,97,25,354,7,31,18,15,10,81,435
162,JHARKHAND,2007,Total,46,261,316,197,60,880,22,178,135,54,20,409,1289
163,JHARKHAND,2007,Total Salaried,4,34,41,15,5,99,0,0,4,1,0,5,104
164,JHARKHAND,2007,Total Self-employed,1,67,110,73,11,262,2,29,26,8,2,67,329
165,KARNATAKA,2007,House Wife,0,0,0,0,0,0,1,656,611,382,152,1802,1802
166,KARNATAKA,2007,Service (Government),0,58,53,67,1,179,0,11,9,5,3,28,207
167,KARNATAKA,2007,Service (Private),0,273,332,248,49,902,1,114,36,18,5,174,1076
168,KARNATAKA,2007,Public Sector Undertaking,0,54,68,36,18,176,0,9,9,9,0,27,203
169,KARNATAKA,2007,Student,51,177,18,0,0,246,58,193,10,0,0,261,507
170,KARNATAKA,2007,Unemployed,0,137,185,106,22,450,6,63,21,11,1,102,552
171,KARNATAKA,2007,Self-employed (Business activity),0,102,176,123,20,421,0,26,24,11,2,63,484
172,KARNATAKA,2007,Professional Activity,0,37,82,58,10,187,0,3,4,0,0,7,194
173,KARNATAKA,2007,Farming/Agriculture Activity,0,311,655,595,211,1772,7,112,125,91,28,363,2135
174,KARNATAKA,2007,Others (Please Specify),18,514,763,670,168,2133,16,158,220,133,14,541,2674
175,KARNATAKA,2007,Retired Person,0,0,1,10,36,47,0,0,0,0,4,4,51
176,KARNATAKA,2007,Others (Please Specify),40,491,651,506,191,1879,38,178,166,93,65,540,2419
177,KARNATAKA,2007,Total,109,2154,2984,2419,726,8392,127,1523,1235,753,274,3912,12304
178,KARNATAKA,2007,Total Salaried,0,385,453,351,68,1257,1,134,54,32,8,229,1486
179,KARNATAKA,2007,Total Self-employed,18,964,1676,1446,409,4513,23,299,373,235,44,974,5487
180,KERALA,2007,House Wife,0,0,0,0,0,0,0,289,394,433,210,1326,1326
181,KERALA,2007,Service (Government),0,2,34,52,0,88,0,0,5,6,0,11,99
182,KERALA,2007,Service (Private),0,34,209,135,12,390,0,21,33,24,0,78,468
183,KERALA,2007,Public Sector Undertaking,0,3,32,50,6,91,0,2,5,6,0,13,104
184,KERALA,2007,Student,33,82,0,0,0,115,34,124,2,0,0,160,275
185,KERALA,2007,Unemployed,0,209,325,135,3,672,0,72,66,28,8,174,846
186,KERALA,2007,Self-employed (Business activity),0,51,136,200,39,426,0,0,1,6,0,7,433
187,KERALA,2007,Professional Activity,0,38,79,69,8,194,0,4,3,4,1,12,206
188,KERALA,2007,Farming/Agriculture Activity,0,102,290,508,258,1158,0,13,21,25,15,74,1232
189,KERALA,2007,Others (Please Specify),0,396,662,677,413,2148,4,65,95,76,85,325,2473
190,KERALA,2007,Retired Person,0,0,0,20,68,88,0,0,0,0,6,6,94
191,KERALA,2007,Others (Please Specify),15,180,302,427,294,1218,5,20,56,39,68,188,1406
192,KERALA,2007,Total,48,1097,2069,2273,1101,6588,43,610,681,647,393,2374,8962
193,KERALA,2007,Total Salaried,0,39,275,237,18,569,0,23,43,36,0,102,671
194,KERALA,2007,Total Self-employed,0,587,1167,1454,718,3926,4,82,120,111,101,418,4344
195,MADHYA PRADESH,2007,House Wife,0,0,0,0,0,0,17,1128,511,165,86,1907,1907
196,MADHYA PRADESH,2007,Service (Government),0,20,18,31,1,70,0,8,6,1,2,17,87
197,MADHYA PRADESH,2007,Service (Private),11,63,53,35,7,169,1,45,25,8,1,80,249
198,MADHYA PRADESH,2007,Public Sector Undertaking,0,65,47,26,1,139,1,44,11,9,0,65,204
199,MADHYA PRADESH,2007,Student,34,155,2,0,0,191,32,98,0,1,4,135,326
200,MADHYA PRADESH,2007,Unemployed,2,124,81,37,14,258,0,21,7,0,0,28,286
201,MADHYA PRADESH,2007,Self-employed (Business activity),0,110,116,73,13,312,0,33,17,2,1,53,365
202,MADHYA PRADESH,2007,Professional Activity,0,75,62,33,12,182,0,11,1,0,0,12,194
203,MADHYA PRADESH,2007,Farming/Agriculture Activity,26,335,376,223,105,1065,8,104,67,15,4,198,1263
204,MADHYA PRADESH,2007,Others (Please Specify),3,242,217,129,66,657,35,128,55,13,14,245,902
205,MADHYA PRADESH,2007,Retired Person,0,2,9,5,4,20,2,0,0,0,0,2,22
206,MADHYA PRADESH,2007,Others (Please Specify),17,122,145,84,39,407,16,53,26,15,7,117,524
207,MADHYA PRADESH,2007,Total,93,1313,1126,676,262,3470,112,1673,726,229,119,2859,6329
208,MADHYA PRADESH,2007,Total Salaried,11,148,118,92,9,378,2,97,42,18,3,162,540
209,MADHYA PRADESH,2007,Total Self-employed,29,762,771,458,196,2216,43,276,140,30,19,508,2724
210,MAHARASHTRA,2007,House Wife,0,0,0,0,0,0,4,1880,1031,410,238,3563,3563
211,MAHARASHTRA,2007,Service (Government),0,41,90,78,2,211,0,11,3,1,0,15,226
212,MAHARASHTRA,2007,Service (Private),0,444,616,356,36,1452,0,80,47,11,0,138,1590
213,MAHARASHTRA,2007,Public Sector Undertaking,0,31,44,37,3,115,0,11,4,5,0,20,135
214,MAHARASHTRA,2007,Student,41,355,8,0,0,404,69,319,1,0,0,389,793
215,MAHARASHTRA,2007,Unemployed,0,429,355,162,32,978,0,51,7,2,1,61,1039
216,MAHARASHTRA,2007,Self-employed (Business activity),0,108,194,104,28,434,0,3,6,1,0,10,444
217,MAHARASHTRA,2007,Professional Activity,0,168,291,165,57,681,0,27,18,12,9,66,747
218,MAHARASHTRA,2007,Farming/Agriculture Activity,0,908,1498,1038,524,3968,0,131,73,37,29,270,4238
219,MAHARASHTRA,2007,Others (Please Specify),0,533,797,453,216,1999,1,103,63,32,12,211,2210
220,MAHARASHTRA,2007,Retired Person,0,0,1,27,118,146,0,0,7,3,7,17,163
221,MAHARASHTRA,2007,Others (Please Specify),1,5,14,5,7,32,0,2,1,1,0,4,36
222,MAHARASHTRA,2007,Total,42,3022,3908,2425,1023,10420,74,2618,1261,515,296,4764,15184
223,MAHARASHTRA,2007,Total Salaried,0,516,750,471,41,1778,0,102,54,17,0,173,1951
224,MAHARASHTRA,2007,Total Self-employed,0,1717,2780,1760,825,7082,1,264,160,82,50,557,7639
225,MANIPUR,2007,House Wife,0,0,0,0,0,0,0,3,5,1,0,9,9
226,MANIPUR,2007,Service (Government),0,0,8,2,0,10,0,0,0,0,0,0,10
227,MANIPUR,2007,Service (Private),0,0,0,0,0,0,0,0,0,0,0,0,0
228,MANIPUR,2007,Public Sector Undertaking,0,0,0,0,0,0,0,0,0,0,0,0,0
229,MANIPUR,2007,Student,1,4,0,0,0,5,0,1,0,0,0,1,6
230,MANIPUR,2007,Unemployed,0,2,6,1,0,9,0,0,1,0,0,1,10
231,MANIPUR,2007,Self-employed (Business activity),0,0,0,0,0,0,0,0,0,0,0,0,0
232,MANIPUR,2007,Professional Activity,0,0,0,0,0,0,0,0,0,0,0,0,0
233,MANIPUR,2007,Farming/Agriculture Activity,0,0,0,0,0,0,0,0,0,0,0,0,0
234,MANIPUR,2007,Others (Please Specify),0,0,2,0,0,2,0,0,0,0,0,0,2
235,MANIPUR,2007,Retired Person,0,0,0,0,0,0,0,0,0,0,0,0,0
236,MANIPUR,2007,Others (Please Specify),0,1,1,0,0,2,0,0,0,0,0,0,2
237,MANIPUR,2007,Total,1,7,17,3,0,28,0,4,6,1,0,11,39
238,MANIPUR,2007,Total Salaried,0,0,8,2,0,10,0,0,0,0,0,0,10
239,MANIPUR,2007,Total Self-employed,0,0,2,0,0,2,0,0,0,0,0,0,2
240,MEGHALAYA,2007,House Wife,0,0,0,0,0,0,0,2,4,0,0,6,6
241,MEGHALAYA,2007,Service (Government),0,3,2,1,0,6,0,1,0,0,0,1,7
242,MEGHALAYA,2007,Service (Private),0,0,0,0,0,0,0,0,0,0,0,0,0
243,MEGHALAYA,2007,Public Sector Undertaking,0,0,0,1,0,1,0,0,0,0,0,0,1
244,MEGHALAYA,2007,Student,1,9,0,0,0,10,0,5,2,0,0,7,17
245,MEGHALAYA,2007,Unemployed,0,3,6,0,1,10,0,2,0,0,0,2,12
246,MEGHALAYA,2007,Self-employed (Business activity),0,4,4,1,0,9,0,0,0,0,0,0,9
247,MEGHALAYA,2007,Professional Activity,0,0,0,0,0,0,0,0,0,0,0,0,0
248,MEGHALAYA,2007,Farming/Agriculture Activity,0,7,4,1,2,14,0,2,2,0,0,4,18
249,MEGHALAYA,2007,Others (Please Specify),0,0,3,3,0,6,0,0,1,0,0,1,7
250,MEGHALAYA,2007,Retired Person,0,0,0,0,0,0,0,0,0,0,0,0,0
251,MEGHALAYA,2007,Others (Please Specify),0,2,2,0,0,4,0,3,3,0,0,6,10
252,MEGHALAYA,2007,Total,1,28,21,7,3,60,0,15,12,0,0,27,87
253,MEGHALAYA,2007,Total Salaried,0,3,2,2,0,7,0,1,0,0,0,1,8
254,MEGHALAYA,2007,Total Self-employed,0,11,11,5,2,29,0,2,3,0,0,5,34
255,MIZORAM,2007,House Wife,0,0,0,0,0,0,0,0,1,2,0,3,3
256,MIZORAM,2007,Service (Government),0,0,0,0,0,0,0,0,0,0,0,0,0
257,MIZORAM,2007,Service (Private),0,0,0,0,0,0,0,0,0,0,0,0,0
258,MIZORAM,2007,Public Sector Undertaking,0,0,0,0,0,0,0,0,0,0,0,0,0
259,MIZORAM,2007,Student,0,0,0,0,0,0,0,0,0,0,0,0,0
260,MIZORAM,2007,Unemployed,0,0,0,0,0,0,0,0,0,0,0,0,0
261,MIZORAM,2007,Self-employed (Business activity),0,0,0,0,0,0,0,0,0,0,0,0,0
262,MIZORAM,2007,Professional Activity,0,0,0,0,0,0,0,0,0,0,0,0,0
263,MIZORAM,2007,Farming/Agriculture Activity,0,0,0,0,0,0,0,0,0,0,0,0,0
264,MIZORAM,2007,Others (Please Specify),0,0,0,0,0,0,0,0,0,0,0,0,0
265,MIZORAM,2007,Retired Person,0,0,0,0,0,0,0,0,0,0,0,0,0
266,MIZORAM,2007,Others (Please Specify),1,9,8,2,2,22,0,1,2,0,0,3,25
267,MIZORAM,2007,Total,1,9,8,2,2,22,0,1,3,2,0,6,28
268,MIZORAM,2007,Total Salaried,0,0,0,0,0,0,0,0,0,0,0,0,0
269,MIZORAM,2007,Total Self-employed,0,0,0,0,0,0,0,0,0,0,0,0,0
270,NAGALAND,2007,House Wife,0,0,0,0,0,0,0,1,4,0,0,5,5
271,NAGALAND,2007,Service (Government),0,1,0,4,0,5,0,0,0,0,0,0,5
272,NAGALAND,2007,Service (Private),0,0,0,0,0,0,0,0,0,0,0,0,0
273,NAGALAND,2007,Public Sector Undertaking,0,0,0,0,0,0,0,0,0,0,0,0,0
274,NAGALAND,2007,Student,0,0,0,0,0,0,0,0,0,0,0,0,0
275,NAGALAND,2007,Unemployed,0,0,2,0,0,2,0,0,0,0,0,0,2
276,NAGALAND,2007,Self-employed (Business activity),0,0,0,0,0,0,0,0,0,0,0,0,0
277,NAGALAND,2007,Professional Activity,0,0,0,0,0,0,0,0,0,0,0,0,0
278,NAGALAND,2007,Farming/Agriculture Activity,0,0,0,0,0,0,0,0,0,0,0,0,0
279,NAGALAND,2007,Others (Please Specify),0,1,3,0,0,4,0,1,0,0,0,1,5
280,NAGALAND,2007,Retired Person,0,0,0,0,0,0,0,0,0,0,0,0,0
281,NAGALAND,2007,Others (Please Specify),0,2,3,1,0,6,0,1,0,0,0,1,7
282,NAGALAND,2007,Total,0,4,8,5,0,17,0,3,4,0,0,7,24
283,NAGALAND,2007,Total Salaried,0,1,0,4,0,5,0,0,0,0,0,0,5
284,NAGALAND,2007,Total Self-employed,0,1,3,0,0,4,0,1,0,0,0,1,5
285,ODISHA,2007,House Wife,0,0,0,0,0,0,0,322,212,66,14,614,614
286,ODISHA,2007,Service (Government),0,6,8,12,0,26,0,1,5,0,0,6,32
287,ODISHA,2007,Service (Private),0,82,82,48,2,214,0,26,31,29,3,89,303
288,ODISHA,2007,Public Sector Undertaking,0,34,48,26,4,112,0,17,3,8,0,28,140
289,ODISHA,2007,Student,26,109,0,0,0,135,24,75,0,0,0,99,234
290,ODISHA,2007,Unemployed,12,98,62,40,12,224,5,93,73,5,1,177,401
291,ODISHA,2007,Self-employed (Business activity),0,75,161,77,23,336,0,6,4,2,0,12,348
292,ODISHA,2007,Professional Activity,0,29,29,21,3,82,0,6,16,3,0,25,107
293,ODISHA,2007,Farming/Agriculture Activity,2,42,61,48,17,170,3,17,21,16,13,70,240
294,ODISHA,2007,Others (Please Specify),26,209,226,142,81,684,30,201,97,46,18,392,1076
295,ODISHA,2007,Retired Person,0,0,0,6,25,31,0,0,0,0,5,5,36
296,ODISHA,2007,Others (Please Specify),11,92,171,121,79,474,8,114,94,68,19,303,777
297,ODISHA,2007,Total,77,776,848,541,246,2488,70,878,556,243,73,1820,4308
298,ODISHA,2007,Total Salaried,0,122,138,86,6,352,0,44,39,37,3,123,475
299,ODISHA,2007,Total Self-employed,28,355,477,288,124,1272,33,230,138,67,31,499,1771
300,PUNJAB,2007,House Wife,0,0,0,0,0,0,0,62,53,13,4,132,132
301,PUNJAB,2007,Service (Government),0,9,9,9,0,27,0,1,1,1,0,3,30
302,PUNJAB,2007,Service (Private),0,22,28,13,0,63,0,3,0,0,0,3,66
303,PUNJAB,2007,Public Sector Undertaking,0,0,0,0,0,0,0,0,0,0,0,0,0
304,PUNJAB,2007,Student,2,12,1,0,0,15,6,9,0,0,0,15,30
305,PUNJAB,2007,Unemployed,0,22,7,7,6,42,0,7,2,0,0,9,51
306,PUNJAB,2007,Self-employed (Business activity),0,9,17,12,4,42,0,0,0,0,0,0,42
307,PUNJAB,2007,Professional Activity,0,9,9,4,1,23,0,1,0,0,0,1,24
308,PUNJAB,2007,Farming/Agriculture Activity,0,21,32,19,14,86,0,0,1,1,0,2,88
309,PUNJAB,2007,Others (Please Specify),0,68,53,32,17,170,2,12,0,0,0,14,184
310,PUNJAB,2007,Retired Person,0,0,0,4,2,6,0,0,0,0,0,0,6
311,PUNJAB,2007,Others (Please Specify),3,64,60,17,14,158,5,17,12,2,0,36,194
312,PUNJAB,2007,Total,5,236,216,117,58,632,13,112,69,17,4,215,847
313,PUNJAB,2007,Total Salaried,0,31,37,22,0,90,0,4,1,1,0,6,96
314,PUNJAB,2007,Total Self-employed,0,107,111,67,36,321,2,13,1,1,0,17,338
315,RAJASTHAN,2007,House Wife,0,0,0,0,0,0,9,398,410,177,29,1023,1023
316,RAJASTHAN,2007,Service (Government),0,5,22,12,0,39,0,10,17,1,1,29,68
317,RAJASTHAN,2007,Service (Private),6,102,150,82,1,341,0,9,1,0,0,10,351
318,RAJASTHAN,2007,Public Sector Undertaking,0,11,7,6,0,24,0,5,0,0,0,5,29
319,RAJASTHAN,2007,Student,28,86,1,0,0,115,13,47,10,0,0,70,185
320,RAJASTHAN,2007,Unemployed,1,48,86,20,2,157,0,1,2,2,0,5,162
321,RAJASTHAN,2007,Self-employed (Business activity),0,72,120,84,3,279,0,0,0,0,0,0,279
322,RAJASTHAN,2007,Professional Activity,0,18,16,2,0,36,0,0,3,0,0,3,39
323,RAJASTHAN,2007,Farming/Agriculture Activity,2,153,229,176,29,589,0,9,9,10,1,29,618
324,RAJASTHAN,2007,Others (Please Specify),5,254,334,128,36,757,0,25,9,7,0,41,798
325,RAJASTHAN,2007,Retired Person,0,0,0,0,0,0,0,0,0,0,0,0,0
326,RAJASTHAN,2007,Others (Please Specify),36,314,216,195,56,817,14,40,5,5,4,68,885
327,RAJASTHAN,2007,Total,78,1063,1181,705,127,3154,36,544,466,202,35,1283,4437
328,RAJASTHAN,2007,Total Salaried,6,118,179,100,1,404,0,24,18,1,1,44,448
329,RAJASTHAN,2007,Total Self-employed,7,497,699,390,68,1661,0,34,21,17,1,73,1734
330,SIKKIM,2007,House Wife,0,0,0,0,0,0,0,6,0,0,0,6,6
331,SIKKIM,2007,Service (Government),0,0,0,0,0,0,0,0,0,0,0,0,0
332,SIKKIM,2007,Service (Private),0,3,3,3,0,9,0,3,0,0,0,3,12
333,SIKKIM,2007,Public Sector Undertaking,0,0,0,0,0,0,0,1,0,0,0,1,1
334,SIKKIM,2007,Student,2,3,0,0,0,5,0,0,0,0,0,0,5
335,SIKKIM,2007,Unemployed,0,9,0,0,0,9,0,2,0,0,0,2,11
336,SIKKIM,2007,Self-employed (Business activity),0,0,0,0,0,0,0,0,0,0,0,0,0
337,SIKKIM,2007,Professional Activity,0,0,0,0,0,0,0,0,0,0,0,0,0
338,SIKKIM,2007,Farming/Agriculture Activity,0,0,8,7,0,15,0,2,4,0,0,6,21
339,SIKKIM,2007,Others (Please Specify),3,18,5,2,2,30,1,3,0,3,0,7,37
340,SIKKIM,2007,Retired Person,0,0,0,0,0,0,0,0,0,0,0,0,0
341,SIKKIM,2007,Others (Please Specify),0,8,8,0,0,16,6,2,4,1,0,13,29
342,SIKKIM,2007,Total,5,41,24,12,2,84,7,19,8,4,0,38,122
343,SIKKIM,2007,Total Salaried,0,3,3,3,0,9,0,4,0,0,0,4,13
344,SIKKIM,2007,Total Self-employed,3,18,13,9,2,45,1,5,4,3,0,13,58
345,TAMIL NADU,2007,House Wife,0,0,0,0,0,0,0,873,996,474,133,2476,2476
346,TAMIL NADU,2007,Service (Government),0,23,103,52,1,179,0,10,9,8,5,32,211
347,TAMIL NADU,2007,Service (Private),0,323,519,337,84,1263,0,486,106,61,7,660,1923
348,TAMIL NADU,2007,Public Sector Undertaking,0,57,124,69,33,283,0,19,11,59,1,90,373
349,TAMIL NADU,2007,Student,30,76,6,1,2,115,38,89,7,0,0,134,249
350,TAMIL NADU,2007,Unemployed,0,421,134,197,111,863,0,253,128,90,35,506,1369
351,TAMIL NADU,2007,Self-employed (Business activity),0,156,901,201,35,1293,0,9,80,3,0,92,1385
352,TAMIL NADU,2007,Professional Activity,0,0,0,0,0,0,0,0,0,0,0,0,0
353,TAMIL NADU,2007,Farming/Agriculture Activity,0,90,170,95,41,396,0,25,42,19,2,88,484
354,TAMIL NADU,2007,Others (Please Specify),0,876,810,951,325,2962,0,235,189,113,74,611,3573
355,TAMIL NADU,2007,Retired Person,0,0,0,12,89,101,0,0,0,0,16,16,117
356,TAMIL NADU,2007,Others (Please Specify),0,289,470,322,151,1232,45,103,134,91,46,419,1651
357,TAMIL NADU,2007,Total,30,2311,3237,2237,872,8687,83,2102,1702,918,319,5124,13811
358,TAMIL NADU,2007,Total Salaried,0,403,746,458,118,1725,0,515,126,128,13,782,2507
359,TAMIL NADU,2007,Total Self-employed,0,1122,1881,1247,401,4651,0,269,311,135,76,791,5442
360,TRIPURA,2007,House Wife,0,0,0,0,0,0,0,49,31,9,4,93,93
361,TRIPURA,2007,Service (Government),0,3,23,2,0,28,0,3,2,0,0,5,33
362,TRIPURA,2007,Service (Private),0,2,6,0,0,8,0,0,0,0,0,0,8
363,TRIPURA,2007,Public Sector Undertaking,0,0,0,0,0,0,0,0,0,0,0,0,0
364,TRIPURA,2007,Student,14,22,0,0,0,36,16,18,0,0,0,34,70
365,TRIPURA,2007,Unemployed,0,12,20,9,0,41,0,2,1,0,0,3,44
366,TRIPURA,2007,Self-employed (Business activity),0,14,28,18,3,63,0,0,0,0,0,0,63
367,TRIPURA,2007,Professional Activity,0,0,0,0,0,0,0,0,0,0,0,0,0
368,TRIPURA,2007,Farming/Agriculture Activity,0,0,0,0,0,0,0,0,0,0,0,0,0
369,TRIPURA,2007,Others (Please Specify),8,58,43,51,7,167,0,30,44,26,1,101,268
370,TRIPURA,2007,Retired Person,0,1,0,1,0,2,0,0,0,0,0,0,2
371,TRIPURA,2007,Others (Please Specify),4,36,21,13,0,74,6,14,22,6,2,50,124
372,TRIPURA,2007,Total,26,148,141,94,10,419,22,116,100,41,7,286,705
373,TRIPURA,2007,Total Salaried,0,5,29,2,0,36,0,3,2,0,0,5,41
374,TRIPURA,2007,Total Self-employed,8,72,71,69,10,230,0,30,44,26,1,101,331
375,UTTAR PRADESH,2007,House Wife,0,0,0,0,0,0,10,560,312,67,25,974,974
376,UTTAR PRADESH,2007,Service (Government),0,15,15,9,0,39,0,6,4,1,3,14,53
377,UTTAR PRADESH,2007,Service (Private),3,72,83,28,5,191,0,26,12,4,1,43,234
378,UTTAR PRADESH,2007,Public Sector Undertaking,0,10,11,9,3,33,1,8,4,0,0,13,46
379,UTTAR PRADESH,2007,Student,18,123,7,0,0,148,20,96,8,0,2,126,274
380,UTTAR PRADESH,2007,Unemployed,5,129,122,49,12,317,1,34,8,2,5,50,367
381,UTTAR PRADESH,2007,Self-employed (Business activity),0,38,47,46,5,136,0,12,5,0,2,19,155
382,UTTAR PRADESH,2007,Professional Activity,1,17,31,26,14,89,2,9,0,2,0,13,102
383,UTTAR PRADESH,2007,Farming/Agriculture Activity,3,84,125,123,54,389,5,29,27,20,16,97,486
384,UTTAR PRADESH,2007,Others (Please Specify),10,161,132,135,75,513,15,163,109,23,26,336,849
385,UTTAR PRADESH,2007,Retired Person,0,0,0,2,3,5,0,0,0,0,1,1,6
386,UTTAR PRADESH,2007,Others (Please Specify),10,46,55,38,45,194,15,47,68,37,20,187,381
387,UTTAR PRADESH,2007,Total,50,695,628,465,216,2054,69,990,557,156,101,1873,3927
388,UTTAR PRADESH,2007,Total Salaried,3,97,109,46,8,263,1,40,20,5,4,70,333
389,UTTAR PRADESH,2007,Total Self-employed,14,300,335,330,148,1127,22,213,141,45,44,465,1592
390,UTTARAKHAND,2007,House Wife,0,0,0,0,0,0,0,40,19,6,2,67,67
391,UTTARAKHAND,2007,Service (Government),0,1,4,0,0,5,0,2,0,0,0,2,7
392,UTTARAKHAND,2007,Service (Private),0,8,14,4,0,26,0,3,2,0,0,5,31
393,UTTARAKHAND,2007,Public Sector Undertaking,0,2,10,1,0,13,0,3,3,0,0,6,19
394,UTTARAKHAND,2007,Student,1,5,2,0,0,8,3,4,0,0,0,7,15
395,UTTARAKHAND,2007,Unemployed,1,8,8,3,0,20,1,2,3,0,0,6,26
396,UTTARAKHAND,2007,Self-employed (Business activity),0,6,4,0,0,10,0,0,2,0,0,2,12
397,UTTARAKHAND,2007,Professional Activity,0,0,3,1,0,4,0,1,0,0,0,1,5
398,UTTARAKHAND,2007,Farming/Agriculture Activity,0,7,9,2,0,18,0,6,2,2,0,10,28
399,UTTARAKHAND,2007,Others (Please Specify),0,5,1,2,0,8,2,2,1,0,0,5,13
400,UTTARAKHAND,2007,Retired Person,0,0,0,0,0,0,0,0,0,0,0,0,0
401,UTTARAKHAND,2007,Others (Please Specify),0,11,5,1,1,18,2,0,3,0,2,7,25
402,UTTARAKHAND,2007,Total,2,53,60,14,1,130,8,63,35,8,4,118,248
403,UTTARAKHAND,2007,Total Salaried,0,11,28,5,0,44,0,8,5,0,0,13,57
404,UTTARAKHAND,2007,Total Self-employed,0,18,17,5,0,40,2,9,5,2,0,18,58
405,WEST BENGAL,2007,House Wife,0,0,0,0,0,0,0,1541,1296,451,74,3362,3362
406,WEST BENGAL,2007,Service (Government),0,23,48,43,2,116,0,3,8,13,0,24,140
407,WEST BENGAL,2007,Service (Private),0,136,225,207,11,579,0,23,63,17,0,103,682
408,WEST BENGAL,2007,Public Sector Undertaking,0,130,327,192,6,655,0,42,24,18,0,84,739
409,WEST BENGAL,2007,Student,112,532,5,0,0,649,110,369,10,0,0,489,1138
410,WEST BENGAL,2007,Unemployed,3,321,348,129,4,805,10,137,183,32,0,362,1167
411,WEST BENGAL,2007,Self-employed (Business activity),0,312,506,316,24,1158,0,8,25,6,0,39,1197
412,WEST BENGAL,2007,Professional Activity,0,22,118,122,1,263,0,2,1,0,0,3,266
413,WEST BENGAL,2007,Farming/Agriculture Activity,5,188,432,185,68,878,0,68,98,40,18,224,1102
414,WEST BENGAL,2007,Others (Please Specify),61,562,824,449,183,2079,38,249,289,258,50,884,2963
415,WEST BENGAL,2007,Retired Person,0,0,0,0,95,95,0,0,0,0,16,16,111
416,WEST BENGAL,2007,Others (Please Specify),36,420,373,297,102,1228,44,288,181,178,74,765,1993
417,WEST BENGAL,2007,Total,217,2646,3206,1940,496,8505,202,2730,2178,1013,232,6355,14860
418,WEST BENGAL,2007,Total Salaried,0,289,600,442,19,1350,0,68,95,48,0,211,1561
419,WEST BENGAL,2007,Total Self-employed,66,1084,1880,1072,276,4378,38,327,413,304,68,1150,5528
420,TOTAL (STATES),2007,House Wife,0,0,0,0,0,0,49,10681,8050,3613,1342,23735,23735
421,TOTAL (STATES),2007,Service (Government),0,358,631,509,10,1508,1,115,105,53,15,289,1797
422,TOTAL (STATES),2007,Service (Private),30,2264,3313,2002,329,7938,6,950,503,258,67,1784,9722
423,TOTAL (STATES),2007,Public Sector Undertaking,0,542,990,584,83,2199,6,194,111,122,1,434,2633
424,TOTAL (STATES),2007,Student,591,2555,154,8,2,3310,621,2010,87,6,7,2731,6041
425,TOTAL (STATES),2007,Unemployed,28,2639,2319,1149,255,6390,32,860,574,190,53,1709,8099
426,TOTAL (STATES),2007,Self-employed (Business activity),1,1581,3209,1751,272,6814,1,156,204,57,6,424,7238
427,TOTAL (STATES),2007,Professional Activity,4,777,1228,782,191,2982,9,113,83,31,12,248,3230
428,TOTAL (STATES),2007,Farming/Agriculture Activity,46,3220,5366,3996,1644,14272,49,788,701,413,156,2107,16379
429,TOTAL (STATES),2007,Others (Please Specify),150,5313,6584,4939,2112,19098,191,1886,1533,934,404,4948,24046
430,TOTAL (STATES),2007,Retired Person,0,37,69,148,650,904,2,8,7,23,89,129,1033
431,TOTAL (STATES),2007,Others (Please Specify),317,3576,4117,2998,1376,12384,301,1420,1115,717,417,3970,16354
432,TOTAL (STATES),2007,Total,1167,22862,27980,18866,6924,77799,1268,19181,13073,6417,2569,42508,120307
433,TOTAL (STATES),2007,Total Salaried,30,3164,4934,3095,422,11645,13,1259,719,433,83,2507,14152
434,TOTAL (STATES),2007,Total Self-employed,201,10891,16387,11468,4219,43166,250,2943,2521,1435,578,7727,50893
435,A & N ISLANDS,2007,House Wife,0,0,0,0,0,0,0,10,10,8,2,30,30
436,A & N ISLANDS,2007,Service (Government),0,1,4,4,0,9,0,1,0,0,0,1,10
437,A & N ISLANDS,2007,Service (Private),0,17,12,8,2,39,0,1,0,0,0,1,40
438,A & N ISLANDS,2007,Public Sector Undertaking,0,0,0,0,0,0,0,0,0,0,0,0,0
439,A & N ISLANDS,2007,Student,0,4,0,0,0,4,4,9,0,0,0,13,17
440,A & N ISLANDS,2007,Unemployed,0,9,1,1,1,12,0,0,0,0,0,0,12
441,A & N ISLANDS,2007,Self-employed (Business activity),0,0,0,0,0,0,0,0,0,0,0,0,0
442,A & N ISLANDS,2007,Professional Activity,0,0,0,0,0,0,0,0,0,0,0,0,0
443,A & N ISLANDS,2007,Farming/Agriculture Activity,0,4,3,5,4,16,0,0,0,0,0,0,16
444,A & N ISLANDS,2007,Others (Please Specify),0,0,2,4,1,7,0,0,0,0,0,0,7
445,A & N ISLANDS,2007,Retired Person,0,0,0,1,2,3,0,0,0,0,0,0,3
446,A & N ISLANDS,2007,Others (Please Specify),0,1,4,4,1,10,2,9,0,0,0,11,21
447,A & N ISLANDS,2007,Total,0,36,26,27,11,100,6,30,10,8,2,56,156
448,A & N ISLANDS,2007,Total Salaried,0,18,16,12,2,48,0,2,0,0,0,2,50
449,A & N ISLANDS,2007,Total Self-employed,0,4,5,9,5,23,0,0,0,0,0,0,23
450,CHANDIGARH,2007,House Wife,0,0,0,0,0,0,0,10,8,1,2,21,21
451,CHANDIGARH,2007,Service (Government),0,0,3,1,0,4,0,1,0,0,0,1,5
452,CHANDIGARH,2007,Service (Private),0,3,10,4,0,17,0,0,0,0,0,0,17
453,CHANDIGARH,2007,Public Sector Undertaking,0,0,0,0,0,0,0,0,0,0,0,0,0
454,CHANDIGARH,2007,Student,2,13,0,0,0,15,0,0,0,0,0,0,15
455,CHANDIGARH,2007,Unemployed,0,6,2,2,0,10,0,0,0,0,0,0,10
456,CHANDIGARH,2007,Self-employed (Business activity),0,0,2,1,0,3,0,0,0,0,0,0,3
457,CHANDIGARH,2007,Professional Activity,0,0,0,0,0,0,0,0,0,0,0,0,0
458,CHANDIGARH,2007,Farming/Agriculture Activity,0,0,0,0,0,0,0,0,0,0,0,0,0
459,CHANDIGARH,2007,Others (Please Specify),0,2,3,0,0,5,0,0,0,0,0,0,5
460,CHANDIGARH,2007,Retired Person,0,0,0,0,2,2,0,0,0,0,0,0,2
461,CHANDIGARH,2007,Others (Please Specify),0,2,1,0,1,4,0,0,0,0,0,0,4
462,CHANDIGARH,2007,Total,2,26,21,8,3,60,0,11,8,1,2,22,82
463,CHANDIGARH,2007,Total Salaried,0,3,13,5,0,21,0,1,0,0,0,1,22
464,CHANDIGARH,2007,Total Self-employed,0,2,5,1,0,8,0,0,0,0,0,0,8
465,D & N HAVELI,2007,House Wife,0,0,0,0,0,0,0,15,8,4,1,28,28
466,D & N HAVELI,2007,Service (Government),0,0,0,0,0,0,0,0,0,0,0,0,0
467,D & N HAVELI,2007,Service (Private),0,4,4,0,0,8,0,0,0,0,0,0,8
468,D & N HAVELI,2007,Public Sector Undertaking,0,0,0,0,0,0,0,0,0,0,0,0,0
469,D & N HAVELI,2007,Student,0,3,0,0,0,3,0,4,0,0,0,4,7
470,D & N HAVELI,2007,Unemployed,0,2,3,2,0,7,0,0,0,0,0,0,7
471,D & N HAVELI,2007,Self-employed (Business activity),0,0,1,1,0,2,0,0,0,0,0,0,2
472,D & N HAVELI,2007,Professional Activity,0,0,0,0,0,0,0,0,0,0,0,0,0
473,D & N HAVELI,2007,Farming/Agriculture Activity,0,4,6,4,3,17,0,0,0,0,0,0,17
474,D & N HAVELI,2007,Others (Please Specify),0,0,0,0,0,0,0,0,0,0,0,0,0
475,D & N HAVELI,2007,Retired Person,0,0,0,0,5,5,0,0,0,0,0,0,5
476,D & N HAVELI,2007,Others (Please Specify),0,2,0,0,0,2,0,0,0,0,0,0,2
477,D & N HAVELI,2007,Total,0,15,14,7,8,44,0,19,8,4,1,32,76
478,D & N HAVELI,2007,Total Salaried,0,4,4,0,0,8,0,0,0,0,0,0,8
479,D & N HAVELI,2007,Total Self-employed,0,4,7,5,3,19,0,0,0,0,0,0,19
480,DAMAN & DIU,2007,House Wife,0,0,0,0,0,0,0,3,2,0,0,5,5
481,DAMAN & DIU,2007,Service (Government),0,0,0,2,0,2,0,0,0,0,0,0,2
482,DAMAN & DIU,2007,Service (Private),0,3,1,0,0,4,0,1,0,0,0,1,5
483,DAMAN & DIU,2007,Public Sector Undertaking,0,0,0,0,0,0,0,0,0,0,0,0,0
484,DAMAN & DIU,2007,Student,0,0,0,0,0,0,0,0,0,0,0,0,0
485,DAMAN & DIU,2007,Unemployed,0,0,0,0,0,0,0,0,0,0,0,0,0
486,DAMAN & DIU,2007,Self-employed (Business activity),0,0,0,0,0,0,0,0,0,0,0,0,0
487,DAMAN & DIU,2007,Professional Activity,0,0,0,0,0,0,0,0,0,0,0,0,0
488,DAMAN & DIU,2007,Farming/Agriculture Activity,0,0,0,0,0,0,0,0,0,0,0,0,0
489,DAMAN & DIU,2007,Others (Please Specify),0,0,0,0,0,0,0,0,0,0,0,0,0
490,DAMAN & DIU,2007,Retired Person,0,0,0,0,0,0,0,0,0,0,0,0,0
491,DAMAN & DIU,2007,Others (Please Specify),0,0,0,0,0,0,0,3,0,0,0,3,3
492,DAMAN & DIU,2007,Total,0,3,1,2,0,6,0,7,2,0,0,9,15
493,DAMAN & DIU,2007,Total Salaried,0,3,1,2,0,6,0,1,0,0,0,1,7
494,DAMAN & DIU,2007,Total Self-employed,0,0,0,0,0,0,0,0,0,0,0,0,0
495,DELHI (UT),2007,House Wife,0,0,0,0,0,0,0,158,86,12,7,263,263
496,DELHI (UT),2007,Service (Government),0,6,15,3,0,24,0,3,1,0,0,4,28
497,DELHI (UT),2007,Service (Private),1,100,90,25,3,219,0,22,6,1,0,29,248
498,DELHI (UT),2007,Public Sector Undertaking,0,4,5,3,0,12,0,2,0,0,0,2,14
499,DELHI (UT),2007,Student,9,61,5,0,0,75,7,53,0,0,0,60,135
500,DELHI (UT),2007,Unemployed,1,108,70,18,5,202,0,44,6,0,0,50,252
501,DELHI (UT),2007,Self-employed (Business activity),0,9,2,5,1,17,0,0,0,0,0,0,17
502,DELHI (UT),2007,Professional Activity,0,3,0,1,0,4,0,1,0,0,0,1,5
503,DELHI (UT),2007,Farming/Agriculture Activity,0,5,10,7,1,23,0,0,0,0,0,0,23
504,DELHI (UT),2007,Others (Please Specify),0,50,71,22,6,149,0,25,7,0,0,32,181
505,DELHI (UT),2007,Retired Person,0,0,0,0,5,5,0,0,0,0,0,0,5
506,DELHI (UT),2007,Others (Please Specify),2,85,107,31,11,236,8,38,22,5,1,74,310
507,DELHI (UT),2007,Total,13,431,375,115,32,966,15,346,128,18,8,515,1481
508,DELHI (UT),2007,Total Salaried,1,110,110,31,3,255,0,27,7,1,0,35,290
509,DELHI (UT),2007,Total Self-employed,0,67,83,35,8,193,0,26,7,0,0,33,226
510,LAKSHADWEEP,2007,House Wife,0,0,0,0,0,0,0,0,0,2,0,2,2
511,LAKSHADWEEP,2007,Service (Government),0,0,1,0,0,1,0,0,0,0,0,0,1
512,LAKSHADWEEP,2007,Service (Private),0,0,0,0,0,0,0,0,0,0,0,0,0
513,LAKSHADWEEP,2007,Public Sector Undertaking,0,0,0,0,0,0,0,0,0,0,0,0,0
514,LAKSHADWEEP,2007,Student,0,0,0,0,0,0,0,0,0,0,0,0,0
515,LAKSHADWEEP,2007,Unemployed,0,0,0,0,0,0,0,0,0,0,0,0,0
516,LAKSHADWEEP,2007,Self-employed (Business activity),0,0,0,0,0,0,0,0,0,0,0,0,0
517,LAKSHADWEEP,2007,Professional Activity,0,0,0,0,0,0,0,0,0,0,0,0,0
518,LAKSHADWEEP,2007,Farming/Agriculture Activity,0,0,0,0,0,0,0,0,0,0,0,0,0
519,LAKSHADWEEP,2007,Others (Please Specify),0,0,0,0,0,0,0,0,0,0,0,0,0
520,LAKSHADWEEP,2007,Retired Person,0,0,0,0,0,0,0,0,0,0,0,0,0
521,LAKSHADWEEP,2007,Others (Please Specify),0,0,0,0,0,0,0,0,0,0,0,0,0
522,LAKSHADWEEP,2007,Total,0,0,1,0,0,1,0,0,0,2,0,2,3
523,LAKSHADWEEP,2007,Total Salaried,0,0,1,0,0,1,0,0,0,0,0,0,1
524,LAKSHADWEEP,2007,Total Self-employed,0,0,0,0,0,0,0,0,0,0,0,0,0
525,PUDUCHERRY,2007,House Wife,0,0,0,0,0,0,0,48,20,4,6,78,78
526,PUDUCHERRY,2007,Service (Government),0,0,4,6,0,10,0,3,1,0,0,4,14
527,PUDUCHERRY,2007,Service (Private),0,6,10,4,0,20,0,3,4,1,0,8,28
528,PUDUCHERRY,2007,Public Sector Undertaking,0,0,0,0,0,0,0,0,0,0,0,0,0
529,PUDUCHERRY,2007,Student,1,8,0,0,0,9,5,14,4,0,1,24,33
530,PUDUCHERRY,2007,Unemployed,0,22,28,9,9,68,0,39,17,2,5,63,131
531,PUDUCHERRY,2007,Self-employed (Business activity),0,2,6,10,2,20,0,0,0,0,0,0,20
532,PUDUCHERRY,2007,Professional Activity,0,0,0,0,0,0,0,0,0,0,0,0,0
533,PUDUCHERRY,2007,Farming/Agriculture Activity,0,33,82,54,12,181,0,9,6,1,0,16,197
534,PUDUCHERRY,2007,Others (Please Specify),0,0,0,0,0,0,1,4,0,0,0,5,5
535,PUDUCHERRY,2007,Retired Person,0,0,0,0,0,0,0,0,0,0,0,0,0
536,PUDUCHERRY,2007,Others (Please Specify),1,2,3,5,0,11,0,0,0,0,0,0,11
537,PUDUCHERRY,2007,Total,2,73,133,88,23,319,6,120,52,8,12,198,517
538,PUDUCHERRY,2007,Total Salaried,0,6,14,10,0,30,0,6,5,1,0,12,42
539,PUDUCHERRY,2007,Total Self-employed,0,35,88,64,14,201,1,13,6,1,0,21,222
540,TOTAL (UTs),2007,House Wife,0,0,0,0,0,0,0,244,134,31,18,427,427
541,TOTAL (UTs),2007,Service (Government),0,7,27,16,0,50,0,8,2,0,0,10,60
542,TOTAL (UTs),2007,Service (Private),1,133,127,41,5,307,0,27,10,2,0,39,346
543,TOTAL (UTs),2007,Public Sector Undertaking,0,4,5,3,0,12,0,2,0,0,0,2,14
544,TOTAL (UTs),2007,Student,12,89,5,0,0,106,16,80,4,0,1,101,207
545,TOTAL (UTs),2007,Unemployed,1,147,104,32,15,299,0,83,23,2,5,113,412
546,TOTAL (UTs),2007,Self-employed (Business activity),0,11,11,17,3,42,0,0,0,0,0,0,42
547,TOTAL (UTs),2007,Professional Activity,0,3,0,1,0,4,0,1,0,0,0,1,5
548,TOTAL (UTs),2007,Farming/Agriculture Activity,0,46,101,70,20,237,0,9,6,1,0,16,253
549,TOTAL (UTs),2007,Others (Please Specify),0,52,76,26,7,161,1,29,7,0,0,37,198
550,TOTAL (UTs),2007,Retired Person,0,0,0,1,14,15,0,0,0,0,0,0,15
551,TOTAL (UTs),2007,Others (Please Specify),3,92,115,40,13,263,10,50,22,5,1,88,351
552,TOTAL (UTs),2007,Total,17,584,571,247,77,1496,27,533,208,41,25,834,2330
553,TOTAL (UTs),2007,Total Salaried,1,144,159,60,5,369,0,37,12,2,0,51,420
554,TOTAL (UTs),2007,Total Self-employed,0,112,188,114,30,444,1,39,13,1,0,54,498
555,TOTAL (ALL INDIA),2007,House Wife,0,0,0,0,0,0,49,10925,8184,3644,1360,24162,24162
556,TOTAL (ALL INDIA),2007,Service (Government),0,365,658,525,10,1558,1,123,107,53,15,299,1857
557,TOTAL (ALL INDIA),2007,Service (Private),31,2397,3440,2043,334,8245,6,977,513,260,67,1823,10068
558,TOTAL (ALL INDIA),2007,Public Sector Undertaking,0,546,995,587,83,2211,6,196,111,122,1,436,2647
559,TOTAL (ALL INDIA),2007,Student,603,2644,159,8,2,3416,637,2090,91,6,8,2832,6248
560,TOTAL (ALL INDIA),2007,Unemployed,29,2786,2423,1181,270,6689,32,943,597,192,58,1822,8511
561,TOTAL (ALL INDIA),2007,Self-employed (Business activity),1,1592,3220,1768,275,6856,1,156,204,57,6,424,7280
562,TOTAL (ALL INDIA),2007,Professional Activity,4,780,1228,783,191,2986,9,114,83,31,12,249,3235
563,TOTAL (ALL INDIA),2007,Farming/Agriculture Activity,46,3266,5467,4066,1664,14509,49,797,707,414,156,2123,16632
564,TOTAL (ALL INDIA),2007,Others (Please Specify),150,5365,6660,4965,2119,19259,192,1915,1540,934,404,4985,24244
565,TOTAL (ALL INDIA),2007,Retired Person,0,37,69,149,664,919,2,8,7,23,89,129,1048
566,TOTAL (ALL INDIA),2007,Others (Please Specify),320,3668,4232,3038,1389,12647,311,1470,1137,722,418,4058,16705
567,TOTAL (ALL INDIA),2007,Total,1184,23446,28551,19113,7001,79295,1295,19714,13281,6458,2594,43342,122637
568,TOTAL (ALL INDIA),2007,Total Salaried,31,3308,5093,3155,427,12014,13,1296,731,435,83,2558,14572
569,TOTAL (ALL INDIA),2007,Total Self-employed,201,11003,16575,11582,4249,43610,251,2982,2534,1436,578,7781,51391
0,ANDHRA PRADESH,2008,House Wife,0,0,0,0,0,0,0,984,1012,381,139,2516,2516
1,ANDHRA PRADESH,2008,Service (Government),0,17,108,121,0,246,0,7,37,15,0,59,305
2,ANDHRA PRADESH,2008,Service (Private),0,239,420,217,92,968,0,68,75,31,15,189,1157
3,ANDHRA PRADESH,2008,Public Sector Undertaking,4,123,155,181,68,531,0,34,33,21,22,110,641
4,ANDHRA PRADESH,2008,Student,37,233,19,5,0,294,44,133,9,1,0,187,481
5,ANDHRA PRADESH,2008,Unemployed,0,185,164,170,0,519,0,7,20,25,0,52,571
6,ANDHRA PRADESH,2008,Self-employed (Business activity),0,194,458,218,65,935,0,11,17,0,2,30,965
7,ANDHRA PRADESH,2008,Professional Activity,2,60,202,157,38,459,0,25,4,0,4,33,492
8,ANDHRA PRADESH,2008,Farming/Agriculture Activity,2,436,628,505,176,1747,6,142,91,84,35,358,2105
9,ANDHRA PRADESH,2008,Others (Please Specify),7,561,815,427,146,1956,34,270,140,95,41,580,2536
10,ANDHRA PRADESH,2008,Retired Person,0,0,21,7,24,52,0,0,5,2,8,15,67
11,ANDHRA PRADESH,2008,Others (Please Specify),39,666,679,469,161,2014,38,201,141,83,41,504,2518
12,ANDHRA PRADESH,2008,Total,91,2714,3669,2477,770,9721,122,1882,1584,738,307,4633,14354
13,ANDHRA PRADESH,2008,Total Salaried,4,379,683,519,160,1745,0,109,145,67,37,358,2103
14,ANDHRA PRADESH,2008,Total Self-employed,11,1251,2103,1307,425,5097,40,448,252,179,82,1001,6098
15,ARUNACHAL PRADESH,2008,House Wife,0,0,0,0,0,0,0,6,7,1,0,14,14
16,ARUNACHAL PRADESH,2008,Service (Government),0,10,14,1,0,25,0,0,1,0,0,1,26
17,ARUNACHAL PRADESH,2008,Service (Private),0,3,2,0,0,5,0,0,3,0,0,3,8
18,ARUNACHAL PRADESH,2008,Public Sector Undertaking,0,0,0,0,0,0,0,0,0,0,0,0,0
19,ARUNACHAL PRADESH,2008,Student,1,1,0,0,0,2,0,3,0,0,0,3,5
20,ARUNACHAL PRADESH,2008,Unemployed,0,4,6,1,0,11,0,0,1,0,0,1,12
21,ARUNACHAL PRADESH,2008,Self-employed (Business activity),0,0,0,0,0,0,0,0,0,0,0,0,0
22,ARUNACHAL PRADESH,2008,Professional Activity,0,0,0,0,0,0,0,0,0,0,0,0,0
23,ARUNACHAL PRADESH,2008,Farming/Agriculture Activity,0,6,1,5,0,12,0,0,0,0,0,0,12
24,ARUNACHAL PRADESH,2008,Others (Please Specify),0,19,1,0,0,20,0,10,1,0,0,11,31
25,ARUNACHAL PRADESH,2008,Retired Person,0,0,0,0,0,0,0,0,0,0,0,0,0
26,ARUNACHAL PRADESH,2008,Others (Please Specify),1,0,1,0,0,2,0,0,0,0,0,0,2
27,ARUNACHAL PRADESH,2008,Total,2,43,25,7,0,77,0,19,13,1,0,33,110
28,ARUNACHAL PRADESH,2008,Total Salaried,0,13,16,1,0,30,0,0,4,0,0,4,34
29,ARUNACHAL PRADESH,2008,Total Self-employed,0,25,2,5,0,32,0,10,1,0,0,11,43
30,ASSAM,2008,House Wife,0,0,0,0,0,0,0,226,247,89,11,573,573
31,ASSAM,2008,Service (Government),0,2,13,4,0,19,0,2,0,0,0,2,21
32,ASSAM,2008,Service (Private),0,16,26,10,0,52,0,12,6,3,0,21,73
33,ASSAM,2008,Public Sector Undertaking,0,5,28,13,0,46,0,5,1,1,0,7,53
34,ASSAM,2008,Student,21,108,0,0,0,129,12,65,0,0,0,77,206
35,ASSAM,2008,Unemployed,0,15,3,19,0,37,0,7,0,0,0,7,44
36,ASSAM,2008,Self-employed (Business activity),0,117,171,86,1,375,0,35,8,10,1,54,429
37,ASSAM,2008,Professional Activity,0,33,66,32,2,133,0,0,4,0,0,4,137
38,ASSAM,2008,Farming/Agriculture Activity,0,70,61,55,6,192,0,5,0,0,0,5,197
39,ASSAM,2008,Others (Please Specify),2,241,314,156,28,741,1,72,37,9,4,123,864
40,ASSAM,2008,Retired Person,0,0,0,0,4,4,0,0,0,0,1,1,5
41,ASSAM,2008,Others (Please Specify),5,109,90,23,15,242,4,74,57,8,2,145,387
42,ASSAM,2008,Total,28,716,772,398,56,1970,17,503,360,120,19,1019,2989
43,ASSAM,2008,Total Salaried,0,23,67,27,0,117,0,19,7,4,0,30,147
44,ASSAM,2008,Total Self-employed,2,461,612,329,37,1441,1,112,49,19,5,186,1627
45,BIHAR,2008,House Wife,0,0,0,0,0,0,0,66,88,18,2,174,174
46,BIHAR,2008,Service (Government),0,3,2,2,1,8,0,0,0,0,0,0,8
47,BIHAR,2008,Service (Private),0,7,8,15,1,31,0,1,2,1,0,4,35
48,BIHAR,2008,Public Sector Undertaking,0,10,2,1,0,13,0,9,1,0,0,10,23
49,BIHAR,2008,Student,9,26,7,0,0,42,3,13,0,0,0,16,58
50,BIHAR,2008,Unemployed,2,24,17,6,0,49,1,3,0,0,0,4,53
51,BIHAR,2008,Self-employed (Business activity),0,8,7,0,0,15,0,0,0,0,0,0,15
52,BIHAR,2008,Professional Activity,0,1,3,1,0,5,0,0,0,0,0,0,5
53,BIHAR,2008,Farming/Agriculture Activity,0,15,21,21,5,62,0,4,1,0,0,5,67
54,BIHAR,2008,Others (Please Specify),2,10,13,12,19,56,8,7,26,4,10,55,111
55,BIHAR,2008,Retired Person,0,0,0,0,9,9,0,0,0,0,6,6,15
56,BIHAR,2008,Others (Please Specify),22,114,122,39,22,319,21,62,27,17,5,132,451
57,BIHAR,2008,Total,35,218,202,97,57,609,33,165,145,40,23,406,1015
58,BIHAR,2008,Total Salaried,0,20,12,18,2,52,0,10,3,1,0,14,66
59,BIHAR,2008,Total Self-employed,2,34,44,34,24,138,8,11,27,4,10,60,198
60,CHHATTISGARH,2008,House Wife,0,0,0,0,0,0,2,499,275,125,36,937,937
61,CHHATTISGARH,2008,Service (Government),0,9,17,13,0,39,0,6,0,0,0,6,45
62,CHHATTISGARH,2008,Service (Private),0,71,77,29,6,183,0,9,6,3,0,18,201
63,CHHATTISGARH,2008,Public Sector Undertaking,0,1,6,3,0,10,0,0,0,0,0,0,10
64,CHHATTISGARH,2008,Student,37,162,2,1,0,202,35,130,3,0,0,168,370
65,CHHATTISGARH,2008,Unemployed,0,86,65,16,0,167,0,6,2,2,0,10,177
66,CHHATTISGARH,2008,Self-employed (Business activity),0,51,63,33,6,153,0,4,0,0,0,4,157
67,CHHATTISGARH,2008,Professional Activity,0,27,26,19,8,80,0,0,11,2,0,13,93
68,CHHATTISGARH,2008,Farming/Agriculture Activity,9,436,576,346,124,1491,20,101,107,46,8,282,1773
69,CHHATTISGARH,2008,Others (Please Specify),13,213,242,149,45,662,11,82,45,17,9,164,826
70,CHHATTISGARH,2008,Retired Person,0,0,0,2,0,2,0,0,0,0,0,0,2
71,CHHATTISGARH,2008,Others (Please Specify),6,69,82,74,28,259,14,17,29,23,12,95,354
72,CHHATTISGARH,2008,Total,65,1125,1156,685,217,3248,82,854,478,218,65,1697,4945
73,CHHATTISGARH,2008,Total Salaried,0,81,100,45,6,232,0,15,6,3,0,24,256
74,CHHATTISGARH,2008,Total Self-employed,22,727,907,547,183,2386,31,187,163,65,17,463,2849
75,GOA,2008,House Wife,0,0,0,0,0,0,0,25,19,10,11,65,65
76,GOA,2008,Service (Government),0,0,3,0,0,3,0,1,0,0,0,1,4
77,GOA,2008,Service (Private),0,23,25,7,1,56,0,5,2,0,0,7,63
78,GOA,2008,Public Sector Undertaking,0,0,0,0,0,0,0,0,0,0,0,0,0
79,GOA,2008,Student,0,5,0,0,0,5,2,5,0,0,0,7,12
80,GOA,2008,Unemployed,0,18,22,12,2,54,1,13,3,0,0,17,71
81,GOA,2008,Self-employed (Business activity),0,1,7,3,0,11,0,0,1,0,0,1,12
82,GOA,2008,Professional Activity,0,0,1,0,0,1,0,0,0,0,0,0,1
83,GOA,2008,Farming/Agriculture Activity,0,0,2,2,2,6,0,0,0,0,0,0,6
84,GOA,2008,Others (Please Specify),0,1,3,0,4,8,0,1,0,0,0,1,9
85,GOA,2008,Retired Person,0,0,0,0,2,2,0,0,0,0,0,0,2
86,GOA,2008,Others (Please Specify),0,7,21,5,4,37,0,4,1,0,0,5,42
87,GOA,2008,Total,0,55,84,29,15,183,3,54,26,10,11,104,287
88,GOA,2008,Total Salaried,0,23,28,7,1,59,0,6,2,0,0,8,67
89,GOA,2008,Total Self-employed,0,2,13,5,6,26,0,1,1,0,0,2,28
90,GUJARAT,2008,House Wife,0,0,0,0,0,0,3,751,622,255,113,1744,1744
91,GUJARAT,2008,Service (Government),0,9,30,18,0,57,0,2,3,0,0,5,62
92,GUJARAT,2008,Service (Private),0,178,244,119,3,544,0,25,30,9,0,64,608
93,GUJARAT,2008,Public Sector Undertaking,0,23,55,22,2,102,0,16,7,2,0,25,127
94,GUJARAT,2008,Student,13,131,9,2,0,155,18,122,7,2,0,149,304
95,GUJARAT,2008,Unemployed,1,206,219,76,11,513,4,28,8,4,1,45,558
96,GUJARAT,2008,Self-employed (Business activity),0,75,124,78,10,287,0,0,3,0,0,3,290
97,GUJARAT,2008,Professional Activity,0,155,161,85,19,420,0,4,4,0,0,8,428
98,GUJARAT,2008,Farming/Agriculture Activity,0,115,182,92,52,441,1,21,19,38,6,85,526
99,GUJARAT,2008,Others (Please Specify),2,225,241,133,26,627,2,50,42,9,7,110,737
100,GUJARAT,2008,Retired Person,0,3,1,48,90,142,0,0,0,11,34,45,187
101,GUJARAT,2008,Others (Please Specify),9,130,156,114,38,447,11,71,41,17,7,147,594
102,GUJARAT,2008,Total,25,1250,1422,787,251,3735,39,1090,786,347,168,2430,6165
103,GUJARAT,2008,Total Salaried,0,210,329,159,5,703,0,43,40,11,0,94,797
104,GUJARAT,2008,Total Self-employed,2,570,708,388,107,1775,3,75,68,47,13,206,1981
105,HARYANA,2008,House Wife,0,0,0,0,0,0,0,159,135,52,20,366,366
106,HARYANA,2008,Service (Government),0,29,40,14,7,90,0,3,0,0,0,3,93
107,HARYANA,2008,Service (Private),0,95,101,38,5,239,0,9,2,0,0,11,250
108,HARYANA,2008,Public Sector Undertaking,0,41,33,11,7,92,0,3,1,0,0,4,96
109,HARYANA,2008,Student,10,78,3,1,0,92,15,28,0,0,0,43,135
110,HARYANA,2008,Unemployed,0,47,75,30,7,159,0,6,12,5,1,24,183
111,HARYANA,2008,Self-employed (Business activity),0,15,16,7,0,38,0,3,0,0,0,3,41
112,HARYANA,2008,Professional Activity,0,12,28,9,1,50,0,0,0,0,0,0,50
113,HARYANA,2008,Farming/Agriculture Activity,0,34,62,36,18,150,0,0,0,0,0,0,150
114,HARYANA,2008,Others (Please Specify),0,42,57,18,6,123,0,9,8,4,0,21,144
115,HARYANA,2008,Retired Person,0,1,0,0,7,8,0,2,0,2,0,4,12
116,HARYANA,2008,Others (Please Specify),37,293,359,158,86,933,24,52,97,22,8,203,1136
117,HARYANA,2008,Total,47,687,774,322,144,1974,39,274,255,85,29,682,2656
118,HARYANA,2008,Total Salaried,0,165,174,63,19,421,0,15,3,0,0,18,439
119,HARYANA,2008,Total Self-employed,0,103,163,70,25,361,0,12,8,4,0,24,385
120,HIMACHAL PRADESH,2008,House Wife,0,0,0,0,0,0,0,38,29,11,9,87,87
121,HIMACHAL PRADESH,2008,Service (Government),0,6,5,8,0,19,0,1,0,1,0,2,21
122,HIMACHAL PRADESH,2008,Service (Private),0,20,10,8,1,39,0,3,5,1,1,10,49
123,HIMACHAL PRADESH,2008,Public Sector Undertaking,0,6,5,4,1,16,0,4,1,2,0,7,23
124,HIMACHAL PRADESH,2008,Student,3,17,0,0,0,20,5,10,0,1,0,16,36
125,HIMACHAL PRADESH,2008,Unemployed,0,16,11,2,0,29,0,9,0,0,0,9,38
126,HIMACHAL PRADESH,2008,Self-employed (Business activity),0,5,13,8,5,31,0,0,1,0,0,1,32
127,HIMACHAL PRADESH,2008,Professional Activity,0,3,3,3,0,9,0,1,2,1,1,5,14
128,HIMACHAL PRADESH,2008,Farming/Agriculture Activity,3,36,42,46,23,150,3,14,10,4,7,38,188
129,HIMACHAL PRADESH,2008,Others (Please Specify),0,22,16,22,6,66,2,10,4,2,0,18,84
130,HIMACHAL PRADESH,2008,Retired Person,0,0,0,1,2,3,0,0,0,0,0,0,3
131,HIMACHAL PRADESH,2008,Others (Please Specify),0,9,10,14,2,35,0,13,5,2,0,20,55
132,HIMACHAL PRADESH,2008,Total,6,140,115,116,40,417,10,103,57,25,18,213,630
133,HIMACHAL PRADESH,2008,Total Salaried,0,32,20,20,2,74,0,8,6,4,1,19,93
134,HIMACHAL PRADESH,2008,Total Self-employed,3,66,74,79,34,256,5,25,17,7,8,62,318
135,JAMMU & KASHMIR,2008,House Wife,0,0,0,0,0,0,0,38,36,1,0,75,75
136,JAMMU & KASHMIR,2008,Service (Government),0,4,12,9,0,25,0,1,2,0,0,3,28
137,JAMMU & KASHMIR,2008,Service (Private),0,5,11,6,0,22,0,2,3,0,0,5,27
138,JAMMU & KASHMIR,2008,Public Sector Undertaking,0,1,5,13,1,20,0,1,0,0,0,1,21
139,JAMMU & KASHMIR,2008,Student,0,7,0,0,0,7,1,8,0,0,0,9,16
140,JAMMU & KASHMIR,2008,Unemployed,0,16,19,1,1,37,0,12,2,0,0,14,51
141,JAMMU & KASHMIR,2008,Self-employed (Business activity),0,0,3,2,1,6,0,0,0,0,0,0,6
142,JAMMU & KASHMIR,2008,Professional Activity,0,0,1,2,1,4,0,0,0,0,0,0,4
143,JAMMU & KASHMIR,2008,Farming/Agriculture Activity,0,2,1,1,0,4,0,2,0,0,0,2,6
144,JAMMU & KASHMIR,2008,Others (Please Specify),0,11,6,3,3,23,0,9,3,0,0,12,35
145,JAMMU & KASHMIR,2008,Retired Person,0,0,0,0,6,6,0,0,0,0,0,0,6
146,JAMMU & KASHMIR,2008,Others (Please Specify),1,10,5,4,3,23,0,7,5,0,0,12,35
147,JAMMU & KASHMIR,2008,Total,1,56,63,41,16,177,1,80,51,1,0,133,310
148,JAMMU & KASHMIR,2008,Total Salaried,0,10,28,28,1,67,0,4,5,0,0,9,76
149,JAMMU & KASHMIR,2008,Total Self-employed,0,13,11,8,5,37,0,11,3,0,0,14,51
150,JHARKHAND,2008,House Wife,0,0,0,0,0,0,1,58,67,41,3,170,170
151,JHARKHAND,2008,Service (Government),0,2,7,3,0,12,0,0,0,1,0,1,13
152,JHARKHAND,2008,Service (Private),0,8,19,4,0,31,0,0,4,0,0,4,35
153,JHARKHAND,2008,Public Sector Undertaking,0,5,7,2,0,14,0,0,0,0,0,0,14
154,JHARKHAND,2008,Student,8,52,1,0,0,61,13,26,1,0,0,40,101
155,JHARKHAND,2008,Unemployed,0,17,18,10,5,50,1,3,6,0,0,10,60
156,JHARKHAND,2008,Self-employed (Business activity),0,4,18,10,0,32,0,3,0,0,0,3,35
157,JHARKHAND,2008,Professional Activity,0,1,32,10,0,43,5,0,0,0,0,5,48
158,JHARKHAND,2008,Farming/Agriculture Activity,3,17,18,23,3,64,2,2,2,1,0,7,71
159,JHARKHAND,2008,Others (Please Specify),8,25,42,25,6,106,1,2,11,0,1,15,121
160,JHARKHAND,2008,Retired Person,0,0,0,0,4,4,0,0,0,0,0,0,4
161,JHARKHAND,2008,Others (Please Specify),1,40,76,47,21,185,8,19,17,7,3,54,239
162,JHARKHAND,2008,Total,20,171,238,134,39,602,31,113,108,50,7,309,911
163,JHARKHAND,2008,Total Salaried,0,15,33,9,0,57,0,0,4,1,0,5,62
164,JHARKHAND,2008,Total Self-employed,11,47,110,68,9,245,8,7,13,1,1,30,275
165,KARNATAKA,2008,House Wife,0,0,0,0,0,0,3,658,587,291,114,1653,1653
166,KARNATAKA,2008,Service (Government),0,53,57,84,2,196,0,21,19,7,6,53,249
167,KARNATAKA,2008,Service (Private),0,279,417,311,47,1054,5,120,50,15,22,212,1266
168,KARNATAKA,2008,Public Sector Undertaking,0,60,77,75,23,235,1,46,6,10,6,69,304
169,KARNATAKA,2008,Student,24,180,19,18,2,243,25,176,11,0,0,212,455
170,KARNATAKA,2008,Unemployed,0,146,153,78,24,401,2,45,35,11,0,93,494
171,KARNATAKA,2008,Self-employed (Business activity),0,149,248,115,32,544,0,13,14,9,4,40,584
172,KARNATAKA,2008,Professional Activity,0,30,31,52,5,118,0,16,3,2,1,22,140
173,KARNATAKA,2008,Farming/Agriculture Activity,0,255,570,435,179,1439,0,99,120,59,20,298,1737
174,KARNATAKA,2008,Others (Please Specify),11,395,664,577,267,1914,16,161,117,101,65,460,2374
175,KARNATAKA,2008,Retired Person,0,0,4,12,35,51,0,1,0,1,4,6,57
176,KARNATAKA,2008,Others (Please Specify),19,651,630,546,175,2021,28,301,299,184,76,888,2909
177,KARNATAKA,2008,Total,54,2198,2870,2303,791,8216,80,1657,1261,690,318,4006,12222
178,KARNATAKA,2008,Total Salaried,0,392,551,470,72,1485,6,187,75,32,34,334,1819
179,KARNATAKA,2008,Total Self-employed,11,829,1513,1179,483,4015,16,289,254,171,90,820,4835
180,KERALA,2008,House Wife,0,0,0,0,0,0,0,258,435,376,251,1320,1320
181,KERALA,2008,Service (Government),0,3,27,36,1,67,0,1,7,5,0,13,80
182,KERALA,2008,Service (Private),0,52,176,147,14,389,0,23,28,25,1,77,466
183,KERALA,2008,Public Sector Undertaking,0,4,35,37,0,76,0,3,4,3,0,10,86
184,KERALA,2008,Student,25,66,0,0,0,91,38,157,0,0,0,195,286
185,KERALA,2008,Unemployed,0,180,294,131,63,668,0,71,46,35,11,163,831
186,KERALA,2008,Self-employed (Business activity),0,36,110,173,55,374,0,1,2,6,0,9,383
187,KERALA,2008,Professional Activity,0,32,57,48,11,148,0,2,5,3,0,10,158
188,KERALA,2008,Farming/Agriculture Activity,0,71,219,294,184,768,0,8,11,23,10,52,820
189,KERALA,2008,Others (Please Specify),0,328,574,607,320,1829,1,95,99,90,47,332,2161
190,KERALA,2008,Retired Person,0,0,1,23,76,100,0,0,0,1,8,9,109
191,KERALA,2008,Others (Please Specify),1,244,555,505,315,1620,3,47,55,70,74,249,1869
192,KERALA,2008,Total,26,1016,2048,2001,1039,6130,42,666,692,637,402,2439,8569
193,KERALA,2008,Total Salaried,0,59,238,220,15,532,0,27,39,33,1,100,632
194,KERALA,2008,Total Self-employed,0,467,960,1122,570,3119,1,106,117,122,57,403,3522
195,MADHYA PRADESH,2008,House Wife,0,0,0,0,0,0,6,1204,593,215,55,2073,2073
196,MADHYA PRADESH,2008,Service (Government),0,60,66,56,0,182,0,22,26,0,0,48,230
197,MADHYA PRADESH,2008,Service (Private),2,132,142,55,6,337,0,26,69,5,0,100,437
198,MADHYA PRADESH,2008,Public Sector Undertaking,0,69,73,73,13,228,0,3,6,0,0,9,237
199,MADHYA PRADESH,2008,Student,29,180,26,6,0,241,50,128,1,0,0,179,420
200,MADHYA PRADESH,2008,Unemployed,1,146,78,48,5,278,0,38,15,0,0,53,331
201,MADHYA PRADESH,2008,Self-employed (Business activity),1,103,148,43,12,307,0,14,8,2,0,24,331
202,MADHYA PRADESH,2008,Professional Activity,2,62,86,48,4,202,0,19,10,4,0,33,235
203,MADHYA PRADESH,2008,Farming/Agriculture Activity,6,437,389,204,136,1172,2,106,68,21,10,207,1379
204,MADHYA PRADESH,2008,Others (Please Specify),21,250,308,206,160,945,10,154,87,37,23,311,1256
205,MADHYA PRADESH,2008,Retired Person,0,3,2,0,13,18,0,0,0,0,0,0,18
206,MADHYA PRADESH,2008,Others (Please Specify),13,150,183,76,33,455,12,119,62,21,13,227,682
207,MADHYA PRADESH,2008,Total,75,1592,1501,815,382,4365,80,1833,945,305,101,3264,7629
208,MADHYA PRADESH,2008,Total Salaried,2,261,281,184,19,747,0,51,101,5,0,157,904
209,MADHYA PRADESH,2008,Total Self-employed,30,852,931,501,312,2626,12,293,173,64,33,575,3201
210,MAHARASHTRA,2008,House Wife,0,0,0,0,0,0,7,1744,1017,369,247,3384,3384
211,MAHARASHTRA,2008,Service (Government),0,28,61,58,0,147,0,6,4,0,0,10,157
212,MAHARASHTRA,2008,Service (Private),0,476,693,360,31,1560,0,65,23,5,0,93,1653
213,MAHARASHTRA,2008,Public Sector Undertaking,0,59,66,44,9,178,1,13,4,0,0,18,196
214,MAHARASHTRA,2008,Student,44,355,8,0,0,407,57,290,3,0,0,350,757
215,MAHARASHTRA,2008,Unemployed,2,353,284,134,23,796,0,56,19,1,1,77,873
216,MAHARASHTRA,2008,Self-employed (Business activity),0,111,191,125,31,458,0,8,3,0,0,11,469
217,MAHARASHTRA,2008,Professional Activity,0,136,183,111,51,481,0,27,24,6,2,59,540
218,MAHARASHTRA,2008,Farming/Agriculture Activity,0,856,1392,935,390,3573,2,89,92,31,15,229,3802
219,MAHARASHTRA,2008,Others (Please Specify),0,623,778,418,181,2000,1,105,56,43,14,219,2219
220,MAHARASHTRA,2008,Retired Person,0,0,0,20,100,120,0,0,1,2,10,13,133
221,MAHARASHTRA,2008,Others (Please Specify),1,39,69,42,18,169,6,9,5,1,1,22,191
222,MAHARASHTRA,2008,Total,47,3036,3725,2247,834,9889,74,2412,1251,458,290,4485,14374
223,MAHARASHTRA,2008,Total Salaried,0,563,820,462,40,1885,1,84,31,5,0,121,2006
224,MAHARASHTRA,2008,Total Self-employed,0,1726,2544,1589,653,6512,3,229,175,80,31,518,7030
225,MANIPUR,2008,House Wife,0,0,0,0,0,0,0,3,1,1,0,5,5
226,MANIPUR,2008,Service (Government),0,3,4,0,0,7,0,0,0,0,0,0,7
227,MANIPUR,2008,Service (Private),0,0,0,0,0,0,0,0,0,0,0,0,0
228,MANIPUR,2008,Public Sector Undertaking,0,0,0,0,0,0,0,0,0,0,0,0,0
229,MANIPUR,2008,Student,0,2,0,0,0,2,1,1,0,0,0,2,4
230,MANIPUR,2008,Unemployed,0,5,2,0,0,7,0,2,1,0,0,3,10
231,MANIPUR,2008,Self-employed (Business activity),0,0,0,0,0,0,0,0,0,0,0,0,0
232,MANIPUR,2008,Professional Activity,0,0,0,0,0,0,0,0,0,0,0,0,0
233,MANIPUR,2008,Farming/Agriculture Activity,0,0,2,0,0,2,0,0,0,0,0,0,2
234,MANIPUR,2008,Others (Please Specify),0,1,3,0,0,4,0,1,0,0,0,1,5
235,MANIPUR,2008,Retired Person,0,0,0,0,0,0,0,0,0,0,0,0,0
236,MANIPUR,2008,Others (Please Specify),0,0,1,0,0,1,0,0,0,0,0,0,1
237,MANIPUR,2008,Total,0,11,12,0,0,23,1,7,2,1,0,11,34
238,MANIPUR,2008,Total Salaried,0,3,4,0,0,7,0,0,0,0,0,0,7
239,MANIPUR,2008,Total Self-employed,0,1,5,0,0,6,0,1,0,0,0,1,7
240,MEGHALAYA,2008,House Wife,0,0,0,0,0,0,0,3,4,2,0,9,9
241,MEGHALAYA,2008,Service (Government),0,0,5,2,0,7,0,0,1,0,0,1,8
242,MEGHALAYA,2008,Service (Private),0,0,1,0,0,1,0,0,0,0,0,0,1
243,MEGHALAYA,2008,Public Sector Undertaking,0,0,0,0,0,0,0,0,0,0,0,0,0
244,MEGHALAYA,2008,Student,0,4,1,0,0,5,1,3,0,0,0,4,9
245,MEGHALAYA,2008,Unemployed,0,7,5,4,0,16,0,2,1,0,1,4,20
246,MEGHALAYA,2008,Self-employed (Business activity),0,0,0,0,0,0,0,0,0,0,0,0,0
247,MEGHALAYA,2008,Professional Activity,0,0,0,0,0,0,0,1,0,0,0,1,1
248,MEGHALAYA,2008,Farming/Agriculture Activity,0,4,3,2,0,9,0,0,0,0,0,0,9
249,MEGHALAYA,2008,Others (Please Specify),0,4,12,2,1,19,0,1,0,0,1,2,21
250,MEGHALAYA,2008,Retired Person,0,0,0,0,0,0,0,0,0,0,0,0,0
251,MEGHALAYA,2008,Others (Please Specify),0,0,0,0,0,0,0,1,6,0,0,7,7
252,MEGHALAYA,2008,Total,0,19,27,10,1,57,1,11,12,2,2,28,85
253,MEGHALAYA,2008,Total Salaried,0,0,6,2,0,8,0,0,1,0,0,1,9
254,MEGHALAYA,2008,Total Self-employed,0,8,15,4,1,28,0,2,0,0,1,3,31
255,MIZORAM,2008,House Wife,0,0,0,0,0,0,0,0,0,0,0,0,0
256,MIZORAM,2008,Service (Government),0,0,0,0,0,0,0,0,0,0,0,0,0
257,MIZORAM,2008,Service (Private),0,0,0,0,0,0,0,0,0,0,0,0,0
258,MIZORAM,2008,Public Sector Undertaking,0,0,0,0,0,0,0,0,0,0,0,0,0
259,MIZORAM,2008,Student,0,3,0,0,0,3,0,0,2,0,0,2,5
260,MIZORAM,2008,Unemployed,0,0,0,0,0,0,0,0,0,0,0,0,0
261,MIZORAM,2008,Self-employed (Business activity),0,0,3,0,0,3,0,0,0,0,0,0,3
262,MIZORAM,2008,Professional Activity,0,0,0,0,0,0,0,0,0,0,0,0,0
263,MIZORAM,2008,Farming/Agriculture Activity,0,0,0,0,0,0,0,0,0,0,0,0,0
264,MIZORAM,2008,Others (Please Specify),0,0,0,1,0,1,0,0,1,0,0,1,2
265,MIZORAM,2008,Retired Person,0,0,0,0,0,0,0,0,0,0,0,0,0
266,MIZORAM,2008,Others (Please Specify),0,9,13,6,0,28,0,2,0,1,0,3,31
267,MIZORAM,2008,Total,0,12,16,7,0,35,0,2,3,1,0,6,41
268,MIZORAM,2008,Total Salaried,0,0,0,0,0,0,0,0,0,0,0,0,0
269,MIZORAM,2008,Total Self-employed,0,0,3,1,0,4,0,0,1,0,0,1,5
270,NAGALAND,2008,House Wife,0,0,0,0,0,0,0,4,0,0,0,4,4
271,NAGALAND,2008,Service (Government),0,0,4,0,0,4,0,1,0,0,0,1,5
272,NAGALAND,2008,Service (Private),0,0,0,0,0,0,0,0,0,0,0,0,0
273,NAGALAND,2008,Public Sector Undertaking,0,0,0,0,0,0,0,0,0,0,0,0,0
274,NAGALAND,2008,Student,0,0,0,0,0,0,0,3,0,0,0,3,3
275,NAGALAND,2008,Unemployed,0,0,0,0,0,0,0,0,0,0,0,0,0
276,NAGALAND,2008,Self-employed (Business activity),0,0,0,0,0,0,0,0,0,0,0,0,0
277,NAGALAND,2008,Professional Activity,0,0,0,0,0,0,0,0,0,0,0,0,0
278,NAGALAND,2008,Farming/Agriculture Activity,0,0,0,2,0,2,0,0,0,0,0,0,2
279,NAGALAND,2008,Others (Please Specify),0,2,6,2,0,10,0,0,0,0,0,0,10
280,NAGALAND,2008,Retired Person,0,0,0,0,0,0,0,0,0,0,0,0,0
281,NAGALAND,2008,Others (Please Specify),0,0,10,6,0,16,0,0,2,0,0,2,18
282,NAGALAND,2008,Total,0,2,20,10,0,32,0,8,2,0,0,10,42
283,NAGALAND,2008,Total Salaried,0,0,4,0,0,4,0,1,0,0,0,1,5
284,NAGALAND,2008,Total Self-employed,0,2,6,4,0,12,0,0,0,0,0,0,12
285,ODISHA,2008,House Wife,0,0,0,0,0,0,0,250,259,113,57,679,679
286,ODISHA,2008,Service (Government),0,0,2,7,0,9,0,9,2,2,0,13,22
287,ODISHA,2008,Service (Private),2,77,117,68,8,272,3,43,35,4,2,87,359
288,ODISHA,2008,Public Sector Undertaking,0,53,42,11,2,108,0,19,9,0,0,28,136
289,ODISHA,2008,Student,27,95,9,0,0,131,23,60,3,0,0,86,217
290,ODISHA,2008,Unemployed,26,201,124,91,8,450,3,71,28,8,0,110,560
291,ODISHA,2008,Self-employed (Business activity),0,50,121,77,27,275,0,7,2,4,0,13,288
292,ODISHA,2008,Professional Activity,1,19,84,19,8,131,0,8,6,2,2,18,149
293,ODISHA,2008,Farming/Agriculture Activity,7,77,101,41,19,245,0,1,10,3,1,15,260
294,ODISHA,2008,Others (Please Specify),23,367,231,246,114,981,9,134,125,63,29,360,1341
295,ODISHA,2008,Retired Person,0,0,0,13,23,36,0,0,0,1,6,7,43
296,ODISHA,2008,Others (Please Specify),28,105,190,140,54,517,17,118,117,59,22,333,850
297,ODISHA,2008,Total,114,1044,1021,713,263,3155,55,720,596,259,119,1749,4904
298,ODISHA,2008,Total Salaried,2,130,161,86,10,389,3,71,46,6,2,128,517
299,ODISHA,2008,Total Self-employed,31,513,537,383,168,1632,9,150,143,72,32,406,2038
300,PUNJAB,2008,House Wife,0,0,0,0,0,0,1,66,66,15,8,156,156
301,PUNJAB,2008,Service (Government),0,4,16,9,0,29,0,0,0,0,0,0,29
302,PUNJAB,2008,Service (Private),0,35,36,12,0,83,0,2,3,0,0,5,88
303,PUNJAB,2008,Public Sector Undertaking,0,1,1,0,0,2,0,0,0,0,0,0,2
304,PUNJAB,2008,Student,2,23,0,1,0,26,3,19,0,0,0,22,48
305,PUNJAB,2008,Unemployed,0,24,20,7,3,54,0,1,0,0,0,1,55
306,PUNJAB,2008,Self-employed (Business activity),0,26,45,21,13,105,0,0,0,0,0,0,105
307,PUNJAB,2008,Professional Activity,0,4,4,3,2,13,0,0,0,0,0,0,13
308,PUNJAB,2008,Farming/Agriculture Activity,1,18,32,9,6,66,0,0,0,0,0,0,66
309,PUNJAB,2008,Others (Please Specify),3,37,41,36,7,124,1,14,12,3,1,31,155
310,PUNJAB,2008,Retired Person,0,0,0,0,2,2,0,0,0,0,0,0,2
311,PUNJAB,2008,Others (Please Specify),2,32,54,32,19,139,5,4,2,0,0,11,150
312,PUNJAB,2008,Total,8,204,249,130,52,643,10,106,83,18,9,226,869
313,PUNJAB,2008,Total Salaried,0,40,53,21,0,114,0,2,3,0,0,5,119
314,PUNJAB,2008,Total Self-employed,4,85,122,69,28,308,1,14,12,3,1,31,339
315,RAJASTHAN,2008,House Wife,0,0,0,0,0,0,18,360,389,147,44,958,958
316,RAJASTHAN,2008,Service (Government),0,13,31,18,1,63,0,13,7,6,0,26,89
317,RAJASTHAN,2008,Service (Private),0,136,206,86,3,431,0,27,5,3,0,35,466
318,RAJASTHAN,2008,Public Sector Undertaking,0,6,6,4,1,17,0,1,1,0,0,2,19
319,RAJASTHAN,2008,Student,29,101,43,0,0,173,13,53,3,0,0,69,242
320,RAJASTHAN,2008,Unemployed,0,81,65,22,8,176,0,15,12,4,0,31,207
321,RAJASTHAN,2008,Self-employed (Business activity),0,57,109,66,2,234,0,2,3,5,0,10,244
322,RAJASTHAN,2008,Professional Activity,0,18,24,8,3,53,0,0,0,0,0,0,53
323,RAJASTHAN,2008,Farming/Agriculture Activity,0,156,287,212,40,695,2,33,56,7,3,101,796
324,RAJASTHAN,2008,Others (Please Specify),38,336,392,161,45,972,9,80,33,38,4,164,1136
325,RAJASTHAN,2008,Retired Person,0,5,5,2,1,13,0,0,0,0,0,0,13
326,RAJASTHAN,2008,Others (Please Specify),51,253,247,169,55,775,26,74,40,20,8,168,943
327,RAJASTHAN,2008,Total,118,1162,1415,748,159,3602,68,658,549,230,59,1564,5166
328,RAJASTHAN,2008,Total Salaried,0,155,243,108,5,511,0,41,13,9,0,63,574
329,RAJASTHAN,2008,Total Self-employed,38,567,812,447,90,1954,11,115,92,50,7,275,2229
330,SIKKIM,2008,House Wife,0,0,0,0,0,0,0,6,0,1,0,7,7
331,SIKKIM,2008,Service (Government),0,0,0,0,0,0,0,0,0,0,0,0,0
332,SIKKIM,2008,Service (Private),0,8,4,6,2,20,0,2,4,2,0,8,28
333,SIKKIM,2008,Public Sector Undertaking,0,0,0,0,0,0,0,3,1,2,0,6,6
334,SIKKIM,2008,Student,2,6,0,0,0,8,0,4,0,0,0,4,12
335,SIKKIM,2008,Unemployed,0,16,11,6,3,36,0,3,6,4,0,13,49
336,SIKKIM,2008,Self-employed (Business activity),0,0,0,0,0,0,0,0,0,0,0,0,0
337,SIKKIM,2008,Professional Activity,0,0,0,0,0,0,0,0,0,0,0,0,0
338,SIKKIM,2008,Farming/Agriculture Activity,0,10,21,17,1,49,0,2,6,0,3,11,60
339,SIKKIM,2008,Others (Please Specify),0,20,20,16,4,60,0,0,0,0,0,0,60
340,SIKKIM,2008,Retired Person,0,0,0,0,0,0,0,0,0,0,0,0,0
341,SIKKIM,2008,Others (Please Specify),0,10,13,20,0,43,0,6,9,4,3,22,65
342,SIKKIM,2008,Total,2,70,69,65,10,216,0,26,26,13,6,71,287
343,SIKKIM,2008,Total Salaried,0,8,4,6,2,20,0,5,5,4,0,14,34
344,SIKKIM,2008,Total Self-employed,0,30,41,33,5,109,0,2,6,0,3,11,120
345,TAMIL NADU,2008,House Wife,0,0,0,0,0,0,0,841,986,470,133,2430,2430
346,TAMIL NADU,2008,Service (Government),0,31,153,83,2,269,0,20,11,9,6,46,315
347,TAMIL NADU,2008,Service (Private),0,357,520,385,71,1333,0,476,120,84,8,688,2021
348,TAMIL NADU,2008,Public Sector Undertaking,0,75,132,71,3,281,0,31,15,54,7,107,388
349,TAMIL NADU,2008,Student,30,84,0,0,0,114,43,97,4,0,0,144,258
350,TAMIL NADU,2008,Unemployed,0,431,134,197,111,873,0,263,145,75,10,493,1366
351,TAMIL NADU,2008,Self-employed (Business activity),0,196,854,201,35,1286,0,29,95,13,4,141,1427
352,TAMIL NADU,2008,Professional Activity,0,110,170,95,41,416,0,55,49,28,10,142,558
353,TAMIL NADU,2008,Farming/Agriculture Activity,0,95,170,95,40,400,0,40,46,24,2,112,512
354,TAMIL NADU,2008,Others (Please Specify),0,886,710,850,325,2771,0,258,175,123,84,640,3411
355,TAMIL NADU,2008,Retired Person,0,0,0,12,89,101,0,0,0,0,16,16,117
356,TAMIL NADU,2008,Others (Please Specify),0,298,422,325,154,1199,40,105,135,84,59,423,1622
357,TAMIL NADU,2008,Total,30,2563,3265,2314,871,9043,83,2215,1781,964,339,5382,14425
358,TAMIL NADU,2008,Total Salaried,0,463,805,539,76,1883,0,527,146,147,21,841,2724
359,TAMIL NADU,2008,Total Self-employed,0,1287,1904,1241,441,4873,0,382,365,188,100,1035,5908
360,TRIPURA,2008,House Wife,0,0,0,0,0,0,0,56,43,29,2,130,130
361,TRIPURA,2008,Service (Government),0,3,9,3,0,15,0,0,0,0,0,0,15
362,TRIPURA,2008,Service (Private),0,4,8,2,0,14,0,0,7,4,0,11,25
363,TRIPURA,2008,Public Sector Undertaking,0,0,0,2,0,2,0,0,0,0,0,0,2
364,TRIPURA,2008,Student,9,43,0,0,0,52,13,26,0,0,0,39,91
365,TRIPURA,2008,Unemployed,0,32,61,27,13,133,0,13,5,0,0,18,151
366,TRIPURA,2008,Self-employed (Business activity),0,7,8,3,0,18,0,0,0,0,0,0,18
367,TRIPURA,2008,Professional Activity,0,0,0,0,0,0,0,0,0,0,0,0,0
368,TRIPURA,2008,Farming/Agriculture Activity,0,10,20,15,0,45,0,0,5,0,0,5,50
369,TRIPURA,2008,Others (Please Specify),0,25,38,17,12,92,0,19,10,5,0,34,126
370,TRIPURA,2008,Retired Person,0,0,0,0,0,0,0,0,0,0,0,0,0
371,TRIPURA,2008,Others (Please Specify),0,28,23,20,0,71,1,29,26,13,4,73,144
372,TRIPURA,2008,Total,9,152,167,89,25,442,14,143,96,51,6,310,752
373,TRIPURA,2008,Total Salaried,0,7,17,7,0,31,0,0,7,4,0,11,42
374,TRIPURA,2008,Total Self-employed,0,42,66,35,12,155,0,19,15,5,0,39,194
375,UTTAR PRADESH,2008,House Wife,0,0,0,0,0,0,10,618,337,91,49,1105,1105
376,UTTAR PRADESH,2008,Service (Government),0,8,15,7,0,30,0,9,5,0,0,14,44
377,UTTAR PRADESH,2008,Service (Private),0,102,84,4,2,192,0,24,12,5,0,41,233
378,UTTAR PRADESH,2008,Public Sector Undertaking,0,18,19,5,1,43,0,3,4,4,0,11,54
379,UTTAR PRADESH,2008,Student,27,148,22,1,2,200,25,125,4,0,0,154,354
380,UTTAR PRADESH,2008,Unemployed,1,101,90,32,15,239,0,25,17,4,1,47,286
381,UTTAR PRADESH,2008,Self-employed (Business activity),1,29,70,53,28,181,4,5,10,1,2,22,203
382,UTTAR PRADESH,2008,Professional Activity,0,6,9,6,1,22,0,7,1,1,0,9,31
383,UTTAR PRADESH,2008,Farming/Agriculture Activity,1,128,267,156,64,616,0,44,59,14,12,129,745
384,UTTAR PRADESH,2008,Others (Please Specify),19,152,106,101,44,422,25,164,40,17,16,262,684
385,UTTAR PRADESH,2008,Retired Person,0,0,1,2,3,6,0,0,0,0,0,0,6
386,UTTAR PRADESH,2008,Others (Please Specify),11,76,75,52,14,228,5,59,30,14,7,115,343
387,UTTAR PRADESH,2008,Total,60,768,758,419,174,2179,69,1083,519,151,87,1909,4088
388,UTTAR PRADESH,2008,Total Salaried,0,128,118,16,3,265,0,36,21,9,0,66,331
389,UTTAR PRADESH,2008,Total Self-employed,21,315,452,316,137,1241,29,220,110,33,30,422,1663
390,UTTARAKHAND,2008,House Wife,0,0,0,0,0,0,0,32,8,4,0,44,44
391,UTTARAKHAND,2008,Service (Government),0,4,2,1,0,7,0,0,0,0,0,0,7
392,UTTARAKHAND,2008,Service (Private),1,7,7,2,0,17,0,3,2,1,0,6,23
393,UTTARAKHAND,2008,Public Sector Undertaking,0,2,2,1,0,5,0,0,0,1,0,1,6
394,UTTARAKHAND,2008,Student,0,4,2,0,0,6,2,5,0,0,0,7,13
395,UTTARAKHAND,2008,Unemployed,0,5,0,0,0,5,0,1,1,0,0,2,7
396,UTTARAKHAND,2008,Self-employed (Business activity),0,3,2,1,0,6,0,0,0,0,0,0,6
397,UTTARAKHAND,2008,Professional Activity,0,0,0,0,0,0,0,0,0,0,0,0,0
398,UTTARAKHAND,2008,Farming/Agriculture Activity,0,6,10,5,0,21,0,4,2,1,0,7,28
399,UTTARAKHAND,2008,Others (Please Specify),2,2,5,2,2,13,1,12,2,0,0,15,28
400,UTTARAKHAND,2008,Retired Person,0,0,0,3,0,3,0,0,0,0,0,0,3
401,UTTARAKHAND,2008,Others (Please Specify),5,4,5,5,2,21,0,4,0,1,0,5,26
402,UTTARAKHAND,2008,Total,8,37,35,20,4,104,3,61,15,8,0,87,191
403,UTTARAKHAND,2008,Total Salaried,1,13,11,4,0,29,0,3,2,2,0,7,36
404,UTTARAKHAND,2008,Total Self-employed,2,11,17,8,2,40,1,16,4,1,0,22,62
405,WEST BENGAL,2008,House Wife,0,0,0,0,0,0,0,1607,1172,406,59,3244,3244
406,WEST BENGAL,2008,Service (Government),0,17,62,41,0,120,0,4,7,14,0,25,145
407,WEST BENGAL,2008,Service (Private),2,122,214,190,7,535,0,29,38,16,0,83,618
408,WEST BENGAL,2008,Public Sector Undertaking,0,58,275,201,3,537,1,19,43,22,0,85,622
409,WEST BENGAL,2008,Student,112,430,13,0,0,555,118,262,5,0,0,385,940
410,WEST BENGAL,2008,Unemployed,9,460,471,166,5,1111,15,152,212,66,1,446,1557
411,WEST BENGAL,2008,Self-employed (Business activity),0,242,403,210,27,882,0,16,30,6,0,52,934
412,WEST BENGAL,2008,Professional Activity,0,34,124,74,2,234,0,9,4,0,0,13,247
413,WEST BENGAL,2008,Farming/Agriculture Activity,0,161,311,159,29,660,0,33,50,12,4,99,759
414,WEST BENGAL,2008,Others (Please Specify),63,665,525,188,98,1539,25,324,167,106,30,652,2191
415,WEST BENGAL,2008,Retired Person,0,0,0,0,63,63,0,0,0,0,10,10,73
416,WEST BENGAL,2008,Others (Please Specify),89,617,929,364,134,2133,82,549,432,254,72,1389,3522
417,WEST BENGAL,2008,Total,275,2806,3327,1593,368,8369,241,3004,2160,902,176,6483,14852
418,WEST BENGAL,2008,Total Salaried,2,197,551,432,10,1192,1,52,88,52,0,193,1385
419,WEST BENGAL,2008,Total Self-employed,63,1102,1363,631,156,3315,25,382,251,124,34,816,4131
420,TOTAL (STATES),2008,House Wife,0,0,0,0,0,0,51,10560,8434,3514,1363,23922,23922
421,TOTAL (STATES),2008,Service (Government),0,318,765,598,14,1695,0,129,132,60,12,333,2028
422,TOTAL (STATES),2008,Service (Private),7,2452,3568,2081,300,8408,8,974,534,217,49,1782,10190
423,TOTAL (STATES),2008,Public Sector Undertaking,4,620,1024,774,134,2556,3,213,137,122,35,510,3066
424,TOTAL (STATES),2008,Student,499,2544,184,35,4,3266,560,1952,56,4,0,2572,5838
425,TOTAL (STATES),2008,Unemployed,42,2822,2411,1286,307,6868,27,852,597,244,27,1747,8615
426,TOTAL (STATES),2008,Self-employed (Business activity),2,1479,3192,1533,350,6556,4,151,197,56,13,421,6977
427,TOTAL (STATES),2008,Professional Activity,5,743,1295,782,197,3022,5,174,127,49,20,375,3397
428,TOTAL (STATES),2008,Farming/Agriculture Activity,32,3451,5388,3713,1497,14081,38,750,755,368,136,2047,16128
429,TOTAL (STATES),2008,Others (Please Specify),214,5463,6163,4375,1869,18084,157,2044,1241,766,386,4594,22678
430,TOTAL (STATES),2008,Retired Person,0,12,35,145,553,745,0,3,6,20,103,132,877
431,TOTAL (STATES),2008,Others (Please Specify),341,3963,5020,3255,1353,13932,345,1947,1640,905,417,5254,19186
432,TOTAL (STATES),2008,Total,1146,23867,29045,18577,6578,79213,1198,19749,13856,6325,2561,43689,122902
433,TOTAL (STATES),2008,Total Salaried,11,3390,5357,3453,448,12659,11,1316,803,399,96,2625,15284
434,TOTAL (STATES),2008,Total Self-employed,253,11136,16038,10403,3913,41743,204,3119,2320,1239,555,7437,49180
435,A & N ISLANDS,2008,House Wife,0,0,0,0,0,0,0,10,13,5,4,32,32
436,A & N ISLANDS,2008,Service (Government),0,2,2,3,0,7,0,0,0,0,0,0,7
437,A & N ISLANDS,2008,Service (Private),0,17,15,8,3,43,0,1,0,0,0,1,44
438,A & N ISLANDS,2008,Public Sector Undertaking,0,0,0,0,0,0,0,0,0,0,0,0,0
439,A & N ISLANDS,2008,Student,0,4,0,0,0,4,0,7,0,0,0,7,11
440,A & N ISLANDS,2008,Unemployed,0,2,1,0,2,5,0,0,0,0,0,0,5
441,A & N ISLANDS,2008,Self-employed (Business activity),0,0,1,0,0,1,0,0,0,0,0,0,1
442,A & N ISLANDS,2008,Professional Activity,0,0,0,0,0,0,0,0,0,0,0,0,0
443,A & N ISLANDS,2008,Farming/Agriculture Activity,0,5,8,6,4,23,0,0,0,0,0,0,23
444,A & N ISLANDS,2008,Others (Please Specify),0,0,2,1,1,4,0,0,0,0,0,0,4
445,A & N ISLANDS,2008,Retired Person,0,0,0,1,3,4,0,0,0,0,0,0,4
446,A & N ISLANDS,2008,Others (Please Specify),0,1,3,2,1,7,0,5,0,0,0,5,12
447,A & N ISLANDS,2008,Total,0,31,32,21,14,98,0,23,13,5,4,45,143
448,A & N ISLANDS,2008,Total Salaried,0,19,17,11,3,50,0,1,0,0,0,1,51
449,A & N ISLANDS,2008,Total Self-employed,0,5,11,7,5,28,0,0,0,0,0,0,28
450,CHANDIGARH,2008,House Wife,0,0,0,0,0,0,0,8,7,2,0,17,17
451,CHANDIGARH,2008,Service (Government),0,0,2,1,0,3,0,0,0,0,0,0,3
452,CHANDIGARH,2008,Service (Private),0,4,7,4,0,15,0,3,0,0,0,3,18
453,CHANDIGARH,2008,Public Sector Undertaking,0,0,0,0,0,0,0,0,0,0,0,0,0
454,CHANDIGARH,2008,Student,0,6,0,0,0,6,0,5,0,0,0,5,11
455,CHANDIGARH,2008,Unemployed,0,10,7,6,0,23,0,0,0,0,0,0,23
456,CHANDIGARH,2008,Self-employed (Business activity),0,2,3,3,0,8,0,0,0,0,0,0,8
457,CHANDIGARH,2008,Professional Activity,0,0,0,1,0,1,0,0,0,0,0,0,1
458,CHANDIGARH,2008,Farming/Agriculture Activity,0,0,0,0,0,0,0,0,0,0,0,0,0
459,CHANDIGARH,2008,Others (Please Specify),0,0,0,0,0,0,0,0,0,0,0,0,0
460,CHANDIGARH,2008,Retired Person,0,0,0,1,1,2,0,0,0,0,0,0,2
461,CHANDIGARH,2008,Others (Please Specify),0,0,0,0,0,0,0,0,0,0,0,0,0
462,CHANDIGARH,2008,Total,0,22,19,16,1,58,0,16,7,2,0,25,83
463,CHANDIGARH,2008,Total Salaried,0,4,9,5,0,18,0,3,0,0,0,3,21
464,CHANDIGARH,2008,Total Self-employed,0,2,3,4,0,9,0,0,0,0,0,0,9
465,D & N HAVELI,2008,House Wife,0,0,0,0,0,0,0,10,6,6,1,23,23
466,D & N HAVELI,2008,Service (Government),0,0,0,1,0,1,0,0,0,0,0,0,1
467,D & N HAVELI,2008,Service (Private),0,8,4,1,0,13,0,4,0,0,0,4,17
468,D & N HAVELI,2008,Public Sector Undertaking,0,0,0,0,0,0,0,0,0,0,0,0,0
469,D & N HAVELI,2008,Student,0,0,0,0,0,0,0,1,0,0,0,1,1
470,D & N HAVELI,2008,Unemployed,0,0,0,0,0,0,0,0,0,0,0,0,0
471,D & N HAVELI,2008,Self-employed (Business activity),0,0,1,0,0,1,0,0,0,0,0,0,1
472,D & N HAVELI,2008,Professional Activity,0,0,0,0,0,0,0,0,0,0,0,0,0
473,D & N HAVELI,2008,Farming/Agriculture Activity,0,1,6,4,1,12,0,0,0,0,0,0,12
474,D & N HAVELI,2008,Others (Please Specify),0,0,0,0,0,0,0,0,0,0,0,0,0
475,D & N HAVELI,2008,Retired Person,0,0,0,0,0,0,0,0,0,0,0,0,0
476,D & N HAVELI,2008,Others (Please Specify),1,2,0,2,0,5,0,0,0,0,0,0,5
477,D & N HAVELI,2008,Total,1,11,11,8,1,32,0,15,6,6,1,28,60
478,D & N HAVELI,2008,Total Salaried,0,8,4,2,0,14,0,4,0,0,0,4,18
479,D & N HAVELI,2008,Total Self-employed,0,1,7,4,1,13,0,0,0,0,0,0,13
480,DAMAN & DIU,2008,House Wife,0,0,0,0,0,0,0,0,0,0,0,0,0
481,DAMAN & DIU,2008,Service (Government),0,0,0,1,0,1,0,0,0,0,0,0,1
482,DAMAN & DIU,2008,Service (Private),0,3,3,2,0,8,0,0,0,0,0,0,8
483,DAMAN & DIU,2008,Public Sector Undertaking,0,0,0,0,0,0,0,0,0,0,0,0,0
484,DAMAN & DIU,2008,Student,0,0,0,0,0,0,0,0,0,0,0,0,0
485,DAMAN & DIU,2008,Unemployed,0,0,0,2,0,2,0,1,0,0,0,1,3
486,DAMAN & DIU,2008,Self-employed (Business activity),0,0,0,1,0,1,0,0,0,0,0,0,1
487,DAMAN & DIU,2008,Professional Activity,0,0,0,0,0,0,0,0,0,0,0,0,0
488,DAMAN & DIU,2008,Farming/Agriculture Activity,0,0,0,0,0,0,0,0,0,0,0,0,0
489,DAMAN & DIU,2008,Others (Please Specify),0,0,1,0,0,1,0,0,0,0,0,0,1
490,DAMAN & DIU,2008,Retired Person,0,0,0,0,0,0,0,0,0,0,0,0,0
491,DAMAN & DIU,2008,Others (Please Specify),0,1,0,0,0,1,0,0,0,1,3,4,5
492,DAMAN & DIU,2008,Total,0,4,4,6,0,14,0,1,0,1,3,5,19
493,DAMAN & DIU,2008,Total Salaried,0,3,3,3,0,9,0,0,0,0,0,0,9
494,DAMAN & DIU,2008,Total Self-employed,0,0,1,1,0,2,0,0,0,0,0,0,2
495,DELHI (UT),2008,House Wife,0,0,0,0,0,0,0,166,89,19,2,276,276
496,DELHI (UT),2008,Service (Government),0,2,7,4,0,13,0,0,1,1,0,2,15
497,DELHI (UT),2008,Service (Private),0,78,82,24,2,186,0,18,7,2,0,27,213
498,DELHI (UT),2008,Public Sector Undertaking,0,16,12,3,4,35,0,3,0,0,0,3,38
499,DELHI (UT),2008,Student,13,63,1,0,0,77,13,79,6,0,0,98,175
500,DELHI (UT),2008,Unemployed,1,99,84,22,5,211,1,36,4,0,0,41,252
501,DELHI (UT),2008,Self-employed (Business activity),0,7,10,4,0,21,0,0,0,0,0,0,21
502,DELHI (UT),2008,Professional Activity,0,0,3,3,1,7,0,0,0,0,0,0,7
503,DELHI (UT),2008,Farming/Agriculture Activity,0,5,5,2,3,15,1,0,0,0,0,1,16
504,DELHI (UT),2008,Others (Please Specify),2,58,51,27,8,146,1,18,4,2,0,25,171
505,DELHI (UT),2008,Retired Person,0,0,0,1,1,2,0,0,0,0,0,0,2
506,DELHI (UT),2008,Others (Please Specify),0,43,31,7,1,82,2,27,4,1,1,35,117
507,DELHI (UT),2008,Total,16,371,286,97,25,795,18,347,115,25,3,508,1303
508,DELHI (UT),2008,Total Salaried,0,96,101,31,6,234,0,21,8,3,0,32,266
509,DELHI (UT),2008,Total Self-employed,2,70,69,36,12,189,2,18,4,2,0,26,215
510,LAKSHADWEEP,2008,House Wife,0,0,0,0,0,0,0,0,0,0,0,0,0
511,LAKSHADWEEP,2008,Service (Government),0,0,0,0,0,0,0,0,0,0,0,0,0
512,LAKSHADWEEP,2008,Service (Private),0,0,0,0,0,0,0,0,0,0,0,0,0
513,LAKSHADWEEP,2008,Public Sector Undertaking,0,0,0,0,0,0,0,0,0,0,0,0,0
514,LAKSHADWEEP,2008,Student,0,0,0,0,0,0,0,0,0,0,0,0,0
515,LAKSHADWEEP,2008,Unemployed,0,0,0,0,0,0,0,0,0,0,0,0,0
516,LAKSHADWEEP,2008,Self-employed (Business activity),0,0,0,0,0,0,0,0,0,0,0,0,0
517,LAKSHADWEEP,2008,Professional Activity,0,0,0,0,0,0,0,0,0,0,0,0,0
518,LAKSHADWEEP,2008,Farming/Agriculture Activity,0,0,0,0,0,0,0,0,0,0,0,0,0
519,LAKSHADWEEP,2008,Others (Please Specify),0,0,0,0,0,0,0,0,0,0,0,0,0
520,LAKSHADWEEP,2008,Retired Person,0,0,0,0,0,0,0,0,0,0,0,0,0
521,LAKSHADWEEP,2008,Others (Please Specify),0,0,0,0,0,0,0,0,0,0,0,0,0
522,LAKSHADWEEP,2008,Total,0,0,0,0,0,0,0,0,0,0,0,0,0
523,LAKSHADWEEP,2008,Total Salaried,0,0,0,0,0,0,0,0,0,0,0,0,0
524,LAKSHADWEEP,2008,Total Self-employed,0,0,0,0,0,0,0,0,0,0,0,0,0
525,PUDUCHERRY,2008,House Wife,0,0,0,0,0,0,0,45,32,8,12,97,97
526,PUDUCHERRY,2008,Service (Government),0,3,2,4,0,9,0,2,3,0,1,6,15
527,PUDUCHERRY,2008,Service (Private),0,2,3,3,1,9,0,2,0,0,0,2,11
528,PUDUCHERRY,2008,Public Sector Undertaking,0,0,0,0,0,0,0,3,0,0,0,3,3
529,PUDUCHERRY,2008,Student,2,10,3,0,0,15,0,9,0,0,0,9,24
530,PUDUCHERRY,2008,Unemployed,0,22,18,9,13,62,0,33,8,0,0,41,103
531,PUDUCHERRY,2008,Self-employed (Business activity),0,1,3,3,0,7,0,0,0,0,0,0,7
532,PUDUCHERRY,2008,Professional Activity,0,0,0,0,0,0,0,0,0,0,0,0,0
533,PUDUCHERRY,2008,Farming/Agriculture Activity,0,2,9,3,0,14,0,2,1,0,0,3,17
534,PUDUCHERRY,2008,Others (Please Specify),0,47,84,72,12,215,0,9,2,1,0,12,227
535,PUDUCHERRY,2008,Retired Person,0,1,0,0,0,1,0,0,0,0,0,0,1
536,PUDUCHERRY,2008,Others (Please Specify),0,2,0,0,0,2,0,0,0,0,0,0,2
537,PUDUCHERRY,2008,Total,2,90,122,94,26,334,0,105,46,9,13,173,507
538,PUDUCHERRY,2008,Total Salaried,0,5,5,7,1,18,0,7,3,0,1,11,29
539,PUDUCHERRY,2008,Total Self-employed,0,50,96,78,12,236,0,11,3,1,0,15,251
540,TOTAL (UTs),2008,House Wife,0,0,0,0,0,0,0,239,147,40,19,445,445
541,TOTAL (UTs),2008,Service (Government),0,7,13,14,0,34,0,2,4,1,1,8,42
542,TOTAL (UTs),2008,Service (Private),0,112,114,42,6,274,0,28,7,2,0,37,311
543,TOTAL (UTs),2008,Public Sector Undertaking,0,16,12,3,4,35,0,6,0,0,0,6,41
544,TOTAL (UTs),2008,Student,15,83,4,0,0,102,13,101,6,0,0,120,222
545,TOTAL (UTs),2008,Unemployed,1,133,110,39,20,303,1,70,12,0,0,83,386
546,TOTAL (UTs),2008,Self-employed (Business activity),0,10,18,11,0,39,0,0,0,0,0,0,39
547,TOTAL (UTs),2008,Professional Activity,0,0,3,4,1,8,0,0,0,0,0,0,8
548,TOTAL (UTs),2008,Farming/Agriculture Activity,0,13,28,15,8,64,1,2,1,0,0,4,68
549,TOTAL (UTs),2008,Others (Please Specify),2,105,138,100,21,366,1,27,6,3,0,37,403
550,TOTAL (UTs),2008,Retired Person,0,1,0,3,5,9,0,0,0,0,0,0,9
551,TOTAL (UTs),2008,Others (Please Specify),1,49,34,11,2,97,2,32,4,2,4,44,141
552,TOTAL (UTs),2008,Total,19,529,474,242,67,1331,18,507,187,48,24,784,2115
553,TOTAL (UTs),2008,Total Salaried,0,135,139,59,10,343,0,36,11,3,1,51,394
554,TOTAL (UTs),2008,Total Self-employed,2,128,187,130,30,477,2,29,7,3,0,41,518
555,TOTAL (ALL INDIA),2008,House Wife,0,0,0,0,0,0,51,10799,8581,3554,1382,24367,24367
556,TOTAL (ALL INDIA),2008,Service (Government),0,325,778,612,14,1729,0,131,136,61,13,341,2070
557,TOTAL (ALL INDIA),2008,Service (Private),7,2564,3682,2123,306,8682,8,1002,541,219,49,1819,10501
558,TOTAL (ALL INDIA),2008,Public Sector Undertaking,4,636,1036,777,138,2591,3,219,137,122,35,516,3107
559,TOTAL (ALL INDIA),2008,Student,514,2627,188,35,4,3368,573,2053,62,4,0,2692,6060
560,TOTAL (ALL INDIA),2008,Unemployed,43,2955,2521,1325,327,7171,28,922,609,244,27,1830,9001
561,TOTAL (ALL INDIA),2008,Self-employed (Business activity),2,1489,3210,1544,350,6595,4,151,197,56,13,421,7016
562,TOTAL (ALL INDIA),2008,Professional Activity,5,743,1298,786,198,3030,5,174,127,49,20,375,3405
563,TOTAL (ALL INDIA),2008,Farming/Agriculture Activity,32,3464,5416,3728,1505,14145,39,752,756,368,136,2051,16196
564,TOTAL (ALL INDIA),2008,Others (Please Specify),216,5568,6301,4475,1890,18450,158,2071,1247,769,386,4631,23081
565,TOTAL (ALL INDIA),2008,Retired Person,0,13,35,148,558,754,0,3,6,20,103,132,886
566,TOTAL (ALL INDIA),2008,Others (Please Specify),342,4012,5054,3266,1355,14029,347,1979,1644,907,421,5298,19327
567,TOTAL (ALL INDIA),2008,Total,1165,24396,29519,18819,6645,80544,1216,20256,14043,6373,2585,44473,125017
568,TOTAL (ALL INDIA),2008,Total Salaried,11,3525,5496,3512,458,13002,11,1352,814,402,97,2676,15678
569,TOTAL (ALL INDIA),2008,Total Self-employed,255,11264,16225,10533,3943,42220,206,3148,2327,1242,555,7478,49698
0,ANDHRA PRADESH,2009,House Wife,0,0,0,0,0,0,0,1033,779,428,151,2391,2391
1,ANDHRA PRADESH,2009,Service (Government),0,54,100,57,2,213,0,13,6,2,0,21,234
2,ANDHRA PRADESH,2009,Service (Private),0,277,468,222,79,1046,0,65,44,33,19,161,1207
3,ANDHRA PRADESH,2009,Public Sector Undertaking,0,154,203,152,78,587,0,36,20,8,14,78,665
4,ANDHRA PRADESH,2009,Student,38,293,33,0,0,364,65,164,4,0,0,233,597
5,ANDHRA PRADESH,2009,Unemployed,0,263,252,129,0,644,0,41,15,14,0,70,714
6,ANDHRA PRADESH,2009,Self-employed (Business activity),0,341,460,387,138,1326,0,14,9,1,1,25,1351
7,ANDHRA PRADESH,2009,Professional Activity,0,74,132,249,11,466,0,18,1,3,1,23,489
8,ANDHRA PRADESH,2009,Farming/Agriculture Activity,5,392,885,562,172,2016,5,132,141,100,20,398,2414
9,ANDHRA PRADESH,2009,Others (Please Specify),8,541,728,532,137,1946,25,229,240,125,51,670,2616
10,ANDHRA PRADESH,2009,Retired Person,0,0,0,8,61,69,0,0,25,1,3,29,98
11,ANDHRA PRADESH,2009,Others (Please Specify),16,338,461,288,107,1210,32,189,136,114,43,514,1724
12,ANDHRA PRADESH,2009,Total,67,2727,3722,2586,785,9887,127,1934,1420,829,303,4613,14500
13,ANDHRA PRADESH,2009,Total Salaried,0,485,771,431,159,1846,0,114,70,43,33,260,2106
14,ANDHRA PRADESH,2009,Total Self-employed,13,1348,2205,1730,458,5754,30,393,391,229,73,1116,6870
15,ARUNACHAL PRADESH,2009,House Wife,0,0,0,0,0,0,0,6,7,1,0,14,14
16,ARUNACHAL PRADESH,2009,Service (Government),0,10,14,1,0,25,0,0,1,0,0,1,26
17,ARUNACHAL PRADESH,2009,Service (Private),0,3,2,0,0,5,0,0,3,0,0,3,8
18,ARUNACHAL PRADESH,2009,Public Sector Undertaking,0,0,0,0,0,0,0,0,0,0,0,0,0
19,ARUNACHAL PRADESH,2009,Student,1,1,0,0,0,2,0,3,0,0,0,3,5
20,ARUNACHAL PRADESH,2009,Unemployed,0,4,6,1,0,11,0,0,1,0,0,1,12
21,ARUNACHAL PRADESH,2009,Self-employed (Business activity),0,0,0,0,0,0,0,0,0,0,0,0,0
22,ARUNACHAL PRADESH,2009,Professional Activity,0,0,0,0,0,0,0,0,0,0,0,0,0
23,ARUNACHAL PRADESH,2009,Farming/Agriculture Activity,0,6,1,5,0,12,0,0,0,0,0,0,12
24,ARUNACHAL PRADESH,2009,Others (Please Specify),0,19,1,0,0,20,0,10,1,0,0,11,31
25,ARUNACHAL PRADESH,2009,Retired Person,0,0,0,0,0,0,0,0,0,0,0,0,0
26,ARUNACHAL PRADESH,2009,Others (Please Specify),1,0,1,0,0,2,0,0,0,0,0,0,2
27,ARUNACHAL PRADESH,2009,Total,2,43,25,7,0,77,0,19,13,1,0,33,110
28,ARUNACHAL PRADESH,2009,Total Salaried,0,13,16,1,0,30,0,0,4,0,0,4,34
29,ARUNACHAL PRADESH,2009,Total Self-employed,0,25,2,5,0,32,0,10,1,0,0,11,43
30,ASSAM,2009,House Wife,0,0,0,0,0,0,0,222,213,94,12,541,541
31,ASSAM,2009,Service (Government),0,1,1,3,0,5,0,0,0,0,0,0,5
32,ASSAM,2009,Service (Private),0,27,13,15,1,56,0,4,2,1,0,7,63
33,ASSAM,2009,Public Sector Undertaking,0,13,23,14,0,50,0,3,3,8,0,14,64
34,ASSAM,2009,Student,11,118,0,0,0,129,8,83,0,0,0,91,220
35,ASSAM,2009,Unemployed,0,3,24,31,0,58,0,3,6,6,0,15,73
36,ASSAM,2009,Self-employed (Business activity),0,101,164,94,2,361,0,36,16,7,0,59,420
37,ASSAM,2009,Professional Activity,0,37,69,23,2,131,0,4,5,3,0,12,143
38,ASSAM,2009,Farming/Agriculture Activity,0,95,137,80,5,317,0,8,7,9,0,24,341
39,ASSAM,2009,Others (Please Specify),9,210,220,114,31,584,7,107,67,46,11,238,822
40,ASSAM,2009,Retired Person,0,0,0,3,10,13,0,0,0,0,0,0,13
41,ASSAM,2009,Others (Please Specify),7,50,61,48,12,178,9,44,21,6,3,83,261
42,ASSAM,2009,Total,27,655,712,425,63,1882,24,514,340,180,26,1084,2966
43,ASSAM,2009,Total Salaried,0,41,37,32,1,111,0,7,5,9,0,21,132
44,ASSAM,2009,Total Self-employed,9,443,590,311,40,1393,7,155,95,65,11,333,1726
45,BIHAR,2009,House Wife,0,0,0,0,0,0,0,124,154,29,7,314,314
46,BIHAR,2009,Service (Government),0,2,1,0,0,3,0,0,0,0,0,0,3
47,BIHAR,2009,Service (Private),0,17,35,3,0,55,0,2,0,0,0,2,57
48,BIHAR,2009,Public Sector Undertaking,0,1,7,0,0,8,0,0,0,0,0,0,8
49,BIHAR,2009,Student,7,31,4,0,0,42,5,19,2,0,0,26,68
50,BIHAR,2009,Unemployed,0,24,19,0,0,43,1,1,6,0,0,8,51
51,BIHAR,2009,Self-employed (Business activity),0,9,9,6,0,24,0,0,0,0,0,0,24
52,BIHAR,2009,Professional Activity,0,2,0,1,0,3,0,0,22,0,0,22,25
53,BIHAR,2009,Farming/Agriculture Activity,0,20,40,23,2,85,0,10,17,0,0,27,112
54,BIHAR,2009,Others (Please Specify),3,34,33,11,1,82,0,0,4,2,0,6,88
55,BIHAR,2009,Retired Person,0,0,0,0,0,0,0,0,0,0,0,0,0
56,BIHAR,2009,Others (Please Specify),12,62,45,31,19,169,19,72,27,10,4,132,301
57,BIHAR,2009,Total,22,202,193,75,22,514,25,228,232,41,11,537,1051
58,BIHAR,2009,Total Salaried,0,20,43,3,0,66,0,2,0,0,0,2,68
59,BIHAR,2009,Total Self-employed,3,65,82,41,3,194,0,10,43,2,0,55,249
60,CHHATTISGARH,2009,House Wife,0,0,0,0,0,0,4,466,299,99,34,902,902
61,CHHATTISGARH,2009,Service (Government),0,19,14,9,0,42,0,5,1,0,0,6,48
62,CHHATTISGARH,2009,Service (Private),0,89,101,54,5,249,0,31,11,3,0,45,294
63,CHHATTISGARH,2009,Public Sector Undertaking,0,5,7,5,0,17,0,0,0,0,0,0,17
64,CHHATTISGARH,2009,Student,59,228,11,0,0,298,33,99,5,0,0,137,435
65,CHHATTISGARH,2009,Unemployed,4,159,204,87,7,461,4,5,18,1,0,28,489
66,CHHATTISGARH,2009,Self-employed (Business activity),0,34,31,33,6,104,0,1,2,1,0,4,108
67,CHHATTISGARH,2009,Professional Activity,0,33,56,39,3,131,0,3,2,1,0,6,137
68,CHHATTISGARH,2009,Farming/Agriculture Activity,9,364,496,412,136,1417,3,144,115,97,26,385,1802
69,CHHATTISGARH,2009,Others (Please Specify),4,153,218,209,99,683,3,59,76,32,8,178,861
70,CHHATTISGARH,2009,Retired Person,0,0,0,0,6,6,0,0,0,0,3,3,9
71,CHHATTISGARH,2009,Others (Please Specify),28,141,204,89,84,546,29,60,58,57,31,235,781
72,CHHATTISGARH,2009,Total,104,1225,1342,937,346,3954,76,873,587,291,102,1929,5883
73,CHHATTISGARH,2009,Total Salaried,0,113,122,68,5,308,0,36,12,3,0,51,359
74,CHHATTISGARH,2009,Total Self-employed,13,584,801,693,244,2335,6,207,195,131,34,573,2908
75,GOA,2009,House Wife,0,0,0,0,0,0,0,24,19,10,7,60,60
76,GOA,2009,Service (Government),0,2,2,1,0,5,0,2,2,1,0,5,10
77,GOA,2009,Service (Private),0,14,19,10,1,44,0,6,0,0,0,6,50
78,GOA,2009,Public Sector Undertaking,0,1,0,2,0,3,0,0,0,0,0,0,3
79,GOA,2009,Student,1,7,0,0,0,8,2,4,0,1,0,7,15
80,GOA,2009,Unemployed,0,15,22,16,0,53,0,4,0,1,1,6,59
81,GOA,2009,Self-employed (Business activity),0,2,1,0,1,4,0,2,0,0,0,2,6
82,GOA,2009,Professional Activity,0,1,2,1,0,4,0,0,1,0,0,1,5
83,GOA,2009,Farming/Agriculture Activity,0,0,2,1,1,4,0,0,0,0,0,0,4
84,GOA,2009,Others (Please Specify),0,5,3,6,5,19,0,3,0,1,0,4,23
85,GOA,2009,Retired Person,0,0,0,0,4,4,0,0,0,0,0,0,4
86,GOA,2009,Others (Please Specify),0,3,21,7,5,36,0,3,0,0,0,3,39
87,GOA,2009,Total,1,50,72,44,17,184,2,48,22,14,8,94,278
88,GOA,2009,Total Salaried,0,17,21,13,1,52,0,8,2,1,0,11,63
89,GOA,2009,Total Self-employed,0,8,8,8,7,31,0,5,1,1,0,7,38
90,GUJARAT,2009,House Wife,0,0,0,0,0,0,3,781,580,262,110,1736,1736
91,GUJARAT,2009,Service (Government),0,10,19,13,1,43,0,17,4,4,1,26,69
92,GUJARAT,2009,Service (Private),0,192,247,133,9,581,0,16,24,8,0,48,629
93,GUJARAT,2009,Public Sector Undertaking,0,24,48,17,2,91,0,13,6,5,0,24,115
94,GUJARAT,2009,Student,17,154,2,1,0,174,25,118,10,1,0,154,328
95,GUJARAT,2009,Unemployed,1,184,226,69,19,499,0,43,28,7,2,80,579
96,GUJARAT,2009,Self-employed (Business activity),0,108,148,65,15,336,0,0,0,2,0,2,338
97,GUJARAT,2009,Professional Activity,0,180,198,109,22,509,0,21,16,6,0,43,552
98,GUJARAT,2009,Farming/Agriculture Activity,0,153,198,107,40,498,0,36,30,14,10,90,588
99,GUJARAT,2009,Others (Please Specify),4,168,216,119,40,547,1,64,49,25,25,164,711
100,GUJARAT,2009,Retired Person,0,1,1,16,76,94,0,0,1,2,21,24,118
101,GUJARAT,2009,Others (Please Specify),5,81,101,88,24,299,1,50,23,12,8,94,393
102,GUJARAT,2009,Total,27,1255,1404,737,248,3671,30,1159,771,348,177,2485,6156
103,GUJARAT,2009,Total Salaried,0,226,314,163,12,715,0,46,34,17,1,98,813
104,GUJARAT,2009,Total Self-employed,4,609,760,400,117,1890,1,121,95,47,35,299,2189
105,HARYANA,2009,House Wife,0,0,0,0,0,0,2,176,196,57,10,441,441
106,HARYANA,2009,Service (Government),0,26,34,15,5,80,0,3,3,0,0,6,86
107,HARYANA,2009,Service (Private),0,100,98,47,8,253,0,16,13,3,0,32,285
108,HARYANA,2009,Public Sector Undertaking,0,35,19,8,2,64,0,7,0,0,0,7,71
109,HARYANA,2009,Student,10,70,3,0,0,83,16,16,0,0,0,32,115
110,HARYANA,2009,Unemployed,0,86,90,37,7,220,0,17,15,0,1,33,253
111,HARYANA,2009,Self-employed (Business activity),0,16,18,13,2,49,0,0,0,0,0,0,49
112,HARYANA,2009,Professional Activity,0,7,13,8,0,28,0,0,0,0,0,0,28
113,HARYANA,2009,Farming/Agriculture Activity,0,44,107,62,12,225,0,1,2,2,0,5,230
114,HARYANA,2009,Others (Please Specify),0,76,57,21,10,164,3,1,0,0,0,4,168
115,HARYANA,2009,Retired Person,0,0,0,0,0,0,0,0,0,0,0,0,0
116,HARYANA,2009,Others (Please Specify),28,232,220,127,42,649,13,57,16,33,9,128,777
117,HARYANA,2009,Total,38,692,659,338,88,1815,34,294,245,95,20,688,2503
118,HARYANA,2009,Total Salaried,0,161,151,70,15,397,0,26,16,3,0,45,442
119,HARYANA,2009,Total Self-employed,0,143,195,104,24,466,3,2,2,2,0,9,475
120,HIMACHAL PRADESH,2009,House Wife,0,0,0,0,0,0,0,38,32,14,10,94,94
121,HIMACHAL PRADESH,2009,Service (Government),0,5,13,8,0,26,0,0,5,1,0,6,32
122,HIMACHAL PRADESH,2009,Service (Private),0,11,19,5,0,35,0,2,2,3,0,7,42
123,HIMACHAL PRADESH,2009,Public Sector Undertaking,0,7,3,5,3,18,0,2,0,3,1,6,24
124,HIMACHAL PRADESH,2009,Student,2,21,2,0,0,25,4,21,0,0,0,25,50
125,HIMACHAL PRADESH,2009,Unemployed,0,22,15,11,4,52,0,3,6,1,2,12,64
126,HIMACHAL PRADESH,2009,Self-employed (Business activity),0,1,9,3,3,16,0,0,1,0,0,1,17
127,HIMACHAL PRADESH,2009,Professional Activity,0,0,3,0,0,3,0,0,0,0,0,0,3
128,HIMACHAL PRADESH,2009,Farming/Agriculture Activity,0,1,8,10,5,24,0,0,0,0,0,0,24
129,HIMACHAL PRADESH,2009,Others (Please Specify),1,7,12,11,5,36,0,3,2,1,1,7,43
130,HIMACHAL PRADESH,2009,Retired Person,0,0,0,0,4,4,0,0,0,0,1,1,5
131,HIMACHAL PRADESH,2009,Others (Please Specify),2,51,44,19,11,127,7,15,7,3,3,35,162
132,HIMACHAL PRADESH,2009,Total,5,126,128,72,35,366,11,84,55,26,18,194,560
133,HIMACHAL PRADESH,2009,Total Salaried,0,23,35,18,3,79,0,4,7,7,1,19,98
134,HIMACHAL PRADESH,2009,Total Self-employed,1,9,32,24,13,79,0,3,3,1,1,8,87
135,JAMMU & KASHMIR,2009,House Wife,0,0,0,0,0,0,0,34,14,1,1,50,50
136,JAMMU & KASHMIR,2009,Service (Government),0,8,14,4,0,26,0,3,4,2,0,9,35
137,JAMMU & KASHMIR,2009,Service (Private),0,4,11,6,3,24,0,2,3,1,0,6,30
138,JAMMU & KASHMIR,2009,Public Sector Undertaking,0,1,2,1,2,6,0,0,1,0,0,1,7
139,JAMMU & KASHMIR,2009,Student,0,3,1,0,0,4,0,12,4,0,0,16,20
140,JAMMU & KASHMIR,2009,Unemployed,0,12,20,9,0,41,0,9,10,2,0,21,62
141,JAMMU & KASHMIR,2009,Self-employed (Business activity),0,1,5,7,4,17,0,1,0,0,0,1,18
142,JAMMU & KASHMIR,2009,Professional Activity,0,0,2,0,0,2,0,1,0,0,0,1,3
143,JAMMU & KASHMIR,2009,Farming/Agriculture Activity,0,6,1,0,1,8,0,0,0,0,0,0,8
144,JAMMU & KASHMIR,2009,Others (Please Specify),0,3,10,5,3,21,2,5,6,3,3,19,40
145,JAMMU & KASHMIR,2009,Retired Person,0,0,0,0,0,0,0,0,0,0,0,0,0
146,JAMMU & KASHMIR,2009,Others (Please Specify),0,6,8,2,3,19,0,14,12,1,2,29,48
147,JAMMU & KASHMIR,2009,Total,0,44,74,34,16,168,2,81,54,10,6,153,321
148,JAMMU & KASHMIR,2009,Total Salaried,0,13,27,11,5,56,0,5,8,3,0,16,72
149,JAMMU & KASHMIR,2009,Total Self-employed,0,10,18,12,8,48,2,7,6,3,3,21,69
150,JHARKHAND,2009,House Wife,0,0,0,0,0,0,0,54,87,40,4,185,185
151,JHARKHAND,2009,Service (Government),0,1,14,2,0,17,0,5,2,0,0,7,24
152,JHARKHAND,2009,Service (Private),0,21,68,30,1,120,1,12,2,1,0,16,136
153,JHARKHAND,2009,Public Sector Undertaking,0,1,1,1,0,3,1,0,0,0,0,1,4
154,JHARKHAND,2009,Student,7,53,3,0,0,63,8,25,0,0,0,33,96
155,JHARKHAND,2009,Unemployed,0,23,39,15,10,87,0,7,6,0,0,13,100
156,JHARKHAND,2009,Self-employed (Business activity),0,7,15,11,0,33,0,2,2,0,0,4,37
157,JHARKHAND,2009,Professional Activity,0,6,9,5,0,20,0,1,1,0,0,2,22
158,JHARKHAND,2009,Farming/Agriculture Activity,0,35,84,34,6,159,0,0,4,1,0,5,164
159,JHARKHAND,2009,Others (Please Specify),1,34,20,16,6,77,1,7,10,5,0,23,100
160,JHARKHAND,2009,Retired Person,0,0,0,0,1,1,0,0,0,0,0,0,1
161,JHARKHAND,2009,Others (Please Specify),8,22,19,88,27,164,11,22,10,17,19,79,243
162,JHARKHAND,2009,Total,16,203,272,202,51,744,22,135,124,64,23,368,1112
163,JHARKHAND,2009,Total Salaried,0,23,83,33,1,140,2,17,4,1,0,24,164
164,JHARKHAND,2009,Total Self-employed,1,82,128,66,12,289,1,10,17,6,0,34,323
165,KARNATAKA,2009,House Wife,0,0,0,0,0,0,12,526,608,378,172,1696,1696
166,KARNATAKA,2009,Service (Government),0,14,32,45,1,92,0,9,4,2,0,15,107
167,KARNATAKA,2009,Service (Private),0,230,296,139,68,733,1,66,31,11,13,122,855
168,KARNATAKA,2009,Public Sector Undertaking,0,115,72,42,15,244,0,18,16,12,2,48,292
169,KARNATAKA,2009,Student,39,206,29,0,0,274,19,207,7,0,0,233,507
170,KARNATAKA,2009,Unemployed,0,130,227,98,25,480,2,33,12,5,3,55,535
171,KARNATAKA,2009,Self-employed (Business activity),0,151,234,224,27,636,0,9,13,7,1,30,666
172,KARNATAKA,2009,Professional Activity,0,39,58,40,7,144,0,8,2,1,0,11,155
173,KARNATAKA,2009,Farming/Agriculture Activity,6,318,705,590,296,1915,0,112,163,70,22,367,2282
174,KARNATAKA,2009,Others (Please Specify),19,349,640,647,303,1958,98,178,207,217,65,765,2723
175,KARNATAKA,2009,Retired Person,0,0,5,3,41,49,0,4,1,0,1,6,55
176,KARNATAKA,2009,Others (Please Specify),139,267,605,503,170,1684,31,136,188,192,91,638,2322
177,KARNATAKA,2009,Total,203,1819,2903,2331,953,8209,163,1306,1252,895,370,3986,12195
178,KARNATAKA,2009,Total Salaried,0,359,400,226,84,1069,1,93,51,25,15,185,1254
179,KARNATAKA,2009,Total Self-employed,25,857,1637,1501,633,4653,98,307,385,295,88,1173,5826
180,KERALA,2009,House Wife,0,0,0,0,0,0,0,258,375,422,261,1316,1316
181,KERALA,2009,Service (Government),0,7,24,25,1,57,0,3,6,6,0,15,72
182,KERALA,2009,Service (Private),1,72,162,103,16,354,0,28,28,18,6,80,434
183,KERALA,2009,Public Sector Undertaking,0,7,37,43,0,87,0,9,5,5,0,19,106
184,KERALA,2009,Student,32,75,0,0,0,107,30,137,0,0,0,167,274
185,KERALA,2009,Unemployed,0,130,220,134,136,620,0,55,57,22,49,183,803
186,KERALA,2009,Self-employed (Business activity),0,80,194,222,90,586,0,1,5,6,0,12,598
187,KERALA,2009,Professional Activity,0,48,73,68,24,213,0,3,5,7,0,15,228
188,KERALA,2009,Farming/Agriculture Activity,0,116,252,294,158,820,0,19,18,23,16,76,896
189,KERALA,2009,Others (Please Specify),4,290,456,479,234,1463,0,95,51,46,25,217,1680
190,KERALA,2009,Retired Person,0,0,5,16,62,83,0,0,0,2,10,12,95
191,KERALA,2009,Others (Please Specify),1,366,556,658,351,1932,0,97,66,76,82,321,2253
192,KERALA,2009,Total,38,1191,1979,2042,1072,6322,30,705,616,633,449,2433,8755
193,KERALA,2009,Total Salaried,1,86,223,171,17,498,0,40,39,29,6,114,612
194,KERALA,2009,Total Self-employed,4,534,975,1063,506,3082,0,118,79,82,41,320,3402
195,MADHYA PRADESH,2009,House Wife,0,0,0,0,0,0,11,1334,652,220,69,2286,2286
196,MADHYA PRADESH,2009,Service (Government),0,13,15,16,0,44,0,1,4,8,0,13,57
197,MADHYA PRADESH,2009,Service (Private),1,136,230,144,27,538,0,73,14,11,2,100,638
198,MADHYA PRADESH,2009,Public Sector Undertaking,0,10,12,8,1,31,0,4,0,0,0,4,35
199,MADHYA PRADESH,2009,Student,75,213,41,10,0,339,68,169,20,1,0,258,597
200,MADHYA PRADESH,2009,Unemployed,6,160,94,34,7,301,0,16,5,1,0,22,323
201,MADHYA PRADESH,2009,Self-employed (Business activity),23,136,185,165,72,581,0,8,13,2,0,23,604
202,MADHYA PRADESH,2009,Professional Activity,20,96,111,97,32,356,0,11,4,3,0,18,374
203,MADHYA PRADESH,2009,Farming/Agriculture Activity,6,418,354,239,103,1120,6,127,102,25,15,275,1395
204,MADHYA PRADESH,2009,Others (Please Specify),15,297,251,143,80,786,63,85,72,18,11,249,1035
205,MADHYA PRADESH,2009,Retired Person,0,0,3,2,10,15,0,0,0,0,0,0,15
206,MADHYA PRADESH,2009,Others (Please Specify),120,279,288,230,72,989,94,268,256,87,60,765,1754
207,MADHYA PRADESH,2009,Total,266,1758,1584,1088,404,5100,242,2096,1142,376,157,4013,9113
208,MADHYA PRADESH,2009,Total Salaried,1,159,257,168,28,613,0,78,18,19,2,117,730
209,MADHYA PRADESH,2009,Total Self-employed,64,947,901,644,287,2843,69,231,191,48,26,565,3408
210,MAHARASHTRA,2009,House Wife,0,0,0,0,0,0,0,1656,1097,399,231,3383,3383
211,MAHARASHTRA,2009,Service (Government),0,20,61,57,1,139,0,8,3,4,0,15,154
212,MAHARASHTRA,2009,Service (Private),0,496,724,345,45,1610,0,78,33,8,1,120,1730
213,MAHARASHTRA,2009,Public Sector Undertaking,0,37,74,38,2,151,0,7,3,2,0,12,163
214,MAHARASHTRA,2009,Student,42,358,3,0,0,403,48,353,8,0,0,409,812
215,MAHARASHTRA,2009,Unemployed,0,356,313,119,33,821,0,33,10,9,0,52,873
216,MAHARASHTRA,2009,Self-employed (Business activity),0,112,165,108,27,412,0,3,4,0,0,7,419
217,MAHARASHTRA,2009,Professional Activity,0,162,219,157,53,591,0,13,14,9,3,39,630
218,MAHARASHTRA,2009,Farming/Agriculture Activity,0,557,1062,728,345,2692,2,89,36,40,13,180,2872
219,MAHARASHTRA,2009,Others (Please Specify),2,723,930,576,280,2511,2,131,76,27,16,252,2763
220,MAHARASHTRA,2009,Retired Person,0,0,2,14,117,133,0,0,0,1,2,3,136
221,MAHARASHTRA,2009,Others (Please Specify),4,80,133,48,57,322,3,16,10,4,10,43,365
222,MAHARASHTRA,2009,Total,48,2901,3686,2190,960,9785,55,2387,1294,503,276,4515,14300
223,MAHARASHTRA,2009,Total Salaried,0,553,859,440,48,1900,0,93,39,14,1,147,2047
224,MAHARASHTRA,2009,Total Self-employed,2,1554,2376,1569,705,6206,4,236,130,76,32,478,6684
225,MANIPUR,2009,House Wife,0,0,0,0,0,0,0,3,2,0,0,5,5
226,MANIPUR,2009,Service (Government),0,3,2,1,0,6,0,0,0,0,0,0,6
227,MANIPUR,2009,Service (Private),0,0,0,0,0,0,0,0,0,0,0,0,0
228,MANIPUR,2009,Public Sector Undertaking,0,0,0,0,0,0,0,0,0,0,0,0,0
229,MANIPUR,2009,Student,0,0,0,0,0,0,0,0,0,0,0,0,0
230,MANIPUR,2009,Unemployed,0,3,4,0,0,7,0,0,1,0,0,1,8
231,MANIPUR,2009,Self-employed (Business activity),0,0,0,0,0,0,0,0,0,0,0,0,0
232,MANIPUR,2009,Professional Activity,0,0,0,0,0,0,0,0,0,0,0,0,0
233,MANIPUR,2009,Farming/Agriculture Activity,0,0,0,0,0,0,0,1,0,0,0,1,1
234,MANIPUR,2009,Others (Please Specify),0,0,4,0,0,4,0,1,0,0,0,1,5
235,MANIPUR,2009,Retired Person,0,0,0,0,0,0,0,0,0,0,0,0,0
236,MANIPUR,2009,Others (Please Specify),0,0,1,0,0,1,0,1,0,0,0,1,2
237,MANIPUR,2009,Total,0,6,11,1,0,18,0,6,3,0,0,9,27
238,MANIPUR,2009,Total Salaried,0,3,2,1,0,6,0,0,0,0,0,0,6
239,MANIPUR,2009,Total Self-employed,0,0,4,0,0,4,0,2,0,0,0,2,6
240,MEGHALAYA,2009,House Wife,0,0,0,0,0,0,0,4,2,5,0,11,11
241,MEGHALAYA,2009,Service (Government),0,0,0,1,0,1,0,0,0,0,0,0,1
242,MEGHALAYA,2009,Service (Private),0,0,0,1,0,1,0,0,0,0,0,0,1
243,MEGHALAYA,2009,Public Sector Undertaking,0,0,1,0,1,2,0,0,0,0,0,0,2
244,MEGHALAYA,2009,Student,1,6,0,0,0,7,0,2,0,0,0,2,9
245,MEGHALAYA,2009,Unemployed,0,2,4,0,0,6,0,1,0,0,0,1,7
246,MEGHALAYA,2009,Self-employed (Business activity),0,1,1,1,0,3,0,0,0,0,0,0,3
247,MEGHALAYA,2009,Professional Activity,0,0,0,0,0,0,0,0,3,0,0,3,3
248,MEGHALAYA,2009,Farming/Agriculture Activity,0,3,2,10,1,16,0,5,0,0,0,5,21
249,MEGHALAYA,2009,Others (Please Specify),0,1,1,0,0,2,1,3,0,0,0,4,6
250,MEGHALAYA,2009,Retired Person,0,0,0,1,1,2,0,0,0,0,0,0,2
251,MEGHALAYA,2009,Others (Please Specify),0,11,2,13,1,27,0,3,1,12,3,19,46
252,MEGHALAYA,2009,Total,1,24,11,27,4,67,1,18,6,17,3,45,112
253,MEGHALAYA,2009,Total Salaried,0,0,1,2,1,4,0,0,0,0,0,0,4
254,MEGHALAYA,2009,Total Self-employed,0,5,4,11,1,21,1,8,3,0,0,12,33
255,MIZORAM,2009,House Wife,0,0,0,0,0,0,0,0,1,0,0,1,1
256,MIZORAM,2009,Service (Government),0,0,1,0,0,1,0,0,0,0,0,0,1
257,MIZORAM,2009,Service (Private),0,1,1,0,0,2,0,0,0,0,0,0,2
258,MIZORAM,2009,Public Sector Undertaking,0,0,0,0,0,0,0,0,0,0,0,0,0
259,MIZORAM,2009,Student,0,1,0,0,0,1,0,0,0,0,0,0,1
260,MIZORAM,2009,Unemployed,0,1,5,0,0,6,0,0,0,0,0,0,6
261,MIZORAM,2009,Self-employed (Business activity),0,0,0,0,0,0,0,0,0,0,0,0,0
262,MIZORAM,2009,Professional Activity,0,0,0,0,0,0,0,0,0,0,0,0,0
263,MIZORAM,2009,Farming/Agriculture Activity,1,16,14,1,1,33,0,2,1,2,0,5,38
264,MIZORAM,2009,Others (Please Specify),0,6,4,2,0,12,0,1,0,0,0,1,13
265,MIZORAM,2009,Retired Person,0,0,0,1,0,1,0,0,0,0,0,0,1
266,MIZORAM,2009,Others (Please Specify),0,6,0,0,0,6,0,0,0,0,0,0,6
267,MIZORAM,2009,Total,1,31,25,4,1,62,0,3,2,2,0,7,69
268,MIZORAM,2009,Total Salaried,0,1,2,0,0,3,0,0,0,0,0,0,3
269,MIZORAM,2009,Total Self-employed,1,22,18,3,1,45,0,3,1,2,0,6,51
270,NAGALAND,2009,House Wife,0,0,0,0,0,0,0,1,1,0,0,2,2
271,NAGALAND,2009,Service (Government),0,1,2,2,0,5,0,0,0,0,0,0,5
272,NAGALAND,2009,Service (Private),0,0,0,0,0,0,0,0,0,0,0,0,0
273,NAGALAND,2009,Public Sector Undertaking,0,0,0,0,0,0,0,0,0,0,0,0,0
274,NAGALAND,2009,Student,0,2,0,0,0,2,0,0,0,0,0,0,2
275,NAGALAND,2009,Unemployed,0,0,0,0,0,0,0,0,0,0,0,0,0
276,NAGALAND,2009,Self-employed (Business activity),0,0,1,0,0,1,0,0,0,0,0,0,1
277,NAGALAND,2009,Professional Activity,0,0,0,0,0,0,0,0,0,0,0,0,0
278,NAGALAND,2009,Farming/Agriculture Activity,0,0,0,0,0,0,0,1,0,0,0,1,1
279,NAGALAND,2009,Others (Please Specify),0,8,3,1,0,12,0,1,1,0,0,2,14
280,NAGALAND,2009,Retired Person,0,0,0,0,0,0,0,0,0,0,0,0,0
281,NAGALAND,2009,Others (Please Specify),2,1,1,1,0,5,0,1,0,0,0,1,6
282,NAGALAND,2009,Total,2,12,7,4,0,25,0,4,2,0,0,6,31
283,NAGALAND,2009,Total Salaried,0,1,2,2,0,5,0,0,0,0,0,0,5
284,NAGALAND,2009,Total Self-employed,0,8,4,1,0,13,0,2,1,0,0,3,16
285,ODISHA,2009,House Wife,0,0,0,0,0,0,0,254,261,92,20,627,627
286,ODISHA,2009,Service (Government),0,9,6,17,1,33,0,8,2,1,0,11,44
287,ODISHA,2009,Service (Private),0,83,93,45,17,238,0,53,35,13,0,101,339
288,ODISHA,2009,Public Sector Undertaking,0,52,39,17,11,119,0,12,27,17,0,56,175
289,ODISHA,2009,Student,20,140,1,0,0,161,26,105,1,0,0,132,293
290,ODISHA,2009,Unemployed,16,133,139,75,11,374,10,66,19,17,2,114,488
291,ODISHA,2009,Self-employed (Business activity),0,71,112,59,13,255,0,2,13,4,0,19,274
292,ODISHA,2009,Professional Activity,0,11,17,9,0,37,0,5,3,0,3,11,48
293,ODISHA,2009,Farming/Agriculture Activity,0,35,56,40,12,143,0,6,1,4,0,11,154
294,ODISHA,2009,Others (Please Specify),20,229,288,180,70,787,18,205,187,101,40,551,1338
295,ODISHA,2009,Retired Person,0,0,0,17,28,45,0,0,0,0,12,12,57
296,ODISHA,2009,Others (Please Specify),13,83,163,69,47,375,13,67,48,16,9,153,528
297,ODISHA,2009,Total,69,846,914,528,210,2567,67,783,597,265,86,1798,4365
298,ODISHA,2009,Total Salaried,0,144,138,79,29,390,0,73,64,31,0,168,558
299,ODISHA,2009,Total Self-employed,20,346,473,288,95,1222,18,218,204,109,43,592,1814
300,PUNJAB,2009,House Wife,0,0,0,0,0,0,0,64,49,12,5,130,130
301,PUNJAB,2009,Service (Government),0,1,13,1,0,15,0,0,0,0,0,0,15
302,PUNJAB,2009,Service (Private),1,20,22,5,6,54,0,3,4,0,0,7,61
303,PUNJAB,2009,Public Sector Undertaking,0,1,3,0,2,6,0,0,2,0,0,2,8
304,PUNJAB,2009,Student,7,18,4,0,0,29,4,22,0,0,0,26,55
305,PUNJAB,2009,Unemployed,0,20,20,2,1,43,0,3,2,0,0,5,48
306,PUNJAB,2009,Self-employed (Business activity),1,12,22,13,3,51,0,0,0,0,2,2,53
307,PUNJAB,2009,Professional Activity,0,5,11,15,0,31,0,0,1,0,0,1,32
308,PUNJAB,2009,Farming/Agriculture Activity,0,38,35,14,6,93,0,2,0,2,0,4,97
309,PUNJAB,2009,Others (Please Specify),2,73,52,35,14,176,0,4,2,2,1,9,185
310,PUNJAB,2009,Retired Person,0,2,5,4,1,12,0,0,0,4,4,8,20
311,PUNJAB,2009,Others (Please Specify),0,40,33,33,19,125,1,9,1,4,3,18,143
312,PUNJAB,2009,Total,11,230,220,122,52,635,5,107,61,24,15,212,847
313,PUNJAB,2009,Total Salaried,1,22,38,6,8,75,0,3,6,0,0,9,84
314,PUNJAB,2009,Total Self-employed,3,128,120,77,23,351,0,6,3,4,3,16,367
315,RAJASTHAN,2009,House Wife,0,0,0,0,0,0,23,466,410,142,29,1070,1070
316,RAJASTHAN,2009,Service (Government),0,5,19,11,1,36,0,7,3,0,0,10,46
317,RAJASTHAN,2009,Service (Private),0,188,217,91,26,522,0,12,2,0,0,14,536
318,RAJASTHAN,2009,Public Sector Undertaking,0,2,5,9,4,20,0,1,1,1,0,3,23
319,RAJASTHAN,2009,Student,37,108,1,0,0,146,20,55,2,0,0,77,223
320,RAJASTHAN,2009,Unemployed,0,77,47,14,1,139,0,5,3,8,1,17,156
321,RAJASTHAN,2009,Self-employed (Business activity),0,61,158,54,4,277,0,2,2,2,0,6,283
322,RAJASTHAN,2009,Professional Activity,0,8,35,9,0,52,0,0,1,0,0,1,53
323,RAJASTHAN,2009,Farming/Agriculture Activity,7,196,337,190,45,775,0,33,28,12,3,76,851
324,RAJASTHAN,2009,Others (Please Specify),17,301,343,206,35,902,13,67,53,10,3,146,1048
325,RAJASTHAN,2009,Retired Person,0,0,1,1,3,5,0,0,0,0,1,1,6
326,RAJASTHAN,2009,Others (Please Specify),38,214,179,140,66,637,6,62,43,18,4,133,770
327,RAJASTHAN,2009,Total,99,1160,1342,725,185,3511,62,710,548,193,41,1554,5065
328,RAJASTHAN,2009,Total Salaried,0,195,241,111,31,578,0,20,6,1,0,27,605
329,RAJASTHAN,2009,Total Self-employed,24,566,873,459,84,2006,13,102,84,24,6,229,2235
330,SIKKIM,2009,House Wife,0,0,0,0,0,0,0,5,3,0,0,8,8
331,SIKKIM,2009,Service (Government),0,5,2,0,0,7,0,3,2,0,0,5,12
332,SIKKIM,2009,Service (Private),0,7,3,2,1,13,0,7,4,4,3,18,31
333,SIKKIM,2009,Public Sector Undertaking,0,3,5,3,0,11,0,8,5,3,0,16,27
334,SIKKIM,2009,Student,0,5,0,0,0,5,0,2,0,0,0,2,7
335,SIKKIM,2009,Unemployed,0,2,3,5,2,12,0,11,7,5,0,23,35
336,SIKKIM,2009,Self-employed (Business activity),0,11,7,7,1,26,0,5,1,3,0,9,35
337,SIKKIM,2009,Professional Activity,0,7,0,2,0,9,0,6,3,5,0,14,23
338,SIKKIM,2009,Farming/Agriculture Activity,0,12,0,1,1,14,0,3,2,2,2,9,23
339,SIKKIM,2009,Others (Please Specify),1,3,2,1,1,8,1,3,1,0,0,5,13
340,SIKKIM,2009,Retired Person,0,0,0,2,2,4,0,0,0,1,2,3,7
341,SIKKIM,2009,Others (Please Specify),2,10,1,0,0,13,2,4,1,0,0,7,20
342,SIKKIM,2009,Total,3,65,23,23,8,122,3,57,29,23,7,119,241
343,SIKKIM,2009,Total Salaried,0,15,10,5,1,31,0,18,11,7,3,39,70
344,SIKKIM,2009,Total Self-employed,1,33,9,11,3,57,1,17,7,10,2,37,94
345,TAMIL NADU,2009,House Wife,0,0,0,0,0,0,0,987,1017,492,267,2763,2763
346,TAMIL NADU,2009,Service (Government),0,7,86,104,11,208,0,8,26,11,0,45,253
347,TAMIL NADU,2009,Service (Private),0,393,604,308,54,1359,0,138,125,98,19,380,1739
348,TAMIL NADU,2009,Public Sector Undertaking,0,152,136,48,9,345,0,4,12,11,0,27,372
349,TAMIL NADU,2009,Student,83,174,0,0,0,257,68,131,0,0,0,199,456
350,TAMIL NADU,2009,Unemployed,3,359,617,446,137,1562,6,171,83,140,24,424,1986
351,TAMIL NADU,2009,Self-employed (Business activity),0,152,249,209,99,709,2,34,53,22,11,122,831
352,TAMIL NADU,2009,Professional Activity,0,97,84,23,38,242,0,38,23,16,9,86,328
353,TAMIL NADU,2009,Farming/Agriculture Activity,5,195,306,244,106,856,7,86,56,36,19,204,1060
354,TAMIL NADU,2009,Others (Please Specify),27,485,645,437,239,1833,26,197,215,82,49,569,2402
355,TAMIL NADU,2009,Retired Person,0,0,0,84,98,182,0,0,0,14,18,32,214
356,TAMIL NADU,2009,Others (Please Specify),18,347,447,346,239,1397,35,283,159,97,49,623,2020
357,TAMIL NADU,2009,Total,136,2361,3174,2249,1030,8950,144,2077,1769,1019,465,5474,14424
358,TAMIL NADU,2009,Total Salaried,0,552,826,460,74,1912,0,150,163,120,19,452,2364
359,TAMIL NADU,2009,Total Self-employed,32,929,1284,913,482,3640,35,355,347,156,88,981,4621
360,TRIPURA,2009,House Wife,0,0,0,0,0,0,0,93,48,26,9,176,176
361,TRIPURA,2009,Service (Government),0,5,9,5,0,19,0,0,0,0,0,0,19
362,TRIPURA,2009,Service (Private),0,9,5,2,3,19,0,0,0,0,0,0,19
363,TRIPURA,2009,Public Sector Undertaking,0,0,2,0,0,2,0,0,0,0,0,0,2
364,TRIPURA,2009,Student,8,39,0,0,0,47,8,34,0,0,0,42,89
365,TRIPURA,2009,Unemployed,0,22,3,0,0,25,0,1,3,0,0,4,29
366,TRIPURA,2009,Self-employed (Business activity),0,15,38,18,0,71,0,4,0,0,0,4,75
367,TRIPURA,2009,Professional Activity,0,5,10,4,1,20,0,0,0,0,0,0,20
368,TRIPURA,2009,Farming/Agriculture Activity,0,11,16,13,5,45,0,0,0,0,0,0,45
369,TRIPURA,2009,Others (Please Specify),0,49,56,51,12,168,1,25,9,0,0,35,203
370,TRIPURA,2009,Retired Person,0,0,0,0,0,0,0,0,0,0,0,0,0
371,TRIPURA,2009,Others (Please Specify),1,32,15,2,1,51,1,1,2,5,1,10,61
372,TRIPURA,2009,Total,9,187,154,95,22,467,10,158,62,31,10,271,738
373,TRIPURA,2009,Total Salaried,0,14,16,7,3,40,0,0,0,0,0,0,40
374,TRIPURA,2009,Total Self-employed,0,80,120,86,18,304,1,29,9,0,0,39,343
375,UTTAR PRADESH,2009,House Wife,0,0,0,0,0,0,7,605,272,74,48,1006,1006
376,UTTAR PRADESH,2009,Service (Government),0,10,15,6,0,31,0,11,4,3,0,18,49
377,UTTAR PRADESH,2009,Service (Private),0,95,112,47,7,261,0,42,36,8,0,86,347
378,UTTAR PRADESH,2009,Public Sector Undertaking,0,16,12,22,0,50,0,16,7,0,0,23,73
379,UTTAR PRADESH,2009,Student,21,172,10,0,0,203,29,107,7,0,0,143,346
380,UTTAR PRADESH,2009,Unemployed,5,135,118,48,13,319,1,21,20,7,3,52,371
381,UTTAR PRADESH,2009,Self-employed (Business activity),0,45,31,38,12,126,0,6,10,2,0,18,144
382,UTTAR PRADESH,2009,Professional Activity,0,7,8,5,1,21,0,1,1,0,0,2,23
383,UTTAR PRADESH,2009,Farming/Agriculture Activity,6,121,253,96,48,524,0,59,28,24,21,132,656
384,UTTAR PRADESH,2009,Others (Please Specify),8,148,143,118,68,485,14,134,100,35,14,297,782
385,UTTAR PRADESH,2009,Retired Person,0,2,0,0,2,4,0,0,11,0,0,11,15
386,UTTAR PRADESH,2009,Others (Please Specify),11,85,63,38,18,215,11,67,35,8,10,131,346
387,UTTAR PRADESH,2009,Total,51,836,765,418,169,2239,62,1069,531,161,96,1919,4158
388,UTTAR PRADESH,2009,Total Salaried,0,121,139,75,7,342,0,69,47,11,0,127,469
389,UTTAR PRADESH,2009,Total Self-employed,14,321,435,257,129,1156,14,200,139,61,35,449,1605
390,UTTARAKHAND,2009,House Wife,0,0,0,0,0,0,0,42,25,7,1,75,75
391,UTTARAKHAND,2009,Service (Government),0,3,1,4,0,8,0,0,0,0,0,0,8
392,UTTARAKHAND,2009,Service (Private),0,15,9,9,0,33,0,2,4,0,0,6,39
393,UTTARAKHAND,2009,Public Sector Undertaking,0,3,1,2,0,6,0,0,0,2,0,2,8
394,UTTARAKHAND,2009,Student,1,20,0,0,0,21,3,16,0,0,0,19,40
395,UTTARAKHAND,2009,Unemployed,0,10,16,5,0,31,0,4,1,0,0,5,36
396,UTTARAKHAND,2009,Self-employed (Business activity),0,2,4,2,0,8,0,0,2,0,0,2,10
397,UTTARAKHAND,2009,Professional Activity,0,2,8,14,3,27,0,5,2,0,0,7,34
398,UTTARAKHAND,2009,Farming/Agriculture Activity,0,10,9,4,3,26,0,4,0,0,0,4,30
399,UTTARAKHAND,2009,Others (Please Specify),0,0,0,0,0,0,0,0,0,0,0,0,0
400,UTTARAKHAND,2009,Retired Person,1,12,7,17,5,42,0,6,8,6,0,20,62
401,UTTARAKHAND,2009,Others (Please Specify),0,0,0,0,0,0,0,0,0,0,0,0,0
402,UTTARAKHAND,2009,Total,2,77,55,57,11,202,3,79,42,15,1,140,342
403,UTTARAKHAND,2009,Total Salaried,0,21,11,15,0,47,0,2,4,2,0,8,55
404,UTTARAKHAND,2009,Total Self-employed,0,14,21,20,6,61,0,9,4,0,0,13,74
405,WEST BENGAL,2009,House Wife,0,0,0,0,0,0,0,1495,1256,488,66,3305,3305
406,WEST BENGAL,2009,Service (Government),0,32,94,53,0,179,0,19,26,14,1,60,239
407,WEST BENGAL,2009,Service (Private),0,143,241,266,6,656,0,64,80,15,1,160,816
408,WEST BENGAL,2009,Public Sector Undertaking,0,67,228,215,4,514,0,33,37,23,0,93,607
409,WEST BENGAL,2009,Student,117,313,23,0,0,453,120,279,18,0,0,417,870
410,WEST BENGAL,2009,Unemployed,1,448,591,108,3,1151,1,86,88,29,0,204,1355
411,WEST BENGAL,2009,Self-employed (Business activity),0,290,471,333,44,1138,0,69,83,44,4,200,1338
412,WEST BENGAL,2009,Professional Activity,0,23,96,59,2,180,0,15,13,0,0,28,208
413,WEST BENGAL,2009,Farming/Agriculture Activity,1,256,402,217,53,929,4,49,52,18,2,125,1054
414,WEST BENGAL,2009,Others (Please Specify),72,329,724,312,67,1504,18,204,168,90,26,506,2010
415,WEST BENGAL,2009,Retired Person,0,0,0,0,58,58,0,0,0,0,30,30,88
416,WEST BENGAL,2009,Others (Please Specify),44,506,539,417,226,1732,75,412,310,163,66,1026,2758
417,WEST BENGAL,2009,Total,235,2407,3409,1980,463,8494,218,2725,2131,884,196,6154,14648
418,WEST BENGAL,2009,Total Salaried,0,242,563,534,10,1349,0,116,143,52,2,313,1662
419,WEST BENGAL,2009,Total Self-employed,73,898,1693,921,166,3751,22,337,316,152,32,859,4610
420,TOTAL (STATES),2009,House Wife,0,0,0,0,0,0,62,10751,8459,3792,1524,24588,24588
421,TOTAL (STATES),2009,Service (Government),0,273,608,461,24,1366,0,125,108,59,2,294,1660
422,TOTAL (STATES),2009,Service (Private),3,2643,3800,2032,383,8861,2,722,500,239,64,1527,10388
423,TOTAL (STATES),2009,Public Sector Undertaking,0,707,940,652,136,2435,1,173,145,100,17,436,2871
424,TOTAL (STATES),2009,Student,636,2829,171,11,0,3647,609,2183,88,3,0,2883,6530
425,TOTAL (STATES),2009,Unemployed,36,2783,3338,1493,416,8066,25,639,422,275,88,1449,9515
426,TOTAL (STATES),2009,Self-employed (Business activity),24,1759,2732,2072,563,7150,2,199,229,103,19,552,7702
427,TOTAL (STATES),2009,Professional Activity,20,850,1214,937,199,3220,0,153,123,54,16,346,3566
428,TOTAL (STATES),2009,Farming/Agriculture Activity,46,3418,5762,3977,1563,14766,27,929,803,481,169,2409,17175
429,TOTAL (STATES),2009,Others (Please Specify),217,4541,6060,4232,1740,16790,297,1822,1597,868,349,4933,21723
430,TOTAL (STATES),2009,Retired Person,1,17,29,189,590,826,0,10,46,31,108,195,1021
431,TOTAL (STATES),2009,Others (Please Specify),500,3313,4211,3285,1601,12910,393,1953,1430,935,510,5221,18131
432,TOTAL (STATES),2009,Total,1483,23133,28865,19341,7215,80037,1418,19659,13950,6940,2866,44833,124870
433,TOTAL (STATES),2009,Total Salaried,3,3623,5348,3145,543,12662,3,1020,753,398,83,2257,14919
434,TOTAL (STATES),2009,Total Self-employed,307,10568,15768,11218,4065,41926,326,3103,2752,1506,553,8240,50166
435,A & N ISLANDS,2009,House Wife,0,0,0,0,0,0,0,14,10,4,1,29,29
436,A & N ISLANDS,2009,Service (Government),0,0,3,9,1,13,0,0,1,0,0,1,14
437,A & N ISLANDS,2009,Service (Private),0,20,10,10,2,42,0,0,2,0,0,2,44
438,A & N ISLANDS,2009,Public Sector Undertaking,0,0,0,0,0,0,0,0,0,0,0,0,0
439,A & N ISLANDS,2009,Student,1,2,0,0,0,3,7,3,0,0,0,10,13
440,A & N ISLANDS,2009,Unemployed,0,0,0,0,0,0,0,0,0,0,0,0,0
441,A & N ISLANDS,2009,Self-employed (Business activity),0,0,2,0,0,2,0,0,0,0,0,0,2
442,A & N ISLANDS,2009,Professional Activity,0,0,0,0,0,0,0,0,0,0,0,0,0
443,A & N ISLANDS,2009,Farming/Agriculture Activity,0,5,7,5,2,19,0,0,0,0,0,0,19
444,A & N ISLANDS,2009,Others (Please Specify),0,4,1,1,0,6,0,2,1,0,0,3,9
445,A & N ISLANDS,2009,Retired Person,0,0,0,0,1,1,0,0,0,0,0,0,1
446,A & N ISLANDS,2009,Others (Please Specify),0,0,0,0,0,0,0,0,0,0,0,0,0
447,A & N ISLANDS,2009,Total,1,31,23,25,6,86,7,19,14,4,1,45,131
448,A & N ISLANDS,2009,Total Salaried,0,20,13,19,3,55,0,0,3,0,0,3,58
449,A & N ISLANDS,2009,Total Self-employed,0,9,10,6,2,27,0,2,1,0,0,3,30
450,CHANDIGARH,2009,House Wife,0,0,0,0,0,0,0,6,8,1,2,17,17
451,CHANDIGARH,2009,Service (Government),0,0,4,3,0,7,0,0,0,0,0,0,7
452,CHANDIGARH,2009,Service (Private),0,0,3,2,0,5,0,0,1,0,0,1,6
453,CHANDIGARH,2009,Public Sector Undertaking,0,5,6,1,0,12,0,0,0,0,0,0,12
454,CHANDIGARH,2009,Student,0,6,0,0,0,6,1,11,0,0,0,12,18
455,CHANDIGARH,2009,Unemployed,0,3,3,1,0,7,0,0,0,0,0,0,7
456,CHANDIGARH,2009,Self-employed (Business activity),0,0,1,1,1,3,0,0,0,0,0,0,3
457,CHANDIGARH,2009,Professional Activity,0,0,1,0,0,1,0,0,0,0,0,0,1
458,CHANDIGARH,2009,Farming/Agriculture Activity,0,0,0,0,0,0,0,0,0,0,0,0,0
459,CHANDIGARH,2009,Others (Please Specify),0,1,0,0,0,1,0,0,0,0,0,0,1
460,CHANDIGARH,2009,Retired Person,0,0,0,0,1,1,0,0,0,0,0,0,1
461,CHANDIGARH,2009,Others (Please Specify),0,1,0,0,0,1,0,1,0,0,0,1,2
462,CHANDIGARH,2009,Total,0,16,18,8,2,44,1,18,9,1,2,31,75
463,CHANDIGARH,2009,Total Salaried,0,5,13,6,0,24,0,0,1,0,0,1,25
464,CHANDIGARH,2009,Total Self-employed,0,1,2,1,1,5,0,0,0,0,0,0,5
465,D & N HAVELI,2009,House Wife,0,0,0,0,0,0,0,10,2,1,6,19,19
466,D & N HAVELI,2009,Service (Government),0,0,1,0,0,1,0,0,0,0,0,0,1
467,D & N HAVELI,2009,Service (Private),0,6,3,1,0,10,0,0,2,0,0,2,12
468,D & N HAVELI,2009,Public Sector Undertaking,0,0,0,0,0,0,0,0,0,0,0,0,0
469,D & N HAVELI,2009,Student,0,2,0,0,0,2,0,4,0,0,0,4,6
470,D & N HAVELI,2009,Unemployed,0,0,0,0,0,0,0,0,0,0,0,0,0
471,D & N HAVELI,2009,Self-employed (Business activity),0,0,0,1,0,1,0,0,0,0,0,0,1
472,D & N HAVELI,2009,Professional Activity,0,0,0,0,0,0,0,0,0,0,0,0,0
473,D & N HAVELI,2009,Farming/Agriculture Activity,0,2,5,6,2,15,0,0,0,0,0,0,15
474,D & N HAVELI,2009,Others (Please Specify),0,0,1,0,0,1,0,0,0,0,1,1,2
475,D & N HAVELI,2009,Retired Person,0,0,0,0,0,0,0,0,0,0,0,0,0
476,D & N HAVELI,2009,Others (Please Specify),0,0,0,0,0,0,0,0,0,0,0,0,0
477,D & N HAVELI,2009,Total,0,10,10,8,2,30,0,14,4,1,7,26,56
478,D & N HAVELI,2009,Total Salaried,0,6,4,1,0,11,0,0,2,0,0,2,13
479,D & N HAVELI,2009,Total Self-employed,0,2,6,7,2,17,0,0,0,0,1,1,18
480,DAMAN & DIU,2009,House Wife,0,0,0,0,0,0,0,0,3,1,0,4,4
481,DAMAN & DIU,2009,Service (Government),0,0,0,0,0,0,0,0,0,0,0,0,0
482,DAMAN & DIU,2009,Service (Private),0,6,0,0,0,6,0,0,1,0,0,1,7
483,DAMAN & DIU,2009,Public Sector Undertaking,0,0,0,0,0,0,0,1,0,0,0,1,1
484,DAMAN & DIU,2009,Student,0,1,0,1,0,2,1,0,0,0,0,1,3
485,DAMAN & DIU,2009,Unemployed,0,0,0,1,0,1,0,0,0,0,0,0,1
486,DAMAN & DIU,2009,Self-employed (Business activity),0,0,0,0,0,0,0,0,0,0,0,0,0
487,DAMAN & DIU,2009,Professional Activity,0,0,0,0,0,0,0,0,0,0,0,0,0
488,DAMAN & DIU,2009,Farming/Agriculture Activity,0,0,0,0,0,0,0,0,0,0,0,0,0
489,DAMAN & DIU,2009,Others (Please Specify),0,0,0,0,0,0,0,0,0,0,0,0,0
490,DAMAN & DIU,2009,Retired Person,0,0,0,0,0,0,0,0,0,0,0,0,0
491,DAMAN & DIU,2009,Others (Please Specify),0,1,2,1,2,6,0,0,1,0,0,1,7
492,DAMAN & DIU,2009,Total,0,8,2,3,2,15,1,1,5,1,0,8,23
493,DAMAN & DIU,2009,Total Salaried,0,6,0,0,0,6,0,1,1,0,0,2,8
494,DAMAN & DIU,2009,Total Self-employed,0,0,0,0,0,0,0,0,0,0,0,0,0
495,DELHI (UT),2009,House Wife,0,0,0,0,0,0,0,198,98,21,6,323,323
496,DELHI (UT),2009,Service (Government),0,4,9,5,0,18,0,1,1,0,0,2,20
497,DELHI (UT),2009,Service (Private),0,88,99,21,2,210,0,16,3,2,0,21,231
498,DELHI (UT),2009,Public Sector Undertaking,0,9,11,4,0,24,0,2,0,0,0,2,26
499,DELHI (UT),2009,Student,10,87,2,0,0,99,7,58,1,0,0,66,165
500,DELHI (UT),2009,Unemployed,1,129,80,25,3,238,5,30,7,0,0,42,280
501,DELHI (UT),2009,Self-employed (Business activity),0,13,12,5,1,31,0,0,0,0,0,0,31
502,DELHI (UT),2009,Professional Activity,0,3,5,4,0,12,0,1,0,0,0,1,13
503,DELHI (UT),2009,Farming/Agriculture Activity,0,1,3,1,0,5,0,0,0,0,0,0,5
504,DELHI (UT),2009,Others (Please Specify),0,39,43,22,4,108,0,12,8,4,0,24,132
505,DELHI (UT),2009,Retired Person,0,0,0,0,7,7,0,0,0,0,0,0,7
506,DELHI (UT),2009,Others (Please Specify),4,84,61,21,11,181,7,42,7,6,1,63,244
507,DELHI (UT),2009,Total,15,457,325,108,28,933,19,360,125,33,7,544,1477
508,DELHI (UT),2009,Total Salaried,0,101,119,30,2,252,0,19,4,2,0,25,277
509,DELHI (UT),2009,Total Self-employed,0,56,63,32,5,156,0,13,8,4,0,25,181
510,LAKSHADWEEP,2009,House Wife,0,0,0,0,0,0,0,0,1,0,0,1,1
511,LAKSHADWEEP,2009,Service (Government),0,0,0,0,0,0,0,0,0,0,0,0,0
512,LAKSHADWEEP,2009,Service (Private),0,0,0,0,0,0,0,0,0,0,0,0,0
513,LAKSHADWEEP,2009,Public Sector Undertaking,0,0,0,0,0,0,0,0,0,0,0,0,0
514,LAKSHADWEEP,2009,Student,0,0,0,0,0,0,0,0,0,0,0,0,0
515,LAKSHADWEEP,2009,Unemployed,0,0,0,0,0,0,0,0,0,0,0,0,0
516,LAKSHADWEEP,2009,Self-employed (Business activity),0,0,0,0,0,0,0,0,0,0,0,0,0
517,LAKSHADWEEP,2009,Professional Activity,0,0,0,0,0,0,0,0,0,0,0,0,0
518,LAKSHADWEEP,2009,Farming/Agriculture Activity,0,0,0,0,0,0,0,0,0,0,0,0,0
519,LAKSHADWEEP,2009,Others (Please Specify),0,0,0,0,0,0,0,0,0,0,0,0,0
520,LAKSHADWEEP,2009,Retired Person,0,0,0,0,0,0,0,0,0,0,0,0,0
521,LAKSHADWEEP,2009,Others (Please Specify),0,0,0,0,0,0,0,0,0,0,0,0,0
522,LAKSHADWEEP,2009,Total,0,0,0,0,0,0,0,0,1,0,0,1,1
523,LAKSHADWEEP,2009,Total Salaried,0,0,0,0,0,0,0,0,0,0,0,0,0
524,LAKSHADWEEP,2009,Total Self-employed,0,0,0,0,0,0,0,0,0,0,0,0,0
525,PUDUCHERRY,2009,House Wife,0,0,0,0,0,0,0,50,32,23,6,111,111
526,PUDUCHERRY,2009,Service (Government),0,2,3,6,0,11,0,0,1,0,0,1,12
527,PUDUCHERRY,2009,Service (Private),0,7,10,1,1,19,0,12,1,0,0,13,32
528,PUDUCHERRY,2009,Public Sector Undertaking,0,1,0,3,0,4,0,0,0,0,0,0,4
529,PUDUCHERRY,2009,Student,2,7,0,0,0,9,4,13,0,0,0,17,26
530,PUDUCHERRY,2009,Unemployed,0,16,14,20,26,76,0,24,4,2,7,37,113
531,PUDUCHERRY,2009,Self-employed (Business activity),0,2,3,3,1,9,0,0,0,0,0,0,9
532,PUDUCHERRY,2009,Professional Activity,0,18,18,13,0,49,0,2,2,1,0,5,54
533,PUDUCHERRY,2009,Farming/Agriculture Activity,0,38,43,56,9,146,0,2,5,1,0,8,154
534,PUDUCHERRY,2009,Others (Please Specify),0,0,1,1,0,2,0,0,0,0,0,0,2
535,PUDUCHERRY,2009,Retired Person,0,0,0,0,1,1,0,0,0,0,0,0,1
536,PUDUCHERRY,2009,Others (Please Specify),0,0,0,0,0,0,0,0,0,0,0,0,0
537,PUDUCHERRY,2009,Total,2,91,92,103,38,326,4,103,45,27,13,192,518
538,PUDUCHERRY,2009,Total Salaried,0,10,13,10,1,34,0,12,2,0,0,14,48
539,PUDUCHERRY,2009,Total Self-employed,0,58,65,73,10,206,0,4,7,2,0,13,219
540,TOTAL (UTs),2009,House Wife,0,0,0,0,0,0,0,278,154,51,21,504,504
541,TOTAL (UTs),2009,Service (Government),0,6,20,23,1,50,0,1,3,0,0,4,54
542,TOTAL (UTs),2009,Service (Private),0,127,125,35,5,292,0,28,10,2,0,40,332
543,TOTAL (UTs),2009,Public Sector Undertaking,0,15,17,8,0,40,0,3,0,0,0,3,43
544,TOTAL (UTs),2009,Student,13,105,2,1,0,121,20,89,1,0,0,110,231
545,TOTAL (UTs),2009,Unemployed,1,148,97,47,29,322,5,54,11,2,7,79,401
546,TOTAL (UTs),2009,Self-employed (Business activity),0,15,18,10,3,46,0,0,0,0,0,0,46
547,TOTAL (UTs),2009,Professional Activity,0,21,24,17,0,62,0,3,2,1,0,6,68
548,TOTAL (UTs),2009,Farming/Agriculture Activity,0,46,58,68,13,185,0,2,5,1,0,8,193
549,TOTAL (UTs),2009,Others (Please Specify),0,44,46,24,4,118,0,14,9,4,1,28,146
550,TOTAL (UTs),2009,Retired Person,0,0,0,0,10,10,0,0,0,0,0,0,10
551,TOTAL (UTs),2009,Others (Please Specify),4,86,63,22,13,188,7,43,8,6,1,65,253
552,TOTAL (UTs),2009,Total,18,613,470,255,78,1434,32,515,203,67,30,847,2281
553,TOTAL (UTs),2009,Total Salaried,0,148,162,66,6,382,0,32,13,2,0,47,429
554,TOTAL (UTs),2009,Total Self-employed,0,126,146,119,20,411,0,19,16,6,1,42,453
555,TOTAL (ALL INDIA),2009,House Wife,0,0,0,0,0,0,62,11029,8613,3843,1545,25092,25092
556,TOTAL (ALL INDIA),2009,Service (Government),0,279,628,484,25,1416,0,126,111,59,2,298,1714
557,TOTAL (ALL INDIA),2009,Service (Private),3,2770,3925,2067,388,9153,2,750,510,241,64,1567,10720
558,TOTAL (ALL INDIA),2009,Public Sector Undertaking,0,722,957,660,136,2475,1,176,145,100,17,439,2914
559,TOTAL (ALL INDIA),2009,Student,649,2934,173,12,0,3768,629,2272,89,3,0,2993,6761
560,TOTAL (ALL INDIA),2009,Unemployed,37,2931,3435,1540,445,8388,30,693,433,277,95,1528,9916
561,TOTAL (ALL INDIA),2009,Self-employed (Business activity),24,1774,2750,2082,566,7196,2,199,229,103,19,552,7748
562,TOTAL (ALL INDIA),2009,Professional Activity,20,871,1238,954,199,3282,0,156,125,55,16,352,3634
563,TOTAL (ALL INDIA),2009,Farming/Agriculture Activity,46,3464,5820,4045,1576,14951,27,931,808,482,169,2417,17368
564,TOTAL (ALL INDIA),2009,Others (Please Specify),217,4585,6106,4256,1744,16908,297,1836,1606,872,350,4961,21869
565,TOTAL (ALL INDIA),2009,Retired Person,1,17,29,189,600,836,0,10,46,31,108,195,1031
566,TOTAL (ALL INDIA),2009,Others (Please Specify),504,3399,4274,3307,1614,13098,400,1996,1438,941,511,5286,18384
567,TOTAL (ALL INDIA),2009,Total,1501,23746,29335,19596,7293,81471,1450,20174,14153,7007,2896,45680,127151
568,TOTAL (ALL INDIA),2009,Total Salaried,3,3771,5510,3211,549,13044,3,1052,766,400,83,2304,15348
569,TOTAL (ALL INDIA),2009,Total Self-employed,307,10694,15914,11337,4085,42337,326,3122,2768,1512,554,8282,50619
0,ANDHRA PRADESH,2010,House Wife,0,0,0,0,0,0,0,1067,879,409,246,2601,2601
1,ANDHRA PRADESH,2010,Service (Government),0,39,96,52,0,187,0,41,31,0,0,72,259
2,ANDHRA PRADESH,2010,Service (Private),0,352,361,198,18,929,0,58,36,11,9,114,1043
3,ANDHRA PRADESH,2010,Public Sector Undertaking,0,156,184,96,49,485,0,9,29,9,0,47,532
4,ANDHRA PRADESH,2010,Student,41,333,0,0,0,374,62,220,0,0,0,282,656
5,ANDHRA PRADESH,2010,Unemployed,0,266,208,87,0,561,0,27,48,0,0,75,636
6,ANDHRA PRADESH,2010,Self-employed (Business activity),0,324,371,192,50,937,0,43,2,10,3,58,995
7,ANDHRA PRADESH,2010,Professional Activity,0,86,75,37,20,218,0,6,1,2,1,10,228
8,ANDHRA PRADESH,2010,Farming/Agriculture Activity,4,563,824,573,166,2130,12,165,137,40,41,395,2525
9,ANDHRA PRADESH,2010,Others (Please Specify),32,963,1216,894,368,3473,29,343,187,112,76,747,4220
10,ANDHRA PRADESH,2010,Retired Person,0,0,0,9,57,66,0,0,0,11,7,18,84
11,ANDHRA PRADESH,2010,Others (Please Specify),18,448,527,428,166,1587,27,166,222,74,46,535,2122
12,ANDHRA PRADESH,2010,Total,95,3530,3862,2566,894,10947,130,2145,1572,678,429,4954,15901
13,ANDHRA PRADESH,2010,Total Salaried,0,547,641,346,67,1601,0,108,96,20,9,233,1834
14,ANDHRA PRADESH,2010,Total Self-employed,36,1936,2486,1696,604,6758,41,557,327,164,121,1210,7968
15,ARUNACHAL PRADESH,2010,House Wife,0,0,0,0,0,0,0,9,7,1,0,17,17
16,ARUNACHAL PRADESH,2010,Service (Government),0,6,4,1,0,11,0,0,0,0,0,0,11
17,ARUNACHAL PRADESH,2010,Service (Private),0,3,5,1,0,9,0,0,1,0,0,1,10
18,ARUNACHAL PRADESH,2010,Public Sector Undertaking,0,0,0,0,0,0,0,0,0,0,0,0,0
19,ARUNACHAL PRADESH,2010,Student,4,4,0,0,0,8,4,4,0,0,0,8,16
20,ARUNACHAL PRADESH,2010,Unemployed,0,2,4,0,0,6,0,1,0,0,0,1,7
21,ARUNACHAL PRADESH,2010,Self-employed (Business activity),0,4,0,0,0,4,0,0,0,0,0,0,4
22,ARUNACHAL PRADESH,2010,Professional Activity,0,0,0,0,0,0,0,0,0,0,0,0,0
23,ARUNACHAL PRADESH,2010,Farming/Agriculture Activity,0,7,9,1,1,18,0,0,0,0,0,0,18
24,ARUNACHAL PRADESH,2010,Others (Please Specify),0,4,4,3,1,12,0,0,0,0,0,0,12
25,ARUNACHAL PRADESH,2010,Retired Person,0,0,0,0,0,0,0,0,0,0,0,0,0
26,ARUNACHAL PRADESH,2010,Others (Please Specify),0,17,6,0,0,23,0,12,0,1,0,13,36
27,ARUNACHAL PRADESH,2010,Total,4,47,32,6,2,91,4,26,8,2,0,40,131
28,ARUNACHAL PRADESH,2010,Total Salaried,0,9,9,2,0,20,0,0,1,0,0,1,21
29,ARUNACHAL PRADESH,2010,Total Self-employed,0,15,13,4,2,34,0,0,0,0,0,0,34
30,ASSAM,2010,House Wife,0,0,0,0,0,0,0,205,146,55,9,415,415
31,ASSAM,2010,Service (Government),0,2,7,9,0,18,0,1,0,0,0,1,19
32,ASSAM,2010,Service (Private),0,19,28,10,0,57,0,11,5,0,0,16,73
33,ASSAM,2010,Public Sector Undertaking,0,19,51,26,2,98,0,2,12,6,0,20,118
34,ASSAM,2010,Student,20,128,0,0,0,148,14,85,0,0,0,99,247
35,ASSAM,2010,Unemployed,0,3,28,34,1,66,0,12,2,2,0,16,82
36,ASSAM,2010,Self-employed (Business activity),0,112,163,95,1,371,0,36,23,11,0,70,441
37,ASSAM,2010,Professional Activity,0,59,45,29,3,136,0,7,3,0,0,10,146
38,ASSAM,2010,Farming/Agriculture Activity,0,132,126,82,12,352,0,6,9,1,1,17,369
39,ASSAM,2010,Others (Please Specify),9,189,219,112,36,565,8,96,83,42,9,238,803
40,ASSAM,2010,Retired Person,0,0,2,2,6,10,0,0,0,0,0,0,10
41,ASSAM,2010,Others (Please Specify),5,82,66,43,9,205,10,28,19,5,3,65,270
42,ASSAM,2010,Total,34,745,735,442,70,2026,32,489,302,122,22,967,2993
43,ASSAM,2010,Total Salaried,0,40,86,45,2,173,0,14,17,6,0,37,210
44,ASSAM,2010,Total Self-employed,9,492,553,318,52,1424,8,145,118,54,10,335,1759
45,BIHAR,2010,House Wife,0,0,0,0,0,0,0,80,89,26,9,204,204
46,BIHAR,2010,Service (Government),0,6,5,2,0,13,0,2,6,0,0,8,21
47,BIHAR,2010,Service (Private),0,23,12,5,1,41,2,2,3,1,0,8,49
48,BIHAR,2010,Public Sector Undertaking,0,2,0,0,0,2,0,0,0,0,0,0,2
49,BIHAR,2010,Student,12,21,6,0,0,39,14,13,8,0,0,35,74
50,BIHAR,2010,Unemployed,0,36,28,9,0,73,3,3,6,3,0,15,88
51,BIHAR,2010,Self-employed (Business activity),0,4,6,2,0,12,0,2,2,0,0,4,16
52,BIHAR,2010,Professional Activity,0,2,2,1,0,5,0,0,0,0,0,0,5
53,BIHAR,2010,Farming/Agriculture Activity,0,27,39,20,5,91,0,3,1,0,0,4,95
54,BIHAR,2010,Others (Please Specify),12,49,108,80,15,264,7,17,25,2,0,51,315
55,BIHAR,2010,Retired Person,0,0,0,0,1,1,0,0,0,0,2,2,3
56,BIHAR,2010,Others (Please Specify),16,58,66,17,14,171,28,105,19,21,10,183,354
57,BIHAR,2010,Total,40,228,272,136,36,712,54,227,159,53,21,514,1226
58,BIHAR,2010,Total Salaried,0,31,17,7,1,56,2,4,9,1,0,16,72
59,BIHAR,2010,Total Self-employed,12,82,155,103,20,372,7,22,28,2,0,59,431
60,CHHATTISGARH,2010,House Wife,0,0,0,0,0,0,2,453,286,91,30,862,862
61,CHHATTISGARH,2010,Service (Government),0,8,16,14,0,38,0,1,0,1,0,2,40
62,CHHATTISGARH,2010,Service (Private),0,127,103,55,2,287,0,22,18,2,2,44,331
63,CHHATTISGARH,2010,Public Sector Undertaking,0,16,13,15,0,44,0,0,0,0,0,0,44
64,CHHATTISGARH,2010,Student,47,166,9,1,0,223,24,125,5,0,0,154,377
65,CHHATTISGARH,2010,Unemployed,4,177,306,104,2,593,2,13,4,0,0,19,612
66,CHHATTISGARH,2010,Self-employed (Business activity),0,42,31,18,7,98,0,2,4,0,0,6,104
67,CHHATTISGARH,2010,Professional Activity,0,86,95,40,10,231,0,2,1,1,0,4,235
68,CHHATTISGARH,2010,Farming/Agriculture Activity,3,196,274,219,86,778,2,65,137,103,41,348,1126
69,CHHATTISGARH,2010,Others (Please Specify),0,294,423,411,175,1303,5,93,113,47,26,284,1587
70,CHHATTISGARH,2010,Retired Person,0,0,0,0,1,1,0,0,0,0,0,0,1
71,CHHATTISGARH,2010,Others (Please Specify),56,272,268,225,128,949,23,86,79,47,19,254,1203
72,CHHATTISGARH,2010,Total,110,1384,1538,1102,411,4545,58,862,647,292,118,1977,6522
73,CHHATTISGARH,2010,Total Salaried,0,151,132,84,2,369,0,23,18,3,2,46,415
74,CHHATTISGARH,2010,Total Self-employed,3,618,823,688,278,2410,7,162,255,151,67,642,3052
75,GOA,2010,House Wife,0,0,0,0,0,0,0,14,18,9,11,52,52
76,GOA,2010,Service (Government),0,1,4,4,0,9,0,0,0,0,0,0,9
77,GOA,2010,Service (Private),0,24,31,11,1,67,0,3,0,0,0,3,70
78,GOA,2010,Public Sector Undertaking,0,1,1,0,0,2,0,0,0,0,0,0,2
79,GOA,2010,Student,2,10,1,0,0,13,2,8,0,0,0,10,23
80,GOA,2010,Unemployed,0,15,19,14,3,51,1,7,2,0,0,10,61
81,GOA,2010,Self-employed (Business activity),0,2,4,5,0,11,0,0,0,0,0,0,11
82,GOA,2010,Professional Activity,0,0,0,1,0,1,0,0,0,0,0,0,1
83,GOA,2010,Farming/Agriculture Activity,0,2,3,3,7,15,0,0,0,0,0,0,15
84,GOA,2010,Others (Please Specify),0,5,5,4,4,18,0,0,0,0,0,0,18
85,GOA,2010,Retired Person,0,0,0,0,3,3,0,0,0,0,0,0,3
86,GOA,2010,Others (Please Specify),0,9,13,21,3,46,0,5,1,0,5,11,57
87,GOA,2010,Total,2,69,81,63,21,236,3,37,21,9,16,86,322
88,GOA,2010,Total Salaried,0,26,36,15,1,78,0,3,0,0,0,3,81
89,GOA,2010,Total Self-employed,0,9,12,13,11,45,0,0,0,0,0,0,45
90,GUJARAT,2010,House Wife,0,0,0,0,0,0,2,726,512,253,82,1575,1575
91,GUJARAT,2010,Service (Government),0,17,31,14,0,62,0,6,5,2,0,13,75
92,GUJARAT,2010,Service (Private),0,197,202,116,9,524,0,42,44,11,1,98,622
93,GUJARAT,2010,Public Sector Undertaking,0,23,31,20,3,77,0,11,7,6,0,24,101
94,GUJARAT,2010,Student,19,125,6,1,0,151,18,121,3,0,0,142,293
95,GUJARAT,2010,Unemployed,1,217,231,81,18,548,0,39,17,5,0,61,609
96,GUJARAT,2010,Self-employed (Business activity),1,151,185,70,21,428,6,8,12,11,2,39,467
97,GUJARAT,2010,Professional Activity,2,116,127,63,13,321,0,10,5,4,0,19,340
98,GUJARAT,2010,Farming/Agriculture Activity,1,127,201,104,25,458,1,18,25,17,4,65,523
99,GUJARAT,2010,Others (Please Specify),3,193,203,168,32,599,4,58,34,26,8,130,729
100,GUJARAT,2010,Retired Person,0,2,1,11,85,99,0,0,0,8,44,52,151
101,GUJARAT,2010,Others (Please Specify),10,175,194,110,57,546,11,66,58,24,17,176,722
102,GUJARAT,2010,Total,37,1343,1412,758,263,3813,42,1105,722,367,158,2394,6207
103,GUJARAT,2010,Total Salaried,0,237,264,150,12,663,0,59,56,19,1,135,798
104,GUJARAT,2010,Total Self-employed,7,587,716,405,91,1806,11,94,76,58,14,253,2059
105,HARYANA,2010,House Wife,0,0,0,0,0,0,0,174,124,50,16,364,364
106,HARYANA,2010,Service (Government),0,14,16,10,0,40,0,24,18,3,0,45,85
107,HARYANA,2010,Service (Private),0,78,72,42,2,194,0,18,7,2,0,27,221
108,HARYANA,2010,Public Sector Undertaking,0,8,2,1,0,11,1,4,0,0,0,5,16
109,HARYANA,2010,Student,12,101,6,0,0,119,8,21,0,0,0,29,148
110,HARYANA,2010,Unemployed,3,143,118,67,16,347,0,21,9,4,3,37,384
111,HARYANA,2010,Self-employed (Business activity),0,16,12,16,2,46,0,0,0,0,0,0,46
112,HARYANA,2010,Professional Activity,0,14,17,13,1,45,0,0,0,0,0,0,45
113,HARYANA,2010,Farming/Agriculture Activity,0,94,103,59,25,281,0,9,5,2,0,16,297
114,HARYANA,2010,Others (Please Specify),2,190,183,133,45,553,5,11,20,9,5,50,603
115,HARYANA,2010,Retired Person,0,0,0,0,0,0,0,0,0,0,0,0,0
116,HARYANA,2010,Others (Please Specify),7,181,209,114,31,542,3,38,59,39,5,144,686
117,HARYANA,2010,Total,24,839,738,455,122,2178,17,320,242,109,29,717,2895
118,HARYANA,2010,Total Salaried,0,100,90,53,2,245,1,46,25,5,0,77,322
119,HARYANA,2010,Total Self-employed,2,314,315,221,73,925,5,20,25,11,5,66,991
120,HIMACHAL PRADESH,2010,House Wife,0,0,0,0,0,0,0,44,24,15,5,88,88
121,HIMACHAL PRADESH,2010,Service (Government),0,2,7,11,0,20,0,1,1,1,0,3,23
122,HIMACHAL PRADESH,2010,Service (Private),0,10,17,9,2,38,0,4,2,1,0,7,45
123,HIMACHAL PRADESH,2010,Public Sector Undertaking,0,3,6,2,1,12,0,2,1,2,1,6,18
124,HIMACHAL PRADESH,2010,Student,7,26,0,0,0,33,4,27,2,0,0,33,66
125,HIMACHAL PRADESH,2010,Unemployed,0,24,23,4,1,52,0,2,1,0,0,3,55
126,HIMACHAL PRADESH,2010,Self-employed (Business activity),0,4,5,7,3,19,0,1,2,1,1,5,24
127,HIMACHAL PRADESH,2010,Professional Activity,0,10,4,6,1,21,0,0,1,0,0,1,22
128,HIMACHAL PRADESH,2010,Farming/Agriculture Activity,0,12,24,15,8,59,0,2,0,0,0,2,61
129,HIMACHAL PRADESH,2010,Others (Please Specify),0,14,15,7,1,37,0,7,7,5,3,22,59
130,HIMACHAL PRADESH,2010,Retired Person,0,0,1,4,2,7,0,0,0,0,0,0,7
131,HIMACHAL PRADESH,2010,Others (Please Specify),1,12,23,8,6,50,0,7,10,6,1,24,74
132,HIMACHAL PRADESH,2010,Total,8,117,125,73,25,348,4,97,51,31,11,194,542
133,HIMACHAL PRADESH,2010,Total Salaried,0,15,30,22,3,70,0,7,4,4,1,16,86
134,HIMACHAL PRADESH,2010,Total Self-employed,0,40,48,35,13,136,0,10,10,6,4,30,166
135,JAMMU & KASHMIR,2010,House Wife,0,0,0,0,0,0,0,30,24,4,0,58,58
136,JAMMU & KASHMIR,2010,Service (Government),0,2,2,0,0,4,0,1,1,0,0,2,6
137,JAMMU & KASHMIR,2010,Service (Private),0,1,9,3,0,13,0,0,0,0,0,0,13
138,JAMMU & KASHMIR,2010,Public Sector Undertaking,0,1,1,0,0,2,0,0,0,0,0,0,2
139,JAMMU & KASHMIR,2010,Student,3,11,3,0,0,17,2,12,3,2,0,19,36
140,JAMMU & KASHMIR,2010,Unemployed,0,12,11,4,0,27,1,12,3,0,0,16,43
141,JAMMU & KASHMIR,2010,Self-employed (Business activity),0,1,2,4,2,9,0,0,0,0,0,0,9
142,JAMMU & KASHMIR,2010,Professional Activity,0,2,0,0,0,2,0,0,1,0,0,1,3
143,JAMMU & KASHMIR,2010,Farming/Agriculture Activity,0,3,8,4,1,16,0,2,0,0,0,2,18
144,JAMMU & KASHMIR,2010,Others (Please Specify),0,5,1,3,3,12,0,7,2,0,0,9,21
145,JAMMU & KASHMIR,2010,Retired Person,0,0,0,1,0,1,0,0,0,0,0,0,1
146,JAMMU & KASHMIR,2010,Others (Please Specify),0,8,3,7,1,19,0,22,5,2,1,30,49
147,JAMMU & KASHMIR,2010,Total,3,46,40,26,7,122,3,86,39,8,1,137,259
148,JAMMU & KASHMIR,2010,Total Salaried,0,4,12,3,0,19,0,1,1,0,0,2,21
149,JAMMU & KASHMIR,2010,Total Self-employed,0,11,11,11,6,39,0,9,3,0,0,12,51
150,JHARKHAND,2010,House Wife,0,0,0,0,0,0,1,52,104,51,4,212,212
151,JHARKHAND,2010,Service (Government),0,1,3,4,0,8,0,0,1,1,0,2,10
152,JHARKHAND,2010,Service (Private),0,20,29,28,0,77,0,5,3,2,0,10,87
153,JHARKHAND,2010,Public Sector Undertaking,18,1,2,3,0,24,0,4,0,0,0,4,28
154,JHARKHAND,2010,Student,18,70,4,0,0,92,9,40,1,0,0,50,142
155,JHARKHAND,2010,Unemployed,0,34,41,13,0,88,0,8,4,0,0,12,100
156,JHARKHAND,2010,Self-employed (Business activity),0,8,13,6,0,27,0,2,2,0,0,4,31
157,JHARKHAND,2010,Professional Activity,0,3,4,2,0,9,0,0,0,0,0,0,9
158,JHARKHAND,2010,Farming/Agriculture Activity,10,47,58,30,5,150,0,13,6,4,0,23,173
159,JHARKHAND,2010,Others (Please Specify),2,33,64,31,2,132,0,33,9,15,5,62,194
160,JHARKHAND,2010,Retired Person,0,0,0,0,3,3,0,0,0,0,0,0,3
161,JHARKHAND,2010,Others (Please Specify),36,35,57,55,2,185,6,18,12,7,15,58,243
162,JHARKHAND,2010,Total,84,252,275,172,12,795,16,175,142,80,24,437,1232
163,JHARKHAND,2010,Total Salaried,18,22,34,35,0,109,0,9,4,3,0,16,125
164,JHARKHAND,2010,Total Self-employed,12,91,139,69,7,318,0,48,17,19,5,89,407
165,KARNATAKA,2010,House Wife,0,0,0,0,0,0,2,703,664,361,159,1889,1889
166,KARNATAKA,2010,Service (Government),0,37,60,65,16,178,0,17,17,4,2,40,218
167,KARNATAKA,2010,Service (Private),0,244,377,204,64,889,0,124,71,23,9,227,1116
168,KARNATAKA,2010,Public Sector Undertaking,0,85,79,58,32,254,0,15,12,14,0,41,295
169,KARNATAKA,2010,Student,43,238,9,22,7,319,89,176,7,0,0,272,591
170,KARNATAKA,2010,Unemployed,0,125,122,95,20,362,0,35,21,2,0,58,420
171,KARNATAKA,2010,Self-employed (Business activity),0,234,303,227,81,845,0,13,15,11,4,43,888
172,KARNATAKA,2010,Professional Activity,2,30,34,38,6,110,0,5,7,3,0,15,125
173,KARNATAKA,2010,Farming/Agriculture Activity,3,381,723,751,270,2128,11,159,128,111,48,457,2585
174,KARNATAKA,2010,Others (Please Specify),20,505,761,544,199,2029,27,234,168,161,47,637,2666
175,KARNATAKA,2010,Retired Person,0,0,2,29,60,91,0,0,0,2,7,9,100
176,KARNATAKA,2010,Others (Please Specify),19,191,395,355,242,1202,39,121,138,143,115,556,1758
177,KARNATAKA,2010,Total,87,2070,2865,2388,997,8407,168,1602,1248,835,391,4244,12651
178,KARNATAKA,2010,Total Salaried,0,366,516,327,112,1321,0,156,100,41,11,308,1629
179,KARNATAKA,2010,Total Self-employed,25,1150,1821,1560,556,5112,38,411,318,286,99,1152,6264
180,KERALA,2010,House Wife,0,0,0,0,0,0,0,270,370,349,230,1219,1219
181,KERALA,2010,Service (Government),0,7,28,27,0,62,0,1,5,3,0,9,71
182,KERALA,2010,Service (Private),0,66,149,158,7,380,0,28,33,13,0,74,454
183,KERALA,2010,Public Sector Undertaking,0,23,59,52,2,136,0,4,4,4,0,12,148
184,KERALA,2010,Student,56,72,1,0,0,129,44,140,0,0,0,184,313
185,KERALA,2010,Unemployed,1,162,248,214,207,832,1,52,55,32,70,210,1042
186,KERALA,2010,Self-employed (Business activity),0,57,148,163,96,464,0,1,3,9,2,15,479
187,KERALA,2010,Professional Activity,0,25,56,81,13,175,0,4,5,1,1,11,186
188,KERALA,2010,Farming/Agriculture Activity,0,98,242,264,193,797,0,28,26,14,30,98,895
189,KERALA,2010,Others (Please Specify),4,261,553,629,348,1795,1,43,70,47,31,192,1987
190,KERALA,2010,Retired Person,0,0,2,14,50,66,0,0,1,2,7,10,76
191,KERALA,2010,Others (Please Specify),3,269,487,569,182,1510,0,37,54,70,45,206,1716
192,KERALA,2010,Total,64,1040,1973,2171,1098,6346,46,608,626,544,416,2240,8586
193,KERALA,2010,Total Salaried,0,96,236,237,9,578,0,33,42,20,0,95,673
194,KERALA,2010,Total Self-employed,4,441,999,1137,650,3231,1,76,104,71,64,316,3547
195,MADHYA PRADESH,2010,House Wife,0,0,0,0,0,0,18,1366,815,255,110,2564,2564
196,MADHYA PRADESH,2010,Service (Government),0,19,48,29,6,102,0,3,5,4,0,12,114
197,MADHYA PRADESH,2010,Service (Private),0,149,108,66,21,344,2,24,18,8,6,58,402
198,MADHYA PRADESH,2010,Public Sector Undertaking,0,39,64,15,13,131,0,6,3,2,4,15,146
199,MADHYA PRADESH,2010,Student,73,175,8,12,0,268,51,135,5,0,0,191,459
200,MADHYA PRADESH,2010,Unemployed,10,133,111,42,12,308,8,44,12,2,0,66,374
201,MADHYA PRADESH,2010,Self-employed (Business activity),0,112,145,89,25,371,0,0,0,0,0,0,371
202,MADHYA PRADESH,2010,Professional Activity,0,93,97,73,29,292,3,10,12,3,0,28,320
203,MADHYA PRADESH,2010,Farming/Agriculture Activity,17,282,357,208,109,973,14,132,74,27,17,264,1237
204,MADHYA PRADESH,2010,Others (Please Specify),49,524,464,272,116,1425,36,265,133,68,27,529,1954
205,MADHYA PRADESH,2010,Retired Person,0,0,1,4,6,11,0,5,0,0,0,5,16
206,MADHYA PRADESH,2010,Others (Please Specify),66,264,265,180,87,862,29,85,28,23,19,184,1046
207,MADHYA PRADESH,2010,Total,215,1790,1668,990,424,5087,161,2075,1105,392,183,3916,9003
208,MADHYA PRADESH,2010,Total Salaried,0,207,220,110,40,577,2,33,26,14,10,85,662
209,MADHYA PRADESH,2010,Total Self-employed,66,1011,1063,642,279,3061,53,407,219,98,44,821,3882
210,MAHARASHTRA,2010,House Wife,0,0,0,0,0,0,0,1882,1098,405,254,3639,3639
211,MAHARASHTRA,2010,Service (Government),0,35,78,59,1,173,0,8,1,1,0,10,183
212,MAHARASHTRA,2010,Service (Private),0,559,739,376,40,1714,1,93,34,15,0,143,1857
213,MAHARASHTRA,2010,Public Sector Undertaking,0,40,69,28,6,143,0,3,1,0,0,4,147
214,MAHARASHTRA,2010,Student,46,427,8,1,0,482,82,492,0,0,0,574,1056
215,MAHARASHTRA,2010,Unemployed,0,365,305,108,41,819,2,60,20,6,1,89,908
216,MAHARASHTRA,2010,Self-employed (Business activity),0,143,172,100,24,439,0,3,3,0,0,6,445
217,MAHARASHTRA,2010,Professional Activity,0,265,376,270,129,1040,0,42,22,15,4,83,1123
218,MAHARASHTRA,2010,Farming/Agriculture Activity,0,784,1094,743,326,2947,2,79,68,33,12,194,3141
219,MAHARASHTRA,2010,Others (Please Specify),0,792,1020,586,270,2668,3,134,79,44,23,283,2951
220,MAHARASHTRA,2010,Retired Person,0,0,1,13,99,113,0,0,1,0,3,4,117
221,MAHARASHTRA,2010,Others (Please Specify),3,75,110,79,53,320,5,8,7,5,4,29,349
222,MAHARASHTRA,2010,Total,49,3485,3972,2363,989,10858,95,2804,1334,524,301,5058,15916
223,MAHARASHTRA,2010,Total Salaried,0,634,886,463,47,2030,1,104,36,16,0,157,2187
224,MAHARASHTRA,2010,Total Self-employed,0,1984,2662,1699,749,7094,5,258,172,92,39,566,7660
225,MANIPUR,2010,House Wife,0,0,0,0,0,0,0,6,1,1,0,8,8
226,MANIPUR,2010,Service (Government),0,1,3,2,0,6,0,0,0,0,0,0,6
227,MANIPUR,2010,Service (Private),0,0,0,0,0,0,0,0,0,0,0,0,0
228,MANIPUR,2010,Public Sector Undertaking,0,0,0,0,0,0,0,0,0,0,0,0,0
229,MANIPUR,2010,Student,0,1,0,0,0,1,0,0,0,0,0,0,1
230,MANIPUR,2010,Unemployed,0,4,7,1,0,12,0,0,0,0,0,0,12
231,MANIPUR,2010,Self-employed (Business activity),0,0,0,0,0,0,0,0,0,0,0,0,0
232,MANIPUR,2010,Professional Activity,0,0,0,0,0,0,0,0,0,0,0,0,0
233,MANIPUR,2010,Farming/Agriculture Activity,0,0,0,0,0,0,0,1,3,0,0,4,4
234,MANIPUR,2010,Others (Please Specify),0,0,0,0,0,0,0,0,0,0,0,0,0
235,MANIPUR,2010,Retired Person,0,0,0,0,0,0,0,0,0,0,0,0,0
236,MANIPUR,2010,Others (Please Specify),0,1,3,1,0,5,0,1,0,0,0,1,6
237,MANIPUR,2010,Total,0,7,13,4,0,24,0,8,4,1,0,13,37
238,MANIPUR,2010,Total Salaried,0,1,3,2,0,6,0,0,0,0,0,0,6
239,MANIPUR,2010,Total Self-employed,0,0,0,0,0,0,0,1,3,0,0,4,4
240,MEGHALAYA,2010,House Wife,0,0,0,0,0,0,0,7,5,1,1,14,14
241,MEGHALAYA,2010,Service (Government),0,2,4,2,0,8,0,0,0,0,0,0,8
242,MEGHALAYA,2010,Service (Private),0,6,1,4,0,11,0,0,0,0,0,0,11
243,MEGHALAYA,2010,Public Sector Undertaking,0,1,0,0,0,1,0,0,0,0,0,0,1
244,MEGHALAYA,2010,Student,2,10,2,0,0,14,1,5,1,0,0,7,21
245,MEGHALAYA,2010,Unemployed,0,5,8,2,0,15,0,1,1,0,0,2,17
246,MEGHALAYA,2010,Self-employed (Business activity),0,0,0,0,0,0,0,0,0,0,0,0,0
247,MEGHALAYA,2010,Professional Activity,0,0,1,0,0,1,0,0,0,0,0,0,1
248,MEGHALAYA,2010,Farming/Agriculture Activity,0,5,5,3,2,15,0,0,0,1,0,1,16
249,MEGHALAYA,2010,Others (Please Specify),0,2,0,1,2,5,0,1,1,0,0,2,7
250,MEGHALAYA,2010,Retired Person,0,0,0,0,1,1,0,0,0,0,0,0,1
251,MEGHALAYA,2010,Others (Please Specify),0,6,2,1,0,9,0,1,1,0,0,2,11
252,MEGHALAYA,2010,Total,2,37,23,13,5,80,1,15,9,2,1,28,108
253,MEGHALAYA,2010,Total Salaried,0,9,5,6,0,20,0,0,0,0,0,0,20
254,MEGHALAYA,2010,Total Self-employed,0,7,6,4,4,21,0,1,1,1,0,3,24
255,MIZORAM,2010,House Wife,0,0,0,0,0,0,0,0,0,0,0,0,0
256,MIZORAM,2010,Service (Government),0,10,10,2,1,23,0,4,0,0,0,4,27
257,MIZORAM,2010,Service (Private),2,0,0,0,0,2,0,0,1,0,0,1,3
258,MIZORAM,2010,Public Sector Undertaking,0,0,0,0,0,0,0,0,0,0,0,0,0
259,MIZORAM,2010,Student,2,0,0,0,0,2,0,0,0,0,0,0,2
260,MIZORAM,2010,Unemployed,0,10,5,3,1,19,0,2,0,0,0,2,21
261,MIZORAM,2010,Self-employed (Business activity),0,0,0,0,0,0,0,0,0,0,0,0,0
262,MIZORAM,2010,Professional Activity,0,0,0,0,0,0,0,0,0,0,0,0,0
263,MIZORAM,2010,Farming/Agriculture Activity,0,4,0,1,0,5,0,0,0,0,0,0,5
264,MIZORAM,2010,Others (Please Specify),0,0,0,0,0,0,0,0,0,0,0,0,0
265,MIZORAM,2010,Retired Person,0,0,0,0,0,0,0,0,0,0,0,0,0
266,MIZORAM,2010,Others (Please Specify),0,6,10,0,0,16,0,2,0,0,0,2,18
267,MIZORAM,2010,Total,4,30,25,6,2,67,0,8,1,0,0,9,76
268,MIZORAM,2010,Total Salaried,2,10,10,2,1,25,0,4,1,0,0,5,30
269,MIZORAM,2010,Total Self-employed,0,4,0,1,0,5,0,0,0,0,0,0,5
270,NAGALAND,2010,House Wife,0,0,0,0,0,0,0,1,0,0,0,1,1
271,NAGALAND,2010,Service (Government),0,1,0,1,0,2,0,0,0,0,0,0,2
272,NAGALAND,2010,Service (Private),0,0,0,0,0,0,0,0,0,0,0,0,0
273,NAGALAND,2010,Public Sector Undertaking,0,0,0,0,0,0,0,0,0,0,0,0,0
274,NAGALAND,2010,Student,0,0,2,0,0,2,0,0,0,0,0,0,2
275,NAGALAND,2010,Unemployed,0,2,2,0,0,4,0,0,0,0,0,0,4
276,NAGALAND,2010,Self-employed (Business activity),0,0,0,0,0,0,0,0,0,0,0,0,0
277,NAGALAND,2010,Professional Activity,0,1,2,0,0,3,0,0,0,0,0,0,3
278,NAGALAND,2010,Farming/Agriculture Activity,0,0,0,0,0,0,0,0,0,0,0,0,0
279,NAGALAND,2010,Others (Please Specify),0,0,0,0,0,0,0,0,0,0,0,0,0
280,NAGALAND,2010,Retired Person,0,0,0,0,0,0,0,0,0,0,0,0,0
281,NAGALAND,2010,Others (Please Specify),0,0,0,0,0,0,0,0,0,0,0,0,0
282,NAGALAND,2010,Total,0,4,6,1,0,11,0,1,0,0,0,1,12
283,NAGALAND,2010,Total Salaried,0,1,0,1,0,2,0,0,0,0,0,0,2
284,NAGALAND,2010,Total Self-employed,0,1,2,0,0,3,0,0,0,0,0,0,3
285,ODISHA,2010,House Wife,0,0,0,0,0,0,1,362,232,111,24,730,730
286,ODISHA,2010,Service (Government),0,2,7,2,0,11,0,2,1,1,0,4,15
287,ODISHA,2010,Service (Private),0,74,114,70,11,269,0,30,25,4,4,63,332
288,ODISHA,2010,Public Sector Undertaking,0,57,39,14,0,110,0,13,16,6,0,35,145
289,ODISHA,2010,Student,30,138,5,0,0,173,22,104,2,0,0,128,301
290,ODISHA,2010,Unemployed,11,142,103,36,2,294,7,47,25,7,4,90,384
291,ODISHA,2010,Self-employed (Business activity),0,52,115,70,7,244,0,3,14,2,0,19,263
292,ODISHA,2010,Professional Activity,0,15,34,15,10,74,0,2,3,2,2,9,83
293,ODISHA,2010,Farming/Agriculture Activity,0,17,77,36,15,145,0,0,12,5,0,17,162
294,ODISHA,2010,Others (Please Specify),41,211,244,212,54,762,39,186,154,99,24,502,1264
295,ODISHA,2010,Retired Person,0,0,0,1,23,24,0,0,0,1,2,3,27
296,ODISHA,2010,Others (Please Specify),17,89,104,77,37,324,8,104,70,36,7,225,549
297,ODISHA,2010,Total,99,797,842,533,159,2430,77,853,554,274,67,1825,4255
298,ODISHA,2010,Total Salaried,0,133,160,86,11,390,0,45,42,11,4,102,492
299,ODISHA,2010,Total Self-employed,41,295,470,333,86,1225,39,191,183,108,26,547,1772
300,PUNJAB,2010,House Wife,0,0,0,0,0,0,1,60,48,16,5,130,130
301,PUNJAB,2010,Service (Government),0,5,13,3,0,21,0,2,0,0,0,2,23
302,PUNJAB,2010,Service (Private),2,27,44,7,2,82,0,0,1,0,0,1,83
303,PUNJAB,2010,Public Sector Undertaking,0,0,0,0,0,0,0,0,0,0,0,0,0
304,PUNJAB,2010,Student,4,21,6,0,0,31,1,23,0,0,0,24,55
305,PUNJAB,2010,Unemployed,3,25,23,5,3,59,0,3,1,0,4,8,67
306,PUNJAB,2010,Self-employed (Business activity),0,20,16,4,1,41,0,0,0,0,0,0,41
307,PUNJAB,2010,Professional Activity,0,13,5,3,0,21,0,0,0,0,0,0,21
308,PUNJAB,2010,Farming/Agriculture Activity,0,27,31,12,10,80,0,0,0,0,0,0,80
309,PUNJAB,2010,Others (Please Specify),0,77,77,59,26,239,1,5,3,2,3,14,253
310,PUNJAB,2010,Retired Person,0,0,0,1,7,8,0,0,0,0,0,0,8
311,PUNJAB,2010,Others (Please Specify),1,44,44,33,15,137,0,11,8,3,0,22,159
312,PUNJAB,2010,Total,10,259,259,127,64,719,3,104,61,21,12,201,920
313,PUNJAB,2010,Total Salaried,2,32,57,10,2,103,0,2,1,0,0,3,106
314,PUNJAB,2010,Total Self-employed,0,137,129,78,37,381,1,5,3,2,3,14,395
315,RAJASTHAN,2010,House Wife,0,0,0,0,0,0,19,426,403,161,25,1034,1034
316,RAJASTHAN,2010,Service (Government),0,5,20,11,0,36,0,0,6,0,0,6,42
317,RAJASTHAN,2010,Service (Private),0,135,149,97,22,403,0,16,7,5,0,28,431
318,RAJASTHAN,2010,Public Sector Undertaking,0,8,10,13,3,34,0,3,3,0,0,6,40
319,RAJASTHAN,2010,Student,19,118,7,0,0,144,12,75,1,1,0,89,233
320,RAJASTHAN,2010,Unemployed,0,78,66,24,4,172,0,9,11,7,0,27,199
321,RAJASTHAN,2010,Self-employed (Business activity),0,55,89,26,6,176,0,2,2,1,0,5,181
322,RAJASTHAN,2010,Professional Activity,0,14,39,2,6,61,0,2,1,1,0,4,65
323,RAJASTHAN,2010,Farming/Agriculture Activity,2,114,146,66,23,351,0,20,13,6,0,39,390
324,RAJASTHAN,2010,Others (Please Specify),2,226,386,261,41,916,5,56,20,11,3,95,1011
325,RAJASTHAN,2010,Retired Person,0,14,7,9,5,35,0,6,0,0,0,6,41
326,RAJASTHAN,2010,Others (Please Specify),67,326,369,229,46,1037,31,86,63,28,8,216,1253
327,RAJASTHAN,2010,Total,90,1093,1288,738,156,3365,67,701,530,221,36,1555,4920
328,RAJASTHAN,2010,Total Salaried,0,148,179,121,25,473,0,19,16,5,0,40,513
329,RAJASTHAN,2010,Total Self-employed,4,409,660,355,76,1504,5,80,36,19,3,143,1647
330,SIKKIM,2010,House Wife,0,0,0,0,0,0,0,2,1,1,1,5,5
331,SIKKIM,2010,Service (Government),0,17,11,1,0,29,0,1,5,0,0,6,35
332,SIKKIM,2010,Service (Private),9,23,17,1,2,52,0,1,2,0,0,3,55
333,SIKKIM,2010,Public Sector Undertaking,0,11,7,3,0,21,0,5,5,0,0,10,31
334,SIKKIM,2010,Student,0,2,0,0,0,2,0,1,0,0,0,1,3
335,SIKKIM,2010,Unemployed,11,13,12,7,2,45,0,2,5,0,0,7,52
336,SIKKIM,2010,Self-employed (Business activity),0,11,10,0,2,23,0,0,0,1,0,1,24
337,SIKKIM,2010,Professional Activity,0,9,9,0,3,21,0,0,0,1,0,1,22
338,SIKKIM,2010,Farming/Agriculture Activity,1,5,5,7,1,19,0,0,0,0,0,0,19
339,SIKKIM,2010,Others (Please Specify),0,7,0,0,0,7,0,0,1,0,0,1,8
340,SIKKIM,2010,Retired Person,0,0,0,0,3,3,0,0,0,0,2,2,5
341,SIKKIM,2010,Others (Please Specify),0,0,0,11,2,13,0,1,0,7,0,8,21
342,SIKKIM,2010,Total,21,98,71,30,15,235,0,13,19,10,3,45,280
343,SIKKIM,2010,Total Salaried,9,51,35,5,2,102,0,7,12,0,0,19,121
344,SIKKIM,2010,Total Self-employed,1,32,24,7,6,70,0,0,1,2,0,3,73
345,TAMIL NADU,2010,House Wife,0,0,0,0,0,0,3,935,984,520,225,2667,2667
346,TAMIL NADU,2010,Service (Government),0,21,40,61,0,122,0,18,23,16,1,58,180
347,TAMIL NADU,2010,Service (Private),1,383,609,384,53,1430,0,152,84,67,2,305,1735
348,TAMIL NADU,2010,Public Sector Undertaking,0,53,122,78,11,264,0,28,37,12,0,77,341
349,TAMIL NADU,2010,Student,99,254,6,0,0,359,65,208,5,0,0,278,637
350,TAMIL NADU,2010,Unemployed,3,418,577,360,169,1527,3,289,136,90,27,545,2072
351,TAMIL NADU,2010,Self-employed (Business activity),0,212,314,273,62,861,6,85,77,32,19,219,1080
352,TAMIL NADU,2010,Professional Activity,0,53,86,50,23,212,5,16,18,10,2,51,263
353,TAMIL NADU,2010,Farming/Agriculture Activity,13,137,131,103,58,442,0,65,25,6,3,99,541
354,TAMIL NADU,2010,Others (Please Specify),60,695,590,376,229,1950,19,296,262,113,77,767,2717
355,TAMIL NADU,2010,Retired Person,0,0,0,35,77,112,0,0,0,5,15,20,132
356,TAMIL NADU,2010,Others (Please Specify),23,740,1037,859,614,3273,84,412,143,158,126,923,4196
357,TAMIL NADU,2010,Total,199,2966,3512,2579,1296,10552,185,2504,1794,1029,497,6009,16561
358,TAMIL NADU,2010,Total Salaried,1,457,771,523,64,1816,0,198,144,95,3,440,2256
359,TAMIL NADU,2010,Total Self-employed,73,1097,1121,802,372,3465,30,462,382,161,101,1136,4601
360,TRIPURA,2010,House Wife,0,0,0,0,0,0,1,72,64,34,23,194,194
361,TRIPURA,2010,Service (Government),0,2,8,8,0,18,0,0,0,1,0,1,19
362,TRIPURA,2010,Service (Private),0,14,5,6,5,30,0,0,0,0,0,0,30
363,TRIPURA,2010,Public Sector Undertaking,0,0,0,0,0,0,0,0,0,0,0,0,0
364,TRIPURA,2010,Student,15,57,2,0,0,74,14,16,2,0,0,32,106
365,TRIPURA,2010,Unemployed,0,4,3,14,14,35,0,0,0,0,6,6,41
366,TRIPURA,2010,Self-employed (Business activity),0,15,42,6,12,75,0,3,4,5,0,12,87
367,TRIPURA,2010,Professional Activity,0,5,17,5,3,30,0,0,0,0,0,0,30
368,TRIPURA,2010,Farming/Agriculture Activity,0,11,15,17,3,46,0,1,4,7,0,12,58
369,TRIPURA,2010,Others (Please Specify),1,19,50,34,18,122,3,16,6,2,0,27,149
370,TRIPURA,2010,Retired Person,0,0,0,1,10,11,0,0,0,0,0,0,11
371,TRIPURA,2010,Others (Please Specify),0,0,0,0,0,0,0,0,0,0,0,0,0
372,TRIPURA,2010,Total,16,127,142,91,65,441,18,108,80,49,29,284,725
373,TRIPURA,2010,Total Salaried,0,16,13,14,5,48,0,0,0,1,0,1,49
374,TRIPURA,2010,Total Self-employed,1,50,124,62,36,273,3,20,14,14,0,51,324
375,UTTAR PRADESH,2010,House Wife,0,0,0,0,0,0,8,480,350,105,62,1005,1005
376,UTTAR PRADESH,2010,Service (Government),0,14,16,7,1,38,0,60,9,6,0,75,113
377,UTTAR PRADESH,2010,Service (Private),0,90,51,42,5,188,4,37,20,8,1,70,258
378,UTTAR PRADESH,2010,Public Sector Undertaking,0,5,7,4,0,16,0,3,2,1,0,6,22
379,UTTAR PRADESH,2010,Student,13,131,10,2,0,156,29,132,0,0,0,161,317
380,UTTAR PRADESH,2010,Unemployed,5,95,88,32,12,232,0,23,24,9,0,56,288
381,UTTAR PRADESH,2010,Self-employed (Business activity),0,50,60,45,29,184,0,5,2,0,0,7,191
382,UTTAR PRADESH,2010,Professional Activity,0,32,21,9,5,67,0,0,0,0,0,0,67
383,UTTAR PRADESH,2010,Farming/Agriculture Activity,2,110,171,116,33,432,4,54,31,19,8,116,548
384,UTTAR PRADESH,2010,Others (Please Specify),6,109,123,46,30,314,9,124,59,22,7,221,535
385,UTTAR PRADESH,2010,Retired Person,0,0,0,4,8,12,0,1,0,2,1,4,16
386,UTTAR PRADESH,2010,Others (Please Specify),20,36,33,40,19,148,4,108,8,0,0,120,268
387,UTTAR PRADESH,2010,Total,46,672,580,347,142,1787,58,1027,505,172,79,1841,3628
388,UTTAR PRADESH,2010,Total Salaried,0,109,74,53,6,242,4,100,31,15,1,151,393
389,UTTAR PRADESH,2010,Total Self-employed,8,301,375,216,97,997,13,183,92,41,15,344,1341
390,UTTARAKHAND,2010,House Wife,0,0,0,0,0,0,0,28,18,6,2,54,54
391,UTTARAKHAND,2010,Service (Government),0,4,6,1,0,11,0,1,2,0,0,3,14
392,UTTARAKHAND,2010,Service (Private),0,7,10,4,0,21,0,3,0,0,0,3,24
393,UTTARAKHAND,2010,Public Sector Undertaking,0,0,0,0,0,0,0,1,0,0,0,1,1
394,UTTARAKHAND,2010,Student,2,8,0,0,0,10,4,20,0,0,0,24,34
395,UTTARAKHAND,2010,Unemployed,0,14,0,5,0,19,0,1,2,0,0,3,22
396,UTTARAKHAND,2010,Self-employed (Business activity),2,4,6,2,1,15,0,0,0,0,0,0,15
397,UTTARAKHAND,2010,Professional Activity,0,0,1,0,0,1,0,0,0,0,0,0,1
398,UTTARAKHAND,2010,Farming/Agriculture Activity,0,8,14,7,4,33,0,4,2,0,0,6,39
399,UTTARAKHAND,2010,Others (Please Specify),0,8,9,5,4,26,0,4,3,1,0,8,34
400,UTTARAKHAND,2010,Retired Person,0,0,0,3,0,3,0,0,0,0,0,0,3
401,UTTARAKHAND,2010,Others (Please Specify),0,9,11,2,3,25,3,7,3,2,0,15,40
402,UTTARAKHAND,2010,Total,4,62,57,29,12,164,7,69,30,9,2,117,281
403,UTTARAKHAND,2010,Total Salaried,0,11,16,5,0,32,0,5,2,0,0,7,39
404,UTTARAKHAND,2010,Total Self-employed,2,20,30,14,9,75,0,8,5,1,0,14,89
405,WEST BENGAL,2010,House Wife,0,0,0,0,0,0,0,1271,1123,459,75,2928,2928
406,WEST BENGAL,2010,Service (Government),0,17,84,39,1,141,0,4,7,8,0,19,160
407,WEST BENGAL,2010,Service (Private),0,143,243,253,7,646,0,64,69,19,5,157,803
408,WEST BENGAL,2010,Public Sector Undertaking,0,83,264,195,2,544,0,57,44,12,11,124,668
409,WEST BENGAL,2010,Student,108,398,35,3,0,544,97,280,23,5,0,405,949
410,WEST BENGAL,2010,Unemployed,0,304,382,75,3,764,0,114,127,23,1,265,1029
411,WEST BENGAL,2010,Self-employed (Business activity),0,241,329,260,21,851,0,7,24,6,0,37,888
412,WEST BENGAL,2010,Professional Activity,0,56,232,102,11,401,0,31,53,10,6,100,501
413,WEST BENGAL,2010,Farming/Agriculture Activity,2,218,389,164,27,800,0,63,53,57,20,193,993
414,WEST BENGAL,2010,Others (Please Specify),70,634,932,627,214,2477,33,416,508,311,74,1342,3819
415,WEST BENGAL,2010,Retired Person,0,0,0,0,55,55,0,0,0,0,11,11,66
416,WEST BENGAL,2010,Others (Please Specify),88,582,605,586,217,2078,82,319,346,321,87,1155,3233
417,WEST BENGAL,2010,Total,268,2676,3495,2304,558,9301,212,2626,2377,1231,290,6736,16037
418,WEST BENGAL,2010,Total Salaried,0,243,591,487,10,1331,0,125,120,39,16,300,1631
419,WEST BENGAL,2010,Total Self-employed,72,1149,1882,1153,273,4529,33,517,638,384,100,1672,6201
420,TOTAL (STATES),2010,House Wife,0,0,0,0,0,0,58,10725,8389,3749,1608,24529,24529
421,TOTAL (STATES),2010,Service (Government),0,297,627,441,26,1391,0,198,144,52,3,397,1788
422,TOTAL (STATES),2010,Service (Private),14,2774,3485,2150,274,8697,9,737,484,192,39,1461,10158
423,TOTAL (STATES),2010,Public Sector Undertaking,18,635,1011,623,124,2411,1,170,176,74,16,437,2848
424,TOTAL (STATES),2010,Student,697,3045,136,42,7,3927,672,2483,68,8,0,3231,7158
425,TOTAL (STATES),2010,Unemployed,52,2828,3079,1440,531,7930,28,827,536,192,116,1699,9629
426,TOTAL (STATES),2010,Self-employed (Business activity),3,1874,2541,1680,453,6551,12,216,191,100,31,550,7101
427,TOTAL (STATES),2010,Professional Activity,4,989,1379,840,286,3498,8,137,133,53,16,347,3845
428,TOTAL (STATES),2010,Farming/Agriculture Activity,58,3411,5069,3608,1415,13561,46,889,759,453,225,2372,15933
429,TOTAL (STATES),2010,Others (Please Specify),313,6009,7650,5498,2233,21703,234,2445,1947,1139,448,6213,27916
430,TOTAL (STATES),2010,Retired Person,0,16,17,141,562,736,0,12,2,31,101,146,882
431,TOTAL (STATES),2010,Others (Please Specify),456,3935,4907,4050,1934,15282,393,1856,1353,1022,533,5157,20439
432,TOTAL (STATES),2010,Total,1615,25813,29901,20513,7845,85687,1461,20695,14182,7065,3136,46539,132226
433,TOTAL (STATES),2010,Total Salaried,32,3706,5123,3214,424,12499,10,1105,804,318,58,2295,14794
434,TOTAL (STATES),2010,Total Self-employed,378,12283,16639,11626,4387,45313,300,3687,3030,1745,720,9482,54795
435,A & N ISLANDS,2010,House Wife,0,0,0,0,0,0,0,15,11,2,3,31,31
436,A & N ISLANDS,2010,Service (Government),0,3,8,7,0,18,0,1,0,0,0,1,19
437,A & N ISLANDS,2010,Service (Private),0,16,19,10,3,48,0,2,0,0,0,2,50
438,A & N ISLANDS,2010,Public Sector Undertaking,0,0,0,0,0,0,0,0,0,0,0,0,0
439,A & N ISLANDS,2010,Student,4,4,0,0,0,8,0,6,0,0,0,6,14
440,A & N ISLANDS,2010,Unemployed,0,13,0,0,0,13,0,4,0,0,0,4,17
441,A & N ISLANDS,2010,Self-employed (Business activity),0,1,3,1,1,6,0,0,0,0,0,0,6
442,A & N ISLANDS,2010,Professional Activity,0,0,0,0,0,0,0,0,0,0,0,0,0
443,A & N ISLANDS,2010,Farming/Agriculture Activity,0,1,2,0,5,8,0,0,0,0,0,0,8
444,A & N ISLANDS,2010,Others (Please Specify),0,0,1,0,1,2,0,0,0,0,0,0,2
445,A & N ISLANDS,2010,Retired Person,0,0,0,0,8,8,0,0,0,0,0,0,8
446,A & N ISLANDS,2010,Others (Please Specify),0,1,0,0,0,1,0,0,0,0,0,0,1
447,A & N ISLANDS,2010,Total,4,39,33,18,18,112,0,28,11,2,3,44,156
448,A & N ISLANDS,2010,Total Salaried,0,19,27,17,3,66,0,3,0,0,0,3,69
449,A & N ISLANDS,2010,Total Self-employed,0,2,6,1,7,16,0,0,0,0,0,0,16
450,CHANDIGARH,2010,House Wife,0,0,0,0,0,0,0,6,10,2,1,19,19
451,CHANDIGARH,2010,Service (Government),0,1,2,0,0,3,0,1,0,0,0,1,4
452,CHANDIGARH,2010,Service (Private),0,4,4,2,0,10,0,0,0,0,0,0,10
453,CHANDIGARH,2010,Public Sector Undertaking,0,1,0,1,0,2,0,0,0,0,0,0,2
454,CHANDIGARH,2010,Student,0,4,0,0,0,4,1,9,0,0,0,10,14
455,CHANDIGARH,2010,Unemployed,0,4,1,0,0,5,0,3,0,0,0,3,8
456,CHANDIGARH,2010,Self-employed (Business activity),0,0,1,0,0,1,0,0,0,0,0,0,1
457,CHANDIGARH,2010,Professional Activity,0,0,0,0,0,0,0,0,0,0,0,0,0
458,CHANDIGARH,2010,Farming/Agriculture Activity,0,0,0,0,0,0,0,0,0,0,0,0,0
459,CHANDIGARH,2010,Others (Please Specify),0,0,4,1,0,5,1,5,0,0,0,6,11
460,CHANDIGARH,2010,Retired Person,0,0,0,0,1,1,0,0,0,0,0,0,1
461,CHANDIGARH,2010,Others (Please Specify),0,0,0,0,0,0,0,1,0,0,0,1,1
462,CHANDIGARH,2010,Total,0,14,12,4,1,31,2,25,10,2,1,40,71
463,CHANDIGARH,2010,Total Salaried,0,6,6,3,0,15,0,1,0,0,0,1,16
464,CHANDIGARH,2010,Total Self-employed,0,0,5,1,0,6,1,5,0,0,0,6,12
465,D & N HAVELI,2010,House Wife,0,0,0,0,0,0,0,15,4,4,0,23,23
466,D & N HAVELI,2010,Service (Government),0,1,0,0,0,1,0,0,0,0,0,0,1
467,D & N HAVELI,2010,Service (Private),0,6,5,1,0,12,0,0,0,0,0,0,12
468,D & N HAVELI,2010,Public Sector Undertaking,0,0,0,0,0,0,0,0,0,0,0,0,0
469,D & N HAVELI,2010,Student,0,0,0,0,0,0,0,3,0,0,0,3,3
470,D & N HAVELI,2010,Unemployed,0,0,0,0,0,0,0,0,0,0,0,0,0
471,D & N HAVELI,2010,Self-employed (Business activity),0,0,0,0,0,0,0,0,0,0,0,0,0
472,D & N HAVELI,2010,Professional Activity,0,0,0,0,0,0,0,0,0,0,0,0,0
473,D & N HAVELI,2010,Farming/Agriculture Activity,0,2,5,3,0,10,0,0,0,0,0,0,10
474,D & N HAVELI,2010,Others (Please Specify),0,1,0,0,0,1,0,0,0,0,0,0,1
475,D & N HAVELI,2010,Retired Person,0,0,0,0,0,0,0,0,0,0,0,0,0
476,D & N HAVELI,2010,Others (Please Specify),0,4,2,2,5,13,0,0,0,0,0,0,13
477,D & N HAVELI,2010,Total,0,14,12,6,5,37,0,18,4,4,0,26,63
478,D & N HAVELI,2010,Total Salaried,0,7,5,1,0,13,0,0,0,0,0,0,13
479,D & N HAVELI,2010,Total Self-employed,0,3,5,3,0,11,0,0,0,0,0,0,11
480,DAMAN & DIU,2010,House Wife,0,0,0,0,0,0,0,6,2,0,0,8,8
481,DAMAN & DIU,2010,Service (Government),0,0,1,0,0,1,0,0,0,0,0,0,1
482,DAMAN & DIU,2010,Service (Private),0,4,5,1,0,10,0,1,0,0,0,1,11
483,DAMAN & DIU,2010,Public Sector Undertaking,0,0,0,0,0,0,0,0,0,0,0,0,0
484,DAMAN & DIU,2010,Student,3,2,0,0,0,5,0,1,0,0,0,1,6
485,DAMAN & DIU,2010,Unemployed,0,0,0,0,0,0,0,0,0,0,0,0,0
486,DAMAN & DIU,2010,Self-employed (Business activity),0,0,0,0,0,0,0,0,0,0,0,0,0
487,DAMAN & DIU,2010,Professional Activity,0,0,0,0,0,0,0,0,0,0,0,0,0
488,DAMAN & DIU,2010,Farming/Agriculture Activity,0,0,0,0,0,0,0,0,0,0,0,0,0
489,DAMAN & DIU,2010,Others (Please Specify),0,0,0,0,0,0,0,0,0,0,0,0,0
490,DAMAN & DIU,2010,Retired Person,0,0,0,0,0,0,0,0,0,0,0,0,0
491,DAMAN & DIU,2010,Others (Please Specify),0,2,0,1,0,3,0,2,0,0,0,2,5
492,DAMAN & DIU,2010,Total,3,8,6,2,0,19,0,10,2,0,0,12,31
493,DAMAN & DIU,2010,Total Salaried,0,4,6,1,0,11,0,1,0,0,0,1,12
494,DAMAN & DIU,2010,Total Self-employed,0,0,0,0,0,0,0,0,0,0,0,0,0
495,DELHI (UT),2010,House Wife,0,0,0,0,0,0,0,197,117,31,7,352,352
496,DELHI (UT),2010,Service (Government),0,2,7,6,0,15,0,3,0,0,0,3,18
497,DELHI (UT),2010,Service (Private),0,90,78,22,11,201,0,18,3,1,0,22,223
498,DELHI (UT),2010,Public Sector Undertaking,0,12,23,4,0,39,0,5,0,0,0,5,44
499,DELHI (UT),2010,Student,11,75,1,0,0,87,18,56,3,2,0,79,166
500,DELHI (UT),2010,Unemployed,0,102,88,30,16,236,3,32,8,0,0,43,279
501,DELHI (UT),2010,Self-employed (Business activity),0,13,11,8,0,32,0,0,0,0,0,0,32
502,DELHI (UT),2010,Professional Activity,0,1,2,0,0,3,0,0,1,0,0,1,4
503,DELHI (UT),2010,Farming/Agriculture Activity,0,2,5,2,0,9,0,0,0,0,0,0,9
504,DELHI (UT),2010,Others (Please Specify),0,63,69,34,10,176,0,29,6,1,1,37,213
505,DELHI (UT),2010,Retired Person,0,0,0,0,4,4,0,0,0,0,0,0,4
506,DELHI (UT),2010,Others (Please Specify),5,69,55,24,6,159,3,23,12,1,1,40,199
507,DELHI (UT),2010,Total,16,429,339,130,47,961,24,363,150,36,9,582,1543
508,DELHI (UT),2010,Total Salaried,0,104,108,32,11,255,0,26,3,1,0,30,285
509,DELHI (UT),2010,Total Self-employed,0,79,87,44,10,220,0,29,7,1,1,38,258
510,LAKSHADWEEP,2010,House Wife,0,0,0,0,0,0,0,0,1,0,0,1,1
511,LAKSHADWEEP,2010,Service (Government),0,0,0,0,0,0,0,0,0,0,0,0,0
512,LAKSHADWEEP,2010,Service (Private),0,0,0,0,0,0,0,0,0,0,0,0,0
513,LAKSHADWEEP,2010,Public Sector Undertaking,0,0,0,0,0,0,0,0,0,0,0,0,0
514,LAKSHADWEEP,2010,Student,0,0,0,0,0,0,0,0,0,0,0,0,0
515,LAKSHADWEEP,2010,Unemployed,0,0,0,0,0,0,0,0,0,0,0,0,0
516,LAKSHADWEEP,2010,Self-employed (Business activity),0,0,0,0,0,0,0,0,0,0,0,0,0
517,LAKSHADWEEP,2010,Professional Activity,0,0,0,0,0,0,0,0,0,0,0,0,0
518,LAKSHADWEEP,2010,Farming/Agriculture Activity,0,0,0,0,0,0,0,0,0,0,0,0,0
519,LAKSHADWEEP,2010,Others (Please Specify),0,0,0,0,0,0,0,0,0,0,0,0,0
520,LAKSHADWEEP,2010,Retired Person,0,0,0,0,0,0,0,0,0,0,0,0,0
521,LAKSHADWEEP,2010,Others (Please Specify),0,0,0,0,0,0,0,0,0,0,0,0,0
522,LAKSHADWEEP,2010,Total,0,0,0,0,0,0,0,0,1,0,0,1,1
523,LAKSHADWEEP,2010,Total Salaried,0,0,0,0,0,0,0,0,0,0,0,0,0
524,LAKSHADWEEP,2010,Total Self-employed,0,0,0,0,0,0,0,0,0,0,0,0,0
525,PUDUCHERRY,2010,House Wife,0,0,0,0,0,0,0,44,30,10,11,95,95
526,PUDUCHERRY,2010,Service (Government),0,1,4,2,1,8,0,2,1,0,0,3,11
527,PUDUCHERRY,2010,Service (Private),0,10,9,2,0,21,0,12,5,0,0,17,38
528,PUDUCHERRY,2010,Public Sector Undertaking,0,0,2,2,0,4,0,0,2,0,0,2,6
529,PUDUCHERRY,2010,Student,2,4,0,0,0,6,2,10,0,0,0,12,18
530,PUDUCHERRY,2010,Unemployed,0,17,14,13,16,60,0,29,4,0,7,40,100
531,PUDUCHERRY,2010,Self-employed (Business activity),0,3,8,3,0,14,0,0,0,0,0,0,14
532,PUDUCHERRY,2010,Professional Activity,0,34,98,68,5,205,0,2,0,2,1,5,210
533,PUDUCHERRY,2010,Farming/Agriculture Activity,0,0,1,3,0,4,0,0,0,0,0,0,4
534,PUDUCHERRY,2010,Others (Please Specify),0,1,5,2,0,8,1,0,0,0,0,1,9
535,PUDUCHERRY,2010,Retired Person,0,0,0,0,3,3,0,0,0,0,0,0,3
536,PUDUCHERRY,2010,Others (Please Specify),0,0,0,0,0,0,0,0,0,0,0,0,0
537,PUDUCHERRY,2010,Total,2,70,141,95,25,333,3,99,42,12,19,175,508
538,PUDUCHERRY,2010,Total Salaried,0,11,15,6,1,33,0,14,8,0,0,22,55
539,PUDUCHERRY,2010,Total Self-employed,0,38,112,76,5,231,1,2,0,2,1,6,237
540,TOTAL (UTs),2010,House Wife,0,0,0,0,0,0,0,283,175,49,22,529,529
541,TOTAL (UTs),2010,Service (Government),0,8,22,15,1,46,0,7,1,0,0,8,54
542,TOTAL (UTs),2010,Service (Private),0,130,120,38,14,302,0,33,8,1,0,42,344
543,TOTAL (UTs),2010,Public Sector Undertaking,0,13,25,7,0,45,0,5,2,0,0,7,52
544,TOTAL (UTs),2010,Student,20,89,1,0,0,110,21,85,3,2,0,111,221
545,TOTAL (UTs),2010,Unemployed,0,136,103,43,32,314,3,68,12,0,7,90,404
546,TOTAL (UTs),2010,Self-employed (Business activity),0,17,23,12,1,53,0,0,0,0,0,0,53
547,TOTAL (UTs),2010,Professional Activity,0,35,100,68,5,208,0,2,1,2,1,6,214
548,TOTAL (UTs),2010,Farming/Agriculture Activity,0,5,13,8,5,31,0,0,0,0,0,0,31
549,TOTAL (UTs),2010,Others (Please Specify),0,65,79,37,11,192,2,34,6,1,1,44,236
550,TOTAL (UTs),2010,Retired Person,0,0,0,0,16,16,0,0,0,0,0,0,16
551,TOTAL (UTs),2010,Others (Please Specify),5,76,57,27,11,176,3,26,12,1,1,43,219
552,TOTAL (UTs),2010,Total,25,574,543,255,96,1493,29,543,220,56,32,880,2373
553,TOTAL (UTs),2010,Total Salaried,0,151,167,60,15,393,0,45,11,1,0,57,450
554,TOTAL (UTs),2010,Total Self-employed,0,122,215,125,22,484,2,36,7,3,2,50,534
555,TOTAL (ALL INDIA),2010,House Wife,0,0,0,0,0,0,58,11008,8564,3798,1630,25058,25058
556,TOTAL (ALL INDIA),2010,Service (Government),0,305,649,456,27,1437,0,205,145,52,3,405,1842
557,TOTAL (ALL INDIA),2010,Service (Private),14,2904,3605,2188,288,8999,9,770,492,193,39,1503,10502
558,TOTAL (ALL INDIA),2010,Public Sector Undertaking,18,648,1036,630,124,2456,1,175,178,74,16,444,2900
559,TOTAL (ALL INDIA),2010,Student,717,3134,137,42,7,4037,693,2568,71,10,0,3342,7379
560,TOTAL (ALL INDIA),2010,Unemployed,52,2964,3182,1483,563,8244,31,895,548,192,123,1789,10033
561,TOTAL (ALL INDIA),2010,Self-employed (Business activity),3,1891,2564,1692,454,6604,12,216,191,100,31,550,7154
562,TOTAL (ALL INDIA),2010,Professional Activity,4,1024,1479,908,291,3706,8,139,134,55,17,353,4059
563,TOTAL (ALL INDIA),2010,Farming/Agriculture Activity,58,3416,5082,3616,1420,13592,46,889,759,453,225,2372,15964
564,TOTAL (ALL INDIA),2010,Others (Please Specify),313,6074,7729,5535,2244,21895,236,2479,1953,1140,449,6257,28152
565,TOTAL (ALL INDIA),2010,Retired Person,0,16,17,141,578,752,0,12,2,31,101,146,898
566,TOTAL (ALL INDIA),2010,Others (Please Specify),461,4011,4964,4077,1945,15458,396,1882,1365,1023,534,5200,20658
567,TOTAL (ALL INDIA),2010,Total,1640,26387,30444,20768,7941,87180,1490,21238,14402,7121,3168,47419,134599
568,TOTAL (ALL INDIA),2010,Total Salaried,32,3857,5290,3274,439,12892,10,1150,815,319,58,2352,15244
569,TOTAL (ALL INDIA),2010,Total Self-employed,378,12405,16854,11751,4409,45797,302,3723,3037,1748,722,9532,55329
0,ANDHRA PRADESH,2011,House Wife,0,0,0,0,0,0,1,1007,832,332,116,2288,2288
1,ANDHRA PRADESH,2011,Service (Government),0,12,41,36,0,89,0,10,8,2,0,20,109
2,ANDHRA PRADESH,2011,Service (Private),0,311,543,419,114,1387,0,91,104,36,12,243,1630
3,ANDHRA PRADESH,2011,Public Sector Undertaking,0,99,83,81,25,288,0,22,51,3,3,79,367
4,ANDHRA PRADESH,2011,Student,45,235,7,0,0,287,59,216,1,0,0,276,563
5,ANDHRA PRADESH,2011,Unemployed,0,181,248,98,8,535,0,59,30,14,4,107,642
6,ANDHRA PRADESH,2011,Self-employed (Business activity),0,275,311,263,112,961,0,69,39,22,3,133,1094
7,ANDHRA PRADESH,2011,Professional Activity,0,116,123,76,25,340,0,21,11,9,11,52,392
8,ANDHRA PRADESH,2011,Farming/Agriculture Activity,5,463,670,541,143,1822,3,202,102,67,10,384,2206
9,ANDHRA PRADESH,2011,Others (Please Specify),34,707,903,559,280,2483,47,342,221,105,98,813,3296
10,ANDHRA PRADESH,2011,Retired Person,0,0,0,5,30,35,0,0,0,1,5,6,41
11,ANDHRA PRADESH,2011,Others (Please Specify),28,429,622,632,182,1893,33,245,156,72,50,556,2449
12,ANDHRA PRADESH,2011,Total,112,2828,3551,2710,919,10120,143,2284,1555,663,312,4957,15077
13,ANDHRA PRADESH,2011,Total Salaried,0,422,667,536,139,1764,0,123,163,41,15,342,2106
14,ANDHRA PRADESH,2011,Total Self-employed,39,1561,2007,1439,560,5606,50,634,373,203,122,1382,6988
15,ARUNACHAL PRADESH,2011,House Wife,0,0,0,0,0,0,0,11,8,1,1,21,21
16,ARUNACHAL PRADESH,2011,Service (Government),0,2,9,5,0,16,0,0,0,0,0,0,16
17,ARUNACHAL PRADESH,2011,Service (Private),0,9,4,1,1,15,0,0,0,0,0,0,15
18,ARUNACHAL PRADESH,2011,Public Sector Undertaking,0,2,3,4,0,9,0,0,0,0,0,0,9
19,ARUNACHAL PRADESH,2011,Student,3,7,0,0,0,10,1,4,0,0,0,5,15
20,ARUNACHAL PRADESH,2011,Unemployed,0,5,2,0,0,7,1,2,0,0,0,3,10
21,ARUNACHAL PRADESH,2011,Self-employed (Business activity),0,5,1,3,0,9,0,0,0,0,0,0,9
22,ARUNACHAL PRADESH,2011,Professional Activity,0,0,0,0,0,0,0,0,0,0,0,0,0
23,ARUNACHAL PRADESH,2011,Farming/Agriculture Activity,0,4,4,3,1,12,0,1,0,0,0,1,13
24,ARUNACHAL PRADESH,2011,Others (Please Specify),1,4,4,4,0,13,3,1,1,0,0,5,18
25,ARUNACHAL PRADESH,2011,Retired Person,0,0,0,0,1,1,0,0,0,0,0,0,1
26,ARUNACHAL PRADESH,2011,Others (Please Specify),0,0,7,0,0,7,0,0,0,0,0,0,7
27,ARUNACHAL PRADESH,2011,Total,4,38,34,20,3,99,5,19,9,1,1,35,134
28,ARUNACHAL PRADESH,2011,Total Salaried,0,13,16,10,1,40,0,0,0,0,0,0,40
29,ARUNACHAL PRADESH,2011,Total Self-employed,1,13,9,10,1,34,3,2,1,0,0,6,40
30,ASSAM,2011,House Wife,0,0,0,0,0,0,0,175,214,92,9,490,490
31,ASSAM,2011,Service (Government),0,5,13,9,0,27,0,0,1,0,0,1,28
32,ASSAM,2011,Service (Private),0,26,44,16,0,86,0,0,8,4,0,12,98
33,ASSAM,2011,Public Sector Undertaking,0,17,52,22,0,91,1,4,2,1,0,8,99
34,ASSAM,2011,Student,8,152,0,0,0,160,3,81,8,0,0,92,252
35,ASSAM,2011,Unemployed,0,7,15,21,5,48,0,6,5,0,0,11,59
36,ASSAM,2011,Self-employed (Business activity),0,107,110,63,1,281,0,17,22,1,0,40,321
37,ASSAM,2011,Professional Activity,0,28,33,24,0,85,0,0,0,0,0,0,85
38,ASSAM,2011,Farming/Agriculture Activity,0,97,125,70,8,300,0,6,5,0,1,12,312
39,ASSAM,2011,Others (Please Specify),7,154,216,134,20,531,4,69,35,13,3,124,655
40,ASSAM,2011,Retired Person,0,0,0,0,3,3,0,0,0,0,0,0,3
41,ASSAM,2011,Others (Please Specify),5,74,78,49,8,214,2,52,41,15,0,110,324
42,ASSAM,2011,Total,20,667,686,408,45,1826,10,410,341,126,13,900,2726
43,ASSAM,2011,Total Salaried,0,48,109,47,0,204,1,4,11,5,0,21,225
44,ASSAM,2011,Total Self-employed,7,386,484,291,29,1197,4,92,62,14,4,176,1373
45,BIHAR,2011,House Wife,0,0,0,0,0,0,0,71,55,9,3,138,138
46,BIHAR,2011,Service (Government),0,3,5,1,0,9,0,10,9,1,0,20,29
47,BIHAR,2011,Service (Private),0,2,3,3,1,9,0,0,0,0,0,0,9
48,BIHAR,2011,Public Sector Undertaking,0,1,1,1,0,3,0,0,0,0,0,0,3
49,BIHAR,2011,Student,5,27,4,0,0,36,5,28,2,0,0,35,71
50,BIHAR,2011,Unemployed,0,14,22,12,1,49,0,5,2,0,0,7,56
51,BIHAR,2011,Self-employed (Business activity),0,1,4,4,0,9,0,0,0,0,0,0,9
52,BIHAR,2011,Professional Activity,0,2,2,3,0,7,0,0,0,0,0,0,7
53,BIHAR,2011,Farming/Agriculture Activity,0,11,27,19,6,63,0,0,20,0,0,20,83
54,BIHAR,2011,Others (Please Specify),3,21,13,13,4,54,8,9,10,1,0,28,82
55,BIHAR,2011,Retired Person,0,0,0,1,3,4,0,0,0,0,0,0,4
56,BIHAR,2011,Others (Please Specify),8,68,82,31,14,203,28,26,28,8,11,101,304
57,BIHAR,2011,Total,16,150,163,88,29,446,41,149,126,19,14,349,795
58,BIHAR,2011,Total Salaried,0,6,9,5,1,21,0,10,9,1,0,20,41
59,BIHAR,2011,Total Self-employed,3,35,46,39,10,133,8,9,30,1,0,48,181
60,CHHATTISGARH,2011,House Wife,0,0,0,0,0,0,3,384,239,121,28,775,775
61,CHHATTISGARH,2011,Service (Government),0,19,21,5,1,46,1,4,3,0,0,8,54
62,CHHATTISGARH,2011,Service (Private),2,135,120,59,5,321,2,42,31,8,6,89,410
63,CHHATTISGARH,2011,Public Sector Undertaking,0,12,20,29,0,61,0,3,6,2,0,11,72
64,CHHATTISGARH,2011,Student,40,152,9,0,0,201,31,130,0,0,0,161,362
65,CHHATTISGARH,2011,Unemployed,3,182,246,146,15,592,0,18,11,3,2,34,626
66,CHHATTISGARH,2011,Self-employed (Business activity),0,65,81,55,17,218,0,1,4,4,1,10,228
67,CHHATTISGARH,2011,Professional Activity,0,64,51,32,7,154,0,34,16,6,0,56,210
68,CHHATTISGARH,2011,Farming/Agriculture Activity,0,0,0,0,0,0,0,0,0,0,0,0,0
69,CHHATTISGARH,2011,Others (Please Specify),16,493,674,530,242,1955,13,220,214,153,57,657,2612
70,CHHATTISGARH,2011,Retired Person,0,5,3,4,7,19,0,0,0,0,0,0,19
71,CHHATTISGARH,2011,Others (Please Specify),41,301,276,221,121,960,36,152,114,79,47,428,1388
72,CHHATTISGARH,2011,Total,102,1428,1501,1081,415,4527,86,988,638,376,141,2229,6756
73,CHHATTISGARH,2011,Total Salaried,2,166,161,93,6,428,3,49,40,10,6,108,536
74,CHHATTISGARH,2011,Total Self-employed,16,622,806,617,266,2327,13,255,234,163,58,723,3050
75,GOA,2011,House Wife,0,0,0,0,0,0,0,18,22,7,9,56,56
76,GOA,2011,Service (Government),0,0,0,0,0,0,0,0,0,0,0,0,0
77,GOA,2011,Service (Private),0,19,25,9,0,53,0,7,1,0,0,8,61
78,GOA,2011,Public Sector Undertaking,0,0,0,0,0,0,0,0,0,0,0,0,0
79,GOA,2011,Student,3,4,0,0,0,7,2,17,1,0,0,20,27
80,GOA,2011,Unemployed,1,13,12,13,4,43,1,5,2,0,0,8,51
81,GOA,2011,Self-employed (Business activity),0,0,0,0,0,0,0,0,0,0,0,0,0
82,GOA,2011,Professional Activity,0,2,1,1,0,4,0,1,0,0,0,1,5
83,GOA,2011,Farming/Agriculture Activity,0,0,0,0,1,1,0,0,0,0,0,0,1
84,GOA,2011,Others (Please Specify),1,1,5,4,2,13,0,0,0,0,0,0,13
85,GOA,2011,Retired Person,0,0,0,0,4,4,0,0,0,1,0,1,5
86,GOA,2011,Others (Please Specify),0,13,38,12,7,70,0,3,0,1,0,4,74
87,GOA,2011,Total,5,52,81,39,18,195,3,51,26,9,9,98,293
88,GOA,2011,Total Salaried,0,19,25,9,0,53,0,7,1,0,0,8,61
89,GOA,2011,Total Self-employed,1,3,6,5,3,18,0,1,0,0,0,1,19
90,GUJARAT,2011,House Wife,0,0,0,0,0,0,4,719,512,258,78,1571,1571
91,GUJARAT,2011,Service (Government),0,18,26,16,0,60,0,7,2,2,3,14,74
92,GUJARAT,2011,Service (Private),0,226,226,119,10,581,0,39,31,17,5,92,673
93,GUJARAT,2011,Public Sector Undertaking,0,31,35,24,8,98,0,8,9,9,0,26,124
94,GUJARAT,2011,Student,24,146,8,0,0,178,36,110,2,0,0,148,326
95,GUJARAT,2011,Unemployed,2,163,182,82,14,443,0,24,18,6,0,48,491
96,GUJARAT,2011,Self-employed (Business activity),0,107,130,61,14,312,0,0,1,0,0,1,313
97,GUJARAT,2011,Professional Activity,0,210,185,107,29,531,2,31,24,2,2,61,592
98,GUJARAT,2011,Farming/Agriculture Activity,1,133,189,118,32,473,3,25,35,31,11,105,578
99,GUJARAT,2011,Others (Please Specify),1,214,268,139,31,653,3,58,61,28,8,158,811
100,GUJARAT,2011,Retired Person,0,3,1,29,70,103,0,0,0,11,43,54,157
101,GUJARAT,2011,Others (Please Specify),7,173,148,105,47,480,5,72,60,35,20,192,672
102,GUJARAT,2011,Total,35,1424,1398,800,255,3912,53,1093,755,399,170,2470,6382
103,GUJARAT,2011,Total Salaried,0,275,287,159,18,739,0,54,42,28,8,132,871
104,GUJARAT,2011,Total Self-employed,2,664,772,425,106,1969,8,114,121,61,21,325,2294
105,HARYANA,2011,House Wife,0,0,0,0,0,0,0,203,148,56,9,416,416
106,HARYANA,2011,Service (Government),0,20,28,24,0,72,0,2,5,0,0,7,79
107,HARYANA,2011,Service (Private),0,75,91,22,5,193,0,11,7,2,0,20,213
108,HARYANA,2011,Public Sector Undertaking,0,9,9,2,0,20,0,5,0,0,0,5,25
109,HARYANA,2011,Student,14,105,5,5,0,129,4,47,0,0,0,51,180
110,HARYANA,2011,Unemployed,4,91,146,75,16,332,0,15,11,17,1,44,376
111,HARYANA,2011,Self-employed (Business activity),0,21,29,12,0,62,0,0,0,0,0,0,62
112,HARYANA,2011,Professional Activity,0,8,13,3,0,24,0,0,0,0,0,0,24
113,HARYANA,2011,Farming/Agriculture Activity,0,140,113,74,23,350,0,8,18,8,0,34,384
114,HARYANA,2011,Others (Please Specify),0,80,88,61,13,242,6,5,5,2,0,18,260
115,HARYANA,2011,Retired Person,0,1,0,1,0,2,0,0,0,0,0,0,2
116,HARYANA,2011,Others (Please Specify),52,411,363,162,50,1038,15,84,58,22,7,186,1224
117,HARYANA,2011,Total,70,961,885,441,107,2464,25,380,252,107,17,781,3245
118,HARYANA,2011,Total Salaried,0,104,128,48,5,285,0,18,12,2,0,32,317
119,HARYANA,2011,Total Self-employed,0,249,243,150,36,678,6,13,23,10,0,52,730
120,HIMACHAL PRADESH,2011,House Wife,0,0,0,0,0,0,0,23,29,11,2,65,65
121,HIMACHAL PRADESH,2011,Service (Government),0,1,5,4,0,10,0,0,2,1,0,3,13
122,HIMACHAL PRADESH,2011,Service (Private),0,17,15,8,1,41,0,1,3,1,0,5,46
123,HIMACHAL PRADESH,2011,Public Sector Undertaking,0,6,10,4,1,21,0,2,2,2,1,7,28
124,HIMACHAL PRADESH,2011,Student,2,20,0,0,0,22,3,21,0,0,0,24,46
125,HIMACHAL PRADESH,2011,Unemployed,0,9,7,0,1,17,0,4,2,0,0,6,23
126,HIMACHAL PRADESH,2011,Self-employed (Business activity),0,3,7,7,2,19,0,0,3,1,1,5,24
127,HIMACHAL PRADESH,2011,Professional Activity,0,0,1,2,2,5,0,0,2,0,0,2,7
128,HIMACHAL PRADESH,2011,Farming/Agriculture Activity,0,8,14,10,10,42,0,3,0,1,0,4,46
129,HIMACHAL PRADESH,2011,Others (Please Specify),0,13,10,6,6,35,1,2,9,5,4,21,56
130,HIMACHAL PRADESH,2011,Retired Person,0,0,0,0,0,0,0,0,0,0,0,0,0
131,HIMACHAL PRADESH,2011,Others (Please Specify),3,21,19,5,9,57,1,10,10,8,3,32,89
132,HIMACHAL PRADESH,2011,Total,5,98,88,46,32,269,5,66,62,30,11,174,443
133,HIMACHAL PRADESH,2011,Total Salaried,0,24,30,16,2,72,0,3,7,4,1,15,87
134,HIMACHAL PRADESH,2011,Total Self-employed,0,24,32,25,20,101,1,5,14,7,5,32,133
135,JAMMU & KASHMIR,2011,House Wife,0,0,0,0,0,0,0,22,29,7,0,58,58
136,JAMMU & KASHMIR,2011,Service (Government),0,1,7,1,0,9,0,1,2,1,0,4,13
137,JAMMU & KASHMIR,2011,Service (Private),0,4,3,2,0,9,0,1,1,0,0,2,11
138,JAMMU & KASHMIR,2011,Public Sector Undertaking,0,0,2,2,0,4,0,0,0,0,0,0,4
139,JAMMU & KASHMIR,2011,Student,2,9,2,0,0,13,3,24,0,0,0,27,40
140,JAMMU & KASHMIR,2011,Unemployed,0,2,12,4,0,18,0,15,3,0,0,18,36
141,JAMMU & KASHMIR,2011,Self-employed (Business activity),0,2,6,4,1,13,0,2,0,0,0,2,15
142,JAMMU & KASHMIR,2011,Professional Activity,0,1,2,3,1,7,0,0,0,0,0,0,7
143,JAMMU & KASHMIR,2011,Farming/Agriculture Activity,0,0,3,6,2,11,0,2,0,1,0,3,14
144,JAMMU & KASHMIR,2011,Others (Please Specify),0,9,6,3,1,19,0,13,2,0,1,16,35
145,JAMMU & KASHMIR,2011,Retired Person,0,0,0,2,2,4,0,0,0,0,0,0,4
146,JAMMU & KASHMIR,2011,Others (Please Specify),2,12,10,12,1,37,2,7,2,2,0,13,50
147,JAMMU & KASHMIR,2011,Total,4,40,53,39,8,144,5,87,39,11,1,143,287
148,JAMMU & KASHMIR,2011,Total Salaried,0,5,12,5,0,22,0,2,3,1,0,6,28
149,JAMMU & KASHMIR,2011,Total Self-employed,0,12,17,16,5,50,0,17,2,1,1,21,71
150,JHARKHAND,2011,House Wife,0,0,0,0,0,0,10,70,95,24,7,206,206
151,JHARKHAND,2011,Service (Government),0,4,8,3,0,15,0,2,3,2,0,7,22
152,JHARKHAND,2011,Service (Private),0,25,63,17,0,105,0,6,2,1,0,9,114
153,JHARKHAND,2011,Public Sector Undertaking,7,12,1,0,0,20,1,10,0,0,0,11,31
154,JHARKHAND,2011,Student,3,37,11,0,0,51,6,34,4,0,0,44,95
155,JHARKHAND,2011,Unemployed,0,23,44,17,1,85,0,2,1,2,1,6,91
156,JHARKHAND,2011,Self-employed (Business activity),0,5,11,5,0,21,0,0,0,0,0,0,21
157,JHARKHAND,2011,Professional Activity,0,15,16,17,1,49,0,3,3,0,0,6,55
158,JHARKHAND,2011,Farming/Agriculture Activity,0,19,44,24,3,90,0,2,1,1,0,4,94
159,JHARKHAND,2011,Others (Please Specify),0,35,12,11,4,62,0,8,10,6,0,24,86
160,JHARKHAND,2011,Retired Person,0,1,0,0,6,7,0,0,0,0,0,0,7
161,JHARKHAND,2011,Others (Please Specify),3,148,53,85,31,320,1,52,8,8,1,70,390
162,JHARKHAND,2011,Total,13,324,263,179,46,825,18,189,127,44,9,387,1212
163,JHARKHAND,2011,Total Salaried,7,41,72,20,0,140,1,18,5,3,0,27,167
164,JHARKHAND,2011,Total Self-employed,0,74,83,57,8,222,0,13,14,7,0,34,256
165,KARNATAKA,2011,House Wife,0,0,0,0,0,0,0,585,635,417,139,1776,1776
166,KARNATAKA,2011,Service (Government),0,29,73,57,1,160,0,13,10,5,3,31,191
167,KARNATAKA,2011,Service (Private),0,180,377,159,45,761,1,107,68,35,22,233,994
168,KARNATAKA,2011,Public Sector Undertaking,0,125,114,98,25,362,0,37,22,17,1,77,439
169,KARNATAKA,2011,Student,68,343,10,4,0,425,19,235,21,8,3,286,711
170,KARNATAKA,2011,Unemployed,0,256,362,154,28,800,2,86,14,14,8,124,924
171,KARNATAKA,2011,Self-employed (Business activity),0,191,314,213,52,770,0,25,17,14,0,56,826
172,KARNATAKA,2011,Professional Activity,1,60,48,36,21,166,1,14,6,5,4,30,196
173,KARNATAKA,2011,Farming/Agriculture Activity,0,339,630,527,198,1694,0,127,137,126,16,406,2100
174,KARNATAKA,2011,Others (Please Specify),6,438,725,558,171,1898,3,183,122,104,36,448,2346
175,KARNATAKA,2011,Retired Person,0,0,0,9,46,55,0,0,2,3,3,8,63
176,KARNATAKA,2011,Others (Please Specify),145,365,391,284,196,1381,62,200,209,127,77,675,2056
177,KARNATAKA,2011,Total,220,2326,3044,2099,783,8472,88,1612,1263,875,312,4150,12622
178,KARNATAKA,2011,Total Salaried,0,334,564,314,71,1283,1,157,100,57,26,341,1624
179,KARNATAKA,2011,Total Self-employed,7,1028,1717,1334,442,4528,4,349,282,249,56,940,5468
180,KERALA,2011,House Wife,0,0,0,0,0,0,0,238,396,320,260,1214,1214
181,KERALA,2011,Service (Government),0,3,22,29,0,54,0,2,6,4,1,13,67
182,KERALA,2011,Service (Private),0,79,139,119,17,354,0,27,34,17,0,78,432
183,KERALA,2011,Public Sector Undertaking,0,6,20,25,0,51,0,0,1,1,0,2,53
184,KERALA,2011,Student,28,61,0,0,0,89,32,125,0,0,0,157,246
185,KERALA,2011,Unemployed,0,94,165,117,54,430,0,54,40,10,11,115,545
186,KERALA,2011,Self-employed (Business activity),0,42,119,141,51,353,0,0,1,6,0,7,360
187,KERALA,2011,Professional Activity,0,26,71,43,15,155,0,7,3,2,0,12,167
188,KERALA,2011,Farming/Agriculture Activity,0,101,215,230,186,732,0,21,25,34,18,98,830
189,KERALA,2011,Others (Please Specify),0,339,704,732,442,2217,2,73,103,75,40,293,2510
190,KERALA,2011,Retired Person,0,0,1,41,56,98,0,0,0,2,4,6,104
191,KERALA,2011,Others (Please Specify),1,176,444,732,326,1679,2,41,51,74,56,224,1903
192,KERALA,2011,Total,29,927,1900,2209,1147,6212,36,588,660,545,390,2219,8431
193,KERALA,2011,Total Salaried,0,88,181,173,17,459,0,29,41,22,1,93,552
194,KERALA,2011,Total Self-employed,0,508,1109,1146,694,3457,2,101,132,117,58,410,3867
195,MADHYA PRADESH,2011,House Wife,0,0,0,0,0,0,14,1403,863,305,147,2732,2732
196,MADHYA PRADESH,2011,Service (Government),0,20,44,31,0,95,0,10,5,2,0,17,112
197,MADHYA PRADESH,2011,Service (Private),0,166,198,115,17,496,0,45,21,8,1,75,571
198,MADHYA PRADESH,2011,Public Sector Undertaking,0,37,57,23,8,125,2,15,16,3,1,37,162
199,MADHYA PRADESH,2011,Student,53,202,10,0,0,265,39,139,8,0,0,186,451
200,MADHYA PRADESH,2011,Unemployed,6,107,80,15,5,213,6,32,9,3,0,50,263
201,MADHYA PRADESH,2011,Self-employed (Business activity),0,156,177,90,32,455,0,5,1,3,0,9,464
202,MADHYA PRADESH,2011,Professional Activity,0,103,57,56,32,248,0,6,5,6,2,19,267
203,MADHYA PRADESH,2011,Farming/Agriculture Activity,10,366,446,184,126,1132,6,84,84,15,5,194,1326
204,MADHYA PRADESH,2011,Others (Please Specify),44,485,416,252,129,1326,58,194,142,54,20,468,1794
205,MADHYA PRADESH,2011,Retired Person,0,5,0,2,13,20,0,16,3,3,1,23,43
206,MADHYA PRADESH,2011,Others (Please Specify),43,330,274,148,70,865,38,107,30,27,7,209,1074
207,MADHYA PRADESH,2011,Total,156,1977,1759,916,432,5240,163,2056,1187,429,184,4019,9259
208,MADHYA PRADESH,2011,Total Salaried,0,223,299,169,25,716,2,70,42,13,2,129,845
209,MADHYA PRADESH,2011,Total Self-employed,54,1110,1096,582,319,3161,64,289,232,78,27,690,3851
210,MAHARASHTRA,2011,House Wife,0,0,0,0,0,0,10,1863,1152,429,262,3716,3716
211,MAHARASHTRA,2011,Service (Government),0,35,74,59,2,170,0,13,10,2,0,25,195
212,MAHARASHTRA,2011,Service (Private),1,633,738,363,62,1797,0,82,46,8,1,137,1934
213,MAHARASHTRA,2011,Public Sector Undertaking,0,19,33,21,3,76,0,5,4,1,0,10,86
214,MAHARASHTRA,2011,Student,33,441,7,0,0,481,60,437,10,0,0,507,988
215,MAHARASHTRA,2011,Unemployed,0,299,203,71,18,591,3,50,7,6,1,67,658
216,MAHARASHTRA,2011,Self-employed (Business activity),0,168,248,150,12,578,0,11,14,7,0,32,610
217,MAHARASHTRA,2011,Professional Activity,0,209,288,185,68,750,0,20,7,8,1,36,786
218,MAHARASHTRA,2011,Farming/Agriculture Activity,2,727,1186,808,370,3093,1,123,92,19,9,244,3337
219,MAHARASHTRA,2011,Others (Please Specify),7,808,995,565,346,2721,5,110,71,51,18,255,2976
220,MAHARASHTRA,2011,Retired Person,0,4,6,16,118,144,0,0,0,1,2,3,147
221,MAHARASHTRA,2011,Others (Please Specify),3,134,182,111,56,486,1,14,9,2,2,28,514
222,MAHARASHTRA,2011,Total,46,3477,3960,2349,1055,10887,80,2728,1422,534,296,5060,15947
223,MAHARASHTRA,2011,Total Salaried,1,687,845,443,67,2043,0,100,60,11,1,172,2215
224,MAHARASHTRA,2011,Total Self-employed,9,1912,2717,1708,796,7142,6,264,184,85,28,567,7709
225,MANIPUR,2011,House Wife,0,0,0,0,0,0,0,6,2,1,0,9,9
226,MANIPUR,2011,Service (Government),0,0,4,1,0,5,0,0,0,0,0,0,5
227,MANIPUR,2011,Service (Private),0,0,1,0,0,1,0,0,0,0,0,0,1
228,MANIPUR,2011,Public Sector Undertaking,0,0,0,0,0,0,0,0,0,0,0,0,0
229,MANIPUR,2011,Student,0,4,0,0,0,4,0,0,0,0,0,0,4
230,MANIPUR,2011,Unemployed,0,1,4,1,0,6,0,0,0,0,0,0,6
231,MANIPUR,2011,Self-employed (Business activity),0,0,0,0,0,0,0,0,0,0,0,0,0
232,MANIPUR,2011,Professional Activity,0,0,0,0,0,0,0,0,0,0,0,0,0
233,MANIPUR,2011,Farming/Agriculture Activity,0,0,0,0,0,0,0,0,0,0,0,0,0
234,MANIPUR,2011,Others (Please Specify),0,0,0,1,0,1,0,1,0,0,0,1,2
235,MANIPUR,2011,Retired Person,0,0,0,0,0,0,0,0,0,0,0,0,0
236,MANIPUR,2011,Others (Please Specify),0,1,0,0,0,1,0,5,0,0,0,5,6
237,MANIPUR,2011,Total,0,6,9,3,0,18,0,12,2,1,0,15,33
238,MANIPUR,2011,Total Salaried,0,0,5,1,0,6,0,0,0,0,0,0,6
239,MANIPUR,2011,Total Self-employed,0,0,0,1,0,1,0,1,0,0,0,1,2
240,MEGHALAYA,2011,House Wife,0,0,0,0,0,0,0,5,8,2,0,15,15
241,MEGHALAYA,2011,Service (Government),0,2,3,1,0,6,0,0,0,0,0,0,6
242,MEGHALAYA,2011,Service (Private),0,6,1,0,0,7,0,0,1,0,0,1,8
243,MEGHALAYA,2011,Public Sector Undertaking,0,0,1,0,1,2,0,0,0,0,0,0,2
244,MEGHALAYA,2011,Student,3,25,0,0,0,28,0,9,0,0,0,9,37
245,MEGHALAYA,2011,Unemployed,0,12,6,0,0,18,0,1,2,0,0,3,21
246,MEGHALAYA,2011,Self-employed (Business activity),0,3,2,5,0,10,0,0,0,0,0,0,10
247,MEGHALAYA,2011,Professional Activity,0,4,0,0,0,4,0,0,0,2,0,2,6
248,MEGHALAYA,2011,Farming/Agriculture Activity,0,6,6,3,1,16,0,4,2,0,0,6,22
249,MEGHALAYA,2011,Others (Please Specify),0,4,3,3,0,10,0,1,0,1,2,4,14
250,MEGHALAYA,2011,Retired Person,0,0,0,0,0,0,0,0,0,0,0,0,0
251,MEGHALAYA,2011,Others (Please Specify),1,5,3,1,0,10,1,1,0,0,0,2,12
252,MEGHALAYA,2011,Total,4,67,25,13,2,111,1,21,13,5,2,42,153
253,MEGHALAYA,2011,Total Salaried,0,8,5,1,1,15,0,0,1,0,0,1,16
254,MEGHALAYA,2011,Total Self-employed,0,17,11,11,1,40,0,5,2,3,2,12,52
255,MIZORAM,2011,House Wife,0,0,0,0,0,0,0,0,5,1,0,6,6
256,MIZORAM,2011,Service (Government),0,0,1,3,0,4,0,0,0,0,0,0,4
257,MIZORAM,2011,Service (Private),0,0,3,0,0,3,0,0,0,0,0,0,3
258,MIZORAM,2011,Public Sector Undertaking,0,0,0,0,0,0,0,1,0,0,0,1,1
259,MIZORAM,2011,Student,2,10,0,0,0,12,0,1,0,0,0,1,13
260,MIZORAM,2011,Unemployed,0,15,11,0,0,26,0,1,0,0,0,1,27
261,MIZORAM,2011,Self-employed (Business activity),0,0,0,0,0,0,0,0,0,0,0,0,0
262,MIZORAM,2011,Professional Activity,0,0,0,0,0,0,0,0,0,0,0,0,0
263,MIZORAM,2011,Farming/Agriculture Activity,0,3,5,4,1,13,0,0,1,0,0,1,14
264,MIZORAM,2011,Others (Please Specify),0,6,4,0,0,10,0,2,0,1,0,3,13
265,MIZORAM,2011,Retired Person,0,0,0,0,1,1,0,0,0,0,0,0,1
266,MIZORAM,2011,Others (Please Specify),0,3,5,0,0,8,0,0,0,0,0,0,8
267,MIZORAM,2011,Total,2,37,29,7,2,77,0,5,6,2,0,13,90
268,MIZORAM,2011,Total Salaried,0,0,4,3,0,7,0,1,0,0,0,1,8
269,MIZORAM,2011,Total Self-employed,0,9,9,4,1,23,0,2,1,1,0,4,27
270,NAGALAND,2011,House Wife,0,0,0,0,0,0,0,2,2,0,0,4,4
271,NAGALAND,2011,Service (Government),0,1,6,0,0,7,0,0,0,0,0,0,7
272,NAGALAND,2011,Service (Private),0,0,0,0,0,0,0,0,0,0,0,0,0
273,NAGALAND,2011,Public Sector Undertaking,0,0,0,0,0,0,0,0,0,0,0,0,0
274,NAGALAND,2011,Student,0,0,0,0,0,0,0,2,0,0,0,2,2
275,NAGALAND,2011,Unemployed,0,0,1,0,0,1,0,0,0,0,0,0,1
276,NAGALAND,2011,Self-employed (Business activity),0,0,1,0,0,1,0,0,0,0,0,0,1
277,NAGALAND,2011,Professional Activity,0,1,3,5,0,9,0,0,0,0,0,0,9
278,NAGALAND,2011,Farming/Agriculture Activity,0,1,0,1,0,2,0,0,0,0,0,0,2
279,NAGALAND,2011,Others (Please Specify),0,3,0,2,0,5,0,2,0,0,0,2,7
280,NAGALAND,2011,Retired Person,0,0,0,0,0,0,0,0,0,0,0,0,0
281,NAGALAND,2011,Others (Please Specify),0,0,0,0,0,0,0,0,0,0,0,0,0
282,NAGALAND,2011,Total,0,6,11,8,0,25,0,6,2,0,0,8,33
283,NAGALAND,2011,Total Salaried,0,1,6,0,0,7,0,0,0,0,0,0,7
284,NAGALAND,2011,Total Self-employed,0,5,4,8,0,17,0,2,0,0,0,2,19
285,ODISHA,2011,House Wife,0,0,0,0,0,0,0,352,314,132,31,829,829
286,ODISHA,2011,Service (Government),0,5,13,16,0,34,0,2,3,3,0,8,42
287,ODISHA,2011,Service (Private),4,96,154,69,11,334,0,37,41,14,3,95,429
288,ODISHA,2011,Public Sector Undertaking,0,54,65,23,1,143,0,15,13,5,0,33,176
289,ODISHA,2011,Student,36,163,9,0,0,208,37,117,6,0,0,160,368
290,ODISHA,2011,Unemployed,32,149,149,49,2,381,11,65,48,19,6,149,530
291,ODISHA,2011,Self-employed (Business activity),1,56,110,98,10,275,0,21,21,6,1,49,324
292,ODISHA,2011,Professional Activity,0,29,64,17,2,112,0,5,4,0,0,9,121
293,ODISHA,2011,Farming/Agriculture Activity,0,35,44,52,7,138,0,0,3,3,0,6,144
294,ODISHA,2011,Others (Please Specify),58,325,309,236,126,1054,56,141,163,119,63,542,1596
295,ODISHA,2011,Retired Person,0,0,0,4,31,35,0,0,0,4,6,10,45
296,ODISHA,2011,Others (Please Specify),13,104,109,83,37,346,17,117,89,51,17,291,637
297,ODISHA,2011,Total,144,1016,1026,647,227,3060,121,872,705,356,127,2181,5241
298,ODISHA,2011,Total Salaried,4,155,232,108,12,511,0,54,57,22,3,136,647
299,ODISHA,2011,Total Self-employed,59,445,527,403,145,1579,56,167,191,128,64,606,2185
300,PUNJAB,2011,House Wife,0,0,0,0,0,0,0,72,61,10,5,148,148
301,PUNJAB,2011,Service (Government),0,13,20,10,0,43,0,0,0,0,0,0,43
302,PUNJAB,2011,Service (Private),0,52,58,31,7,148,0,6,0,0,0,6,154
303,PUNJAB,2011,Public Sector Undertaking,0,5,2,1,0,8,0,6,2,0,0,8,16
304,PUNJAB,2011,Student,0,20,1,0,0,21,0,17,0,0,0,17,38
305,PUNJAB,2011,Unemployed,0,48,26,12,8,94,0,4,2,0,0,6,100
306,PUNJAB,2011,Self-employed (Business activity),0,10,16,4,1,31,0,0,0,0,0,0,31
307,PUNJAB,2011,Professional Activity,0,3,11,2,1,17,0,0,0,0,0,0,17
308,PUNJAB,2011,Farming/Agriculture Activity,0,33,34,14,13,94,0,0,1,3,0,4,98
309,PUNJAB,2011,Others (Please Specify),0,43,54,27,20,144,0,6,4,2,0,12,156
310,PUNJAB,2011,Retired Person,0,0,2,2,5,9,0,0,0,0,0,0,9
311,PUNJAB,2011,Others (Please Specify),0,47,67,22,10,146,0,5,5,0,0,10,156
312,PUNJAB,2011,Total,0,274,291,125,65,755,0,116,75,15,5,211,966
313,PUNJAB,2011,Total Salaried,0,70,80,42,7,199,0,12,2,0,0,14,213
314,PUNJAB,2011,Total Self-employed,0,89,115,47,35,286,0,6,5,5,0,16,302
315,RAJASTHAN,2011,House Wife,0,0,0,0,0,0,9,341,306,101,27,784,784
316,RAJASTHAN,2011,Service (Government),0,5,16,13,1,35,0,1,6,1,0,8,43
317,RAJASTHAN,2011,Service (Private),0,196,142,68,7,413,0,21,17,5,2,45,458
318,RAJASTHAN,2011,Public Sector Undertaking,0,7,8,8,2,25,0,2,3,0,0,5,30
319,RAJASTHAN,2011,Student,23,128,6,0,0,157,8,68,3,0,0,79,236
320,RAJASTHAN,2011,Unemployed,0,63,42,9,0,114,0,9,4,1,0,14,128
321,RAJASTHAN,2011,Self-employed (Business activity),0,53,71,34,3,161,0,6,7,1,0,14,175
322,RAJASTHAN,2011,Professional Activity,0,31,51,20,2,104,0,1,0,0,0,1,105
323,RAJASTHAN,2011,Farming/Agriculture Activity,0,77,77,59,11,224,0,20,15,8,1,44,268
324,RAJASTHAN,2011,Others (Please Specify),6,252,318,133,29,738,2,66,29,11,3,111,849
325,RAJASTHAN,2011,Retired Person,0,0,1,3,4,8,0,0,0,0,0,0,8
326,RAJASTHAN,2011,Others (Please Specify),34,337,324,292,50,1037,8,102,73,32,12,227,1264
327,RAJASTHAN,2011,Total,63,1149,1056,639,109,3016,27,637,463,160,45,1332,4348
328,RAJASTHAN,2011,Total Salaried,0,208,166,89,10,473,0,24,26,6,2,58,531
329,RAJASTHAN,2011,Total Self-employed,6,413,517,246,45,1227,2,93,51,20,4,170,1397
330,SIKKIM,2011,House Wife,0,0,0,0,0,0,0,7,3,2,0,12,12
331,SIKKIM,2011,Service (Government),0,9,2,1,0,12,0,2,0,0,0,2,14
332,SIKKIM,2011,Service (Private),0,11,5,4,0,20,0,10,0,1,0,11,31
333,SIKKIM,2011,Public Sector Undertaking,0,6,8,0,0,14,0,2,0,2,0,4,18
334,SIKKIM,2011,Student,0,2,1,0,0,3,0,4,0,0,0,4,7
335,SIKKIM,2011,Unemployed,0,3,9,5,0,17,0,1,3,5,0,9,26
336,SIKKIM,2011,Self-employed (Business activity),0,1,2,3,0,6,0,3,2,0,0,5,11
337,SIKKIM,2011,Professional Activity,0,0,1,0,0,1,0,0,2,2,0,4,5
338,SIKKIM,2011,Farming/Agriculture Activity,0,0,4,3,0,7,0,0,3,2,0,5,12
339,SIKKIM,2011,Others (Please Specify),0,4,1,5,0,10,0,0,7,3,0,10,20
340,SIKKIM,2011,Retired Person,0,0,0,2,0,2,0,0,0,0,0,0,2
341,SIKKIM,2011,Others (Please Specify),4,4,3,2,2,15,2,3,2,1,3,11,26
342,SIKKIM,2011,Total,4,40,36,25,2,107,2,32,22,18,3,77,184
343,SIKKIM,2011,Total Salaried,0,26,15,5,0,46,0,14,0,3,0,17,63
344,SIKKIM,2011,Total Self-employed,0,5,8,11,0,24,0,3,14,7,0,24,48
345,TAMIL NADU,2011,House Wife,0,0,0,0,0,0,5,915,888,407,218,2433,2433
346,TAMIL NADU,2011,Service (Government),0,11,52,53,4,120,0,11,18,5,3,37,157
347,TAMIL NADU,2011,Service (Private),0,287,449,257,45,1038,1,96,81,48,1,227,1265
348,TAMIL NADU,2011,Public Sector Undertaking,1,38,50,34,7,130,0,31,16,3,1,51,181
349,TAMIL NADU,2011,Student,95,324,61,0,0,480,78,273,18,0,0,369,849
350,TAMIL NADU,2011,Unemployed,14,408,596,599,146,1763,15,239,114,85,18,471,2234
351,TAMIL NADU,2011,Self-employed (Business activity),0,187,281,203,58,729,0,11,30,7,1,49,778
352,TAMIL NADU,2011,Professional Activity,0,69,144,81,33,327,0,18,23,28,25,94,421
353,TAMIL NADU,2011,Farming/Agriculture Activity,3,99,161,157,62,482,2,61,43,23,12,141,623
354,TAMIL NADU,2011,Others (Please Specify),10,472,734,528,220,1964,11,199,169,98,33,510,2474
355,TAMIL NADU,2011,Retired Person,0,0,6,24,51,81,0,0,0,5,4,9,90
356,TAMIL NADU,2011,Others (Please Specify),36,841,1443,469,379,3168,84,565,426,117,98,1290,4458
357,TAMIL NADU,2011,Total,159,2736,3977,2405,1005,10282,196,2419,1826,826,414,5681,15963
358,TAMIL NADU,2011,Total Salaried,1,336,551,344,56,1288,1,138,115,56,5,315,1603
359,TAMIL NADU,2011,Total Self-employed,13,827,1320,969,373,3502,13,289,265,156,71,794,4296
360,TRIPURA,2011,House Wife,0,0,0,0,0,0,0,29,47,37,27,140,140
361,TRIPURA,2011,Service (Government),0,0,2,1,0,3,0,0,0,0,0,0,3
362,TRIPURA,2011,Service (Private),0,10,6,3,1,20,0,0,0,0,0,0,20
363,TRIPURA,2011,Public Sector Undertaking,0,0,0,0,0,0,0,0,0,0,0,0,0
364,TRIPURA,2011,Student,2,78,0,0,0,80,5,77,0,0,0,82,162
365,TRIPURA,2011,Unemployed,0,1,1,0,0,2,0,0,0,0,0,0,2
366,TRIPURA,2011,Self-employed (Business activity),0,33,30,24,12,99,0,0,0,0,0,0,99
367,TRIPURA,2011,Professional Activity,0,0,0,0,0,0,0,0,0,0,0,0,0
368,TRIPURA,2011,Farming/Agriculture Activity,0,5,9,4,2,20,0,0,0,0,0,0,20
369,TRIPURA,2011,Others (Please Specify),0,5,12,3,9,29,0,4,2,1,0,7,36
370,TRIPURA,2011,Retired Person,0,0,0,0,0,0,0,0,0,0,0,0,0
371,TRIPURA,2011,Others (Please Specify),3,70,73,33,15,194,0,23,4,0,0,27,221
372,TRIPURA,2011,Total,5,202,133,68,39,447,5,133,53,38,27,256,703
373,TRIPURA,2011,Total Salaried,0,10,8,4,1,23,0,0,0,0,0,0,23
374,TRIPURA,2011,Total Self-employed,0,43,51,31,23,148,0,4,2,1,0,7,155
375,UTTAR PRADESH,2011,House Wife,0,0,0,0,0,0,24,739,327,109,45,1244,1244
376,UTTAR PRADESH,2011,Service (Government),0,11,21,16,0,48,0,22,17,2,0,41,89
377,UTTAR PRADESH,2011,Service (Private),0,133,127,57,2,319,0,29,46,4,0,79,398
378,UTTAR PRADESH,2011,Public Sector Undertaking,0,4,4,8,0,16,0,2,2,0,0,4,20
379,UTTAR PRADESH,2011,Student,17,122,10,4,0,153,16,89,1,0,0,106,259
380,UTTAR PRADESH,2011,Unemployed,1,132,86,29,11,259,3,22,27,9,2,63,322
381,UTTAR PRADESH,2011,Self-employed (Business activity),1,33,59,10,2,105,0,27,0,0,0,27,132
382,UTTAR PRADESH,2011,Professional Activity,0,30,54,27,2,113,0,4,3,2,0,9,122
383,UTTAR PRADESH,2011,Farming/Agriculture Activity,3,152,199,118,81,553,4,32,36,12,8,92,645
384,UTTAR PRADESH,2011,Others (Please Specify),9,153,201,117,36,516,6,97,82,39,14,238,754
385,UTTAR PRADESH,2011,Retired Person,0,0,2,1,3,6,0,2,0,0,1,3,9
386,UTTAR PRADESH,2011,Others (Please Specify),14,197,234,131,49,625,6,105,75,24,14,224,849
387,UTTAR PRADESH,2011,Total,45,967,997,518,186,2713,59,1170,616,201,84,2130,4843
388,UTTAR PRADESH,2011,Total Salaried,0,148,152,81,2,383,0,53,65,6,0,124,507
389,UTTAR PRADESH,2011,Total Self-employed,13,368,513,272,121,1287,10,160,121,53,22,366,1653
390,UTTARAKHAND,2011,House Wife,0,0,0,0,0,0,0,23,24,3,1,51,51
391,UTTARAKHAND,2011,Service (Government),0,5,9,3,0,17,0,2,0,0,0,2,19
392,UTTARAKHAND,2011,Service (Private),0,11,18,2,0,31,0,4,2,0,0,6,37
393,UTTARAKHAND,2011,Public Sector Undertaking,0,2,1,1,1,5,0,4,0,0,0,4,9
394,UTTARAKHAND,2011,Student,3,9,1,0,0,13,1,16,0,0,0,17,30
395,UTTARAKHAND,2011,Unemployed,1,12,13,7,3,36,0,3,2,0,0,5,41
396,UTTARAKHAND,2011,Self-employed (Business activity),0,7,5,3,0,15,0,0,0,0,0,0,15
397,UTTARAKHAND,2011,Professional Activity,0,1,2,0,0,3,0,0,0,0,0,0,3
398,UTTARAKHAND,2011,Farming/Agriculture Activity,0,10,2,9,1,22,0,2,1,0,0,3,25
399,UTTARAKHAND,2011,Others (Please Specify),1,7,11,4,3,26,0,5,8,5,0,18,44
400,UTTARAKHAND,2011,Retired Person,0,0,1,0,3,4,0,0,0,0,0,0,4
401,UTTARAKHAND,2011,Others (Please Specify),0,5,10,5,0,20,0,10,7,2,0,19,39
402,UTTARAKHAND,2011,Total,5,69,73,34,11,192,1,69,44,10,1,125,317
403,UTTARAKHAND,2011,Total Salaried,0,18,28,6,1,53,0,10,2,0,0,12,65
404,UTTARAKHAND,2011,Total Self-employed,1,25,20,16,4,66,0,7,9,5,0,21,87
405,WEST BENGAL,2011,House Wife,0,0,0,0,0,0,1,1218,1171,474,91,2955,2955
406,WEST BENGAL,2011,Service (Government),0,14,66,25,1,106,0,7,5,5,0,17,123
407,WEST BENGAL,2011,Service (Private),0,114,235,222,1,572,0,78,66,32,0,176,748
408,WEST BENGAL,2011,Public Sector Undertaking,0,73,245,191,0,509,0,90,61,30,2,183,692
409,WEST BENGAL,2011,Student,92,426,9,0,0,527,96,404,7,0,0,507,1034
410,WEST BENGAL,2011,Unemployed,0,394,638,139,24,1195,0,138,163,76,6,383,1578
411,WEST BENGAL,2011,Self-employed (Business activity),0,353,427,257,32,1069,15,15,39,18,0,87,1156
412,WEST BENGAL,2011,Professional Activity,0,43,165,151,8,367,0,16,18,13,0,47,414
413,WEST BENGAL,2011,Farming/Agriculture Activity,0,132,293,182,55,662,0,39,69,37,0,145,807
414,WEST BENGAL,2011,Others (Please Specify),31,302,727,528,195,1783,36,364,296,199,58,953,2736
415,WEST BENGAL,2011,Retired Person,0,0,0,0,61,61,0,0,0,0,11,11,72
416,WEST BENGAL,2011,Others (Please Specify),161,670,987,601,354,2773,110,344,431,277,242,1404,4177
417,WEST BENGAL,2011,Total,284,2521,3792,2296,731,9624,258,2713,2326,1161,410,6868,16492
418,WEST BENGAL,2011,Total Salaried,0,201,546,438,2,1187,0,175,132,67,2,376,1563
419,WEST BENGAL,2011,Total Self-employed,31,830,1612,1118,290,3881,51,434,422,267,58,1232,5113
420,TOTAL (STATES),2011,House Wife,0,0,0,0,0,0,81,10501,8387,3668,1515,24152,24152
421,TOTAL (STATES),2011,Service (Government),0,248,591,423,10,1272,1,121,115,38,10,285,1557
422,TOTAL (STATES),2011,Service (Private),7,2823,3788,2144,352,9114,4,740,611,241,53,1649,10763
423,TOTAL (STATES),2011,Public Sector Undertaking,8,565,824,602,82,2081,4,264,210,79,9,566,2647
424,TOTAL (STATES),2011,Student,604,3252,171,13,0,4040,544,2725,92,8,3,3372,7412
425,TOTAL (STATES),2011,Unemployed,64,2684,3328,1675,364,8115,42,860,520,270,60,1752,9867
426,TOTAL (STATES),2011,Self-employed (Business activity),2,1884,2552,1712,412,6562,15,213,201,90,7,526,7088
427,TOTAL (STATES),2011,Professional Activity,1,1055,1386,891,249,3582,3,181,127,85,45,441,4023
428,TOTAL (STATES),2011,Farming/Agriculture Activity,24,2961,4500,3220,1343,12048,19,762,693,391,91,1956,14004
429,TOTAL (STATES),2011,Others (Please Specify),235,5377,7413,5158,2329,20512,264,2175,1766,1076,458,5739,26251
430,TOTAL (STATES),2011,Retired Person,0,19,23,146,518,706,0,18,5,31,80,134,840
431,TOTAL (STATES),2011,Others (Please Specify),607,4939,6245,4228,2014,18033,454,2345,1888,984,667,6338,24371
432,TOTAL (STATES),2011,Total,1552,25807,30821,20212,7673,86065,1431,20905,14615,6961,2998,46910,132975
433,TOTAL (STATES),2011,Total Salaried,15,3636,5203,3169,444,12467,9,1125,936,358,72,2500,14967
434,TOTAL (STATES),2011,Total Self-employed,262,11277,15851,10981,4333,42704,301,3331,2787,1642,601,8662,51366
435,A & N ISLANDS,2011,House Wife,0,0,0,0,0,0,0,3,4,2,1,10,10
436,A & N ISLANDS,2011,Service (Government),0,7,6,4,1,18,0,2,1,1,0,4,22
437,A & N ISLANDS,2011,Service (Private),0,7,17,8,1,33,0,4,4,1,1,10,43
438,A & N ISLANDS,2011,Public Sector Undertaking,0,0,0,0,0,0,0,0,0,0,0,0,0
439,A & N ISLANDS,2011,Student,1,9,0,0,0,10,4,8,0,1,0,13,23
440,A & N ISLANDS,2011,Unemployed,0,3,5,2,0,10,0,0,0,1,0,1,11
441,A & N ISLANDS,2011,Self-employed (Business activity),0,0,3,4,0,7,0,2,0,0,0,2,9
442,A & N ISLANDS,2011,Professional Activity,0,0,0,0,0,0,0,0,0,0,0,0,0
443,A & N ISLANDS,2011,Farming/Agriculture Activity,0,0,0,0,0,0,0,0,0,0,0,0,0
444,A & N ISLANDS,2011,Others (Please Specify),0,0,3,0,0,3,0,0,1,0,0,1,4
445,A & N ISLANDS,2011,Retired Person,0,0,0,0,5,5,0,0,1,0,0,1,6
446,A & N ISLANDS,2011,Others (Please Specify),0,2,1,2,3,8,0,0,0,0,0,0,8
447,A & N ISLANDS,2011,Total,1,28,35,20,10,94,4,19,11,6,2,42,136
448,A & N ISLANDS,2011,Total Salaried,0,14,23,12,2,51,0,6,5,2,1,14,65
449,A & N ISLANDS,2011,Total Self-employed,0,0,6,4,0,10,0,2,1,0,0,3,13
450,CHANDIGARH,2011,House Wife,0,0,0,0,0,0,0,13,13,2,0,28,28
451,CHANDIGARH,2011,Service (Government),0,0,1,2,0,3,0,0,0,0,0,0,3
452,CHANDIGARH,2011,Service (Private),0,2,8,7,0,17,0,2,0,1,0,3,20
453,CHANDIGARH,2011,Public Sector Undertaking,0,0,0,0,0,0,0,0,0,0,0,0,0
454,CHANDIGARH,2011,Student,0,4,0,0,0,4,0,10,0,0,0,10,14
455,CHANDIGARH,2011,Unemployed,0,8,1,1,0,10,0,2,0,0,0,2,12
456,CHANDIGARH,2011,Self-employed (Business activity),0,0,3,0,0,3,0,0,0,0,0,0,3
457,CHANDIGARH,2011,Professional Activity,0,0,0,0,0,0,0,0,0,0,0,0,0
458,CHANDIGARH,2011,Farming/Agriculture Activity,0,0,0,0,0,0,0,0,0,0,0,0,0
459,CHANDIGARH,2011,Others (Please Specify),0,10,6,3,1,20,0,1,0,0,0,1,21
460,CHANDIGARH,2011,Retired Person,0,0,0,0,0,0,0,0,0,0,0,0,0
461,CHANDIGARH,2011,Others (Please Specify),0,0,0,0,0,0,0,3,1,0,0,4,4
462,CHANDIGARH,2011,Total,0,24,19,13,1,57,0,31,14,3,0,48,105
463,CHANDIGARH,2011,Total Salaried,0,2,9,9,0,20,0,2,0,1,0,3,23
464,CHANDIGARH,2011,Total Self-employed,0,10,9,3,1,23,0,1,0,0,0,1,24
465,D & N HAVELI,2011,House Wife,0,0,0,0,0,0,0,5,5,2,0,12,12
466,D & N HAVELI,2011,Service (Government),0,0,0,0,0,0,0,0,0,0,0,0,0
467,D & N HAVELI,2011,Service (Private),0,15,3,2,0,20,0,5,0,0,0,5,25
468,D & N HAVELI,2011,Public Sector Undertaking,0,0,0,0,0,0,0,0,0,0,0,0,0
469,D & N HAVELI,2011,Student,0,3,0,0,0,3,0,3,0,0,0,3,6
470,D & N HAVELI,2011,Unemployed,0,0,0,0,0,0,0,0,0,0,0,0,0
471,D & N HAVELI,2011,Self-employed (Business activity),0,0,0,2,0,2,0,0,0,0,0,0,2
472,D & N HAVELI,2011,Professional Activity,0,0,0,0,0,0,0,0,0,0,0,0,0
473,D & N HAVELI,2011,Farming/Agriculture Activity,0,4,3,5,1,13,0,0,0,0,0,0,13
474,D & N HAVELI,2011,Others (Please Specify),0,1,2,0,0,3,0,0,0,1,1,2,5
475,D & N HAVELI,2011,Retired Person,0,0,0,0,0,0,0,0,0,0,0,0,0
476,D & N HAVELI,2011,Others (Please Specify),0,0,0,0,0,0,0,0,0,0,0,0,0
477,D & N HAVELI,2011,Total,0,23,8,9,1,41,0,13,5,3,1,22,63
478,D & N HAVELI,2011,Total Salaried,0,15,3,2,0,20,0,5,0,0,0,5,25
479,D & N HAVELI,2011,Total Self-employed,0,5,5,7,1,18,0,0,0,1,1,2,20
480,DAMAN & DIU,2011,House Wife,0,0,0,0,0,0,0,5,1,1,0,7,7
481,DAMAN & DIU,2011,Service (Government),0,0,0,0,0,0,0,0,0,0,0,0,0
482,DAMAN & DIU,2011,Service (Private),0,6,4,3,0,13,0,3,0,0,0,3,16
483,DAMAN & DIU,2011,Public Sector Undertaking,0,0,0,0,0,0,0,0,0,0,0,0,0
484,DAMAN & DIU,2011,Student,1,0,0,0,0,1,0,4,0,0,0,4,5
485,DAMAN & DIU,2011,Unemployed,0,0,0,0,0,0,0,0,0,0,0,0,0
486,DAMAN & DIU,2011,Self-employed (Business activity),0,0,0,0,0,0,0,0,0,0,0,0,0
487,DAMAN & DIU,2011,Professional Activity,0,0,0,0,0,0,0,0,0,0,0,0,0
488,DAMAN & DIU,2011,Farming/Agriculture Activity,0,0,0,0,0,0,0,0,0,0,0,0,0
489,DAMAN & DIU,2011,Others (Please Specify),0,0,0,1,0,1,0,0,0,0,0,0,1
490,DAMAN & DIU,2011,Retired Person,0,0,0,0,0,0,0,0,0,0,0,0,0
491,DAMAN & DIU,2011,Others (Please Specify),0,1,2,0,0,3,0,1,0,0,0,1,4
492,DAMAN & DIU,2011,Total,1,7,6,4,0,18,0,13,1,1,0,15,33
493,DAMAN & DIU,2011,Total Salaried,0,6,4,3,0,13,0,3,0,0,0,3,16
494,DAMAN & DIU,2011,Total Self-employed,0,0,0,1,0,1,0,0,0,0,0,0,1
495,DELHI (UT),2011,House Wife,0,0,0,0,0,0,0,158,101,20,11,290,290
496,DELHI (UT),2011,Service (Government),0,12,10,5,0,27,0,4,1,1,0,6,33
497,DELHI (UT),2011,Service (Private),0,97,100,28,2,227,0,21,5,2,0,28,255
498,DELHI (UT),2011,Public Sector Undertaking,0,20,6,3,0,29,0,1,0,0,0,1,30
499,DELHI (UT),2011,Student,12,102,0,0,0,114,11,75,0,0,0,86,200
500,DELHI (UT),2011,Unemployed,1,210,130,25,4,370,1,40,10,3,1,55,425
501,DELHI (UT),2011,Self-employed (Business activity),0,9,10,7,0,26,0,0,0,1,0,1,27
502,DELHI (UT),2011,Professional Activity,0,5,7,1,0,13,0,0,0,0,0,0,13
503,DELHI (UT),2011,Farming/Agriculture Activity,0,2,6,2,0,10,0,0,0,0,0,0,10
504,DELHI (UT),2011,Others (Please Specify),1,70,47,19,7,144,1,13,7,10,0,31,175
505,DELHI (UT),2011,Retired Person,0,0,0,0,11,11,0,0,0,0,0,0,11
506,DELHI (UT),2011,Others (Please Specify),4,95,51,37,10,197,6,31,11,1,1,50,247
507,DELHI (UT),2011,Total,18,622,367,127,34,1168,19,343,135,38,13,548,1716
508,DELHI (UT),2011,Total Salaried,0,129,116,36,2,283,0,26,6,3,0,35,318
509,DELHI (UT),2011,Total Self-employed,1,86,70,29,7,193,1,13,7,11,0,32,225
510,LAKSHADWEEP,2011,House Wife,0,0,0,0,0,0,0,0,0,0,0,0,0
511,LAKSHADWEEP,2011,Service (Government),0,0,0,0,0,0,0,0,0,0,0,0,0
512,LAKSHADWEEP,2011,Service (Private),0,0,0,0,0,0,0,0,0,0,0,0,0
513,LAKSHADWEEP,2011,Public Sector Undertaking,0,0,0,0,0,0,0,0,0,0,0,0,0
514,LAKSHADWEEP,2011,Student,0,0,0,0,0,0,0,0,0,0,0,0,0
515,LAKSHADWEEP,2011,Unemployed,0,0,0,0,0,0,0,0,0,0,0,0,0
516,LAKSHADWEEP,2011,Self-employed (Business activity),0,0,0,0,0,0,0,0,0,0,0,0,0
517,LAKSHADWEEP,2011,Professional Activity,0,0,0,0,0,0,0,0,0,0,0,0,0
518,LAKSHADWEEP,2011,Farming/Agriculture Activity,0,0,0,0,0,0,0,0,0,0,0,0,0
519,LAKSHADWEEP,2011,Others (Please Specify),0,0,0,0,0,0,0,0,0,0,0,0,0
520,LAKSHADWEEP,2011,Retired Person,0,0,0,0,0,0,0,0,0,0,0,0,0
521,LAKSHADWEEP,2011,Others (Please Specify),0,0,0,0,0,0,0,0,0,0,0,0,0
522,LAKSHADWEEP,2011,Total,0,0,0,0,0,0,0,0,0,0,0,0,0
523,LAKSHADWEEP,2011,Total Salaried,0,0,0,0,0,0,0,0,0,0,0,0,0
524,LAKSHADWEEP,2011,Total Self-employed,0,0,0,0,0,0,0,0,0,0,0,0,0
525,PUDUCHERRY,2011,House Wife,0,0,0,0,0,0,0,45,30,15,7,97,97
526,PUDUCHERRY,2011,Service (Government),0,1,4,5,0,10,0,1,0,0,0,1,11
527,PUDUCHERRY,2011,Service (Private),0,15,12,13,2,42,0,6,2,0,0,8,50
528,PUDUCHERRY,2011,Public Sector Undertaking,0,2,1,2,0,5,0,1,0,1,0,2,7
529,PUDUCHERRY,2011,Student,2,14,0,0,0,16,7,13,0,0,0,20,36
530,PUDUCHERRY,2011,Unemployed,0,13,15,19,25,72,0,19,2,1,10,32,104
531,PUDUCHERRY,2011,Self-employed (Business activity),0,10,17,18,1,46,0,1,0,0,0,1,47
532,PUDUCHERRY,2011,Professional Activity,0,32,79,54,5,170,0,0,0,0,0,0,170
533,PUDUCHERRY,2011,Farming/Agriculture Activity,0,0,0,0,0,0,0,0,0,0,0,0,0
534,PUDUCHERRY,2011,Others (Please Specify),0,6,16,11,2,35,0,0,0,0,0,0,35
535,PUDUCHERRY,2011,Retired Person,0,0,0,0,0,0,0,0,0,0,0,0,0
536,PUDUCHERRY,2011,Others (Please Specify),0,0,0,0,0,0,0,0,0,0,0,0,0
537,PUDUCHERRY,2011,Total,2,93,144,122,35,396,7,86,34,17,17,161,557
538,PUDUCHERRY,2011,Total Salaried,0,18,17,20,2,57,0,8,2,1,0,11,68
539,PUDUCHERRY,2011,Total Self-employed,0,48,112,83,8,251,0,1,0,0,0,1,252
540,TOTAL (UTs),2011,House Wife,0,0,0,0,0,0,0,229,154,42,19,444,444
541,TOTAL (UTs),2011,Service (Government),0,20,21,16,1,58,0,7,2,2,0,11,69
542,TOTAL (UTs),2011,Service (Private),0,142,144,61,5,352,0,41,11,4,1,57,409
543,TOTAL (UTs),2011,Public Sector Undertaking,0,22,7,5,0,34,0,2,0,1,0,3,37
544,TOTAL (UTs),2011,Student,16,132,0,0,0,148,22,113,0,1,0,136,284
545,TOTAL (UTs),2011,Unemployed,1,234,151,47,29,462,1,61,12,5,11,90,552
546,TOTAL (UTs),2011,Self-employed (Business activity),0,19,33,31,1,84,0,3,0,1,0,4,88
547,TOTAL (UTs),2011,Professional Activity,0,37,86,55,5,183,0,0,0,0,0,0,183
548,TOTAL (UTs),2011,Farming/Agriculture Activity,0,6,9,7,1,23,0,0,0,0,0,0,23
549,TOTAL (UTs),2011,Others (Please Specify),1,87,74,34,10,206,1,14,8,11,1,35,241
550,TOTAL (UTs),2011,Retired Person,0,0,0,0,16,16,0,0,1,0,0,1,17
551,TOTAL (UTs),2011,Others (Please Specify),4,98,54,39,13,208,6,35,12,1,1,55,263
552,TOTAL (UTs),2011,Total,22,797,579,295,81,1774,30,505,200,68,33,836,2610
553,TOTAL (UTs),2011,Total Salaried,0,184,172,82,6,444,0,50,13,7,1,71,515
554,TOTAL (UTs),2011,Total Self-employed,1,149,202,127,17,496,1,17,8,12,1,39,535
555,TOTAL (ALL INDIA),2011,House Wife,0,0,0,0,0,0,81,10730,8541,3710,1534,24596,24596
556,TOTAL (ALL INDIA),2011,Service (Government),0,268,612,439,11,1330,1,128,117,40,10,296,1626
557,TOTAL (ALL INDIA),2011,Service (Private),7,2965,3932,2205,357,9466,4,781,622,245,54,1706,11172
558,TOTAL (ALL INDIA),2011,Public Sector Undertaking,8,587,831,607,82,2115,4,266,210,80,9,569,2684
559,TOTAL (ALL INDIA),2011,Student,620,3384,171,13,0,4188,566,2838,92,9,3,3508,7696
560,TOTAL (ALL INDIA),2011,Unemployed,65,2918,3479,1722,393,8577,43,921,532,275,71,1842,10419
561,TOTAL (ALL INDIA),2011,Self-employed (Business activity),2,1903,2585,1743,413,6646,15,216,201,91,7,530,7176
562,TOTAL (ALL INDIA),2011,Professional Activity,1,1092,1472,946,254,3765,3,181,127,85,45,441,4206
563,TOTAL (ALL INDIA),2011,Farming/Agriculture Activity,24,2967,4509,3227,1344,12071,19,762,693,391,91,1956,14027
564,TOTAL (ALL INDIA),2011,Others (Please Specify),236,5464,7487,5192,2339,20718,265,2189,1774,1087,459,5774,26492
565,TOTAL (ALL INDIA),2011,Retired Person,0,19,23,146,534,722,0,18,6,31,80,135,857
566,TOTAL (ALL INDIA),2011,Others (Please Specify),611,5037,6299,4267,2027,18241,460,2380,1900,985,668,6393,24634
567,TOTAL (ALL INDIA),2011,Total,1574,26604,31400,20507,7754,87839,1461,21410,14815,7029,3031,47746,135585
568,TOTAL (ALL INDIA),2011,Total Salaried,15,3820,5375,3251,450,12911,9,1175,949,365,73,2571,15482
569,TOTAL (ALL INDIA),2011,Total Self-employed,263,11426,16053,11108,4350,43200,302,3348,2795,1654,602,8701,51901
0,ANDHRA PRADESH,2012,House Wife,0,0,0,0,0,0,1,946,669,401,126,2143,2143
1,ANDHRA PRADESH,2012,Service (Government),0,18,42,45,3,108,0,7,16,6,0,29,137
2,ANDHRA PRADESH,2012,Service (Private),0,411,563,244,50,1268,0,84,67,24,10,185,1453
3,ANDHRA PRADESH,2012,Public Sector Undertaking,0,70,124,60,26,280,0,9,38,2,2,51,331
4,ANDHRA PRADESH,2012,Student,35,222,19,0,0,276,54,225,4,0,0,283,559
5,ANDHRA PRADESH,2012,Unemployed,0,195,266,133,46,640,0,81,33,11,2,127,767
6,ANDHRA PRADESH,2012,Self-employed (Business activity),0,207,300,165,49,721,0,7,19,3,1,30,751
7,ANDHRA PRADESH,2012,Professional Activity,0,85,142,98,9,334,1,15,14,1,0,31,365
8,ANDHRA PRADESH,2012,Farming/Agriculture Activity,0,474,753,624,249,2100,7,132,207,70,56,472,2572
9,ANDHRA PRADESH,2012,Others (Please Specify),11,601,976,651,282,2521,49,285,265,128,86,813,3334
10,ANDHRA PRADESH,2012,Retired Person,0,0,1,31,52,84,0,0,0,0,0,0,84
11,ANDHRA PRADESH,2012,Others (Please Specify),19,260,442,289,185,1195,31,255,134,84,43,547,1742
12,ANDHRA PRADESH,2012,Total,65,2543,3628,2340,951,9527,143,2046,1466,730,326,4711,14238
13,ANDHRA PRADESH,2012,Total Salaried,0,499,729,349,79,1656,0,100,121,32,12,265,1921
14,ANDHRA PRADESH,2012,Total Self-employed,11,1367,2171,1538,589,5676,57,439,505,202,143,1346,7022
15,ARUNACHAL PRADESH,2012,House Wife,0,0,0,0,0,0,0,9,9,1,0,19,19
16,ARUNACHAL PRADESH,2012,Service (Government),0,1,1,2,0,4,0,5,0,0,0,5,9
17,ARUNACHAL PRADESH,2012,Service (Private),0,4,13,12,0,29,0,1,0,0,0,1,30
18,ARUNACHAL PRADESH,2012,Public Sector Undertaking,0,2,0,0,0,2,0,0,0,0,0,0,2
19,ARUNACHAL PRADESH,2012,Student,1,9,0,0,0,10,0,3,0,0,0,3,13
20,ARUNACHAL PRADESH,2012,Unemployed,0,3,8,5,0,16,0,0,0,0,0,0,16
21,ARUNACHAL PRADESH,2012,Self-employed (Business activity),0,0,0,0,0,0,0,0,0,0,0,0,0
22,ARUNACHAL PRADESH,2012,Professional Activity,0,0,0,0,0,0,0,0,0,0,0,0,0
23,ARUNACHAL PRADESH,2012,Farming/Agriculture Activity,0,1,7,3,0,11,0,0,0,0,0,0,11
24,ARUNACHAL PRADESH,2012,Others (Please Specify),0,4,8,6,1,19,0,2,0,0,0,2,21
25,ARUNACHAL PRADESH,2012,Retired Person,0,0,0,0,0,0,0,0,0,0,0,0,0
26,ARUNACHAL PRADESH,2012,Others (Please Specify),0,4,2,3,0,9,0,0,0,0,0,0,9
27,ARUNACHAL PRADESH,2012,Total,1,28,39,31,1,100,0,20,9,1,0,30,130
28,ARUNACHAL PRADESH,2012,Total Salaried,0,7,14,14,0,35,0,6,0,0,0,6,41
29,ARUNACHAL PRADESH,2012,Total Self-employed,0,5,15,9,1,30,0,2,0,0,0,2,32
30,ASSAM,2012,House Wife,0,0,0,0,0,0,0,133,175,91,4,403,403
31,ASSAM,2012,Service (Government),0,1,10,17,1,29,0,12,9,4,0,25,54
32,ASSAM,2012,Service (Private),0,44,50,28,0,122,0,3,6,2,0,11,133
33,ASSAM,2012,Public Sector Undertaking,0,25,51,30,1,107,0,4,4,1,0,9,116
34,ASSAM,2012,Student,6,116,2,0,0,124,7,88,2,0,0,97,221
35,ASSAM,2012,Unemployed,0,12,12,33,7,64,0,2,1,1,0,4,68
36,ASSAM,2012,Self-employed (Business activity),0,99,119,102,0,320,0,12,16,5,0,33,353
37,ASSAM,2012,Professional Activity,0,30,55,24,1,110,0,4,8,3,0,15,125
38,ASSAM,2012,Farming/Agriculture Activity,2,103,143,80,12,340,0,0,4,0,0,4,344
39,ASSAM,2012,Others (Please Specify),19,244,424,262,20,969,8,83,60,24,5,180,1149
40,ASSAM,2012,Retired Person,0,0,0,0,4,4,0,0,0,0,0,0,4
41,ASSAM,2012,Others (Please Specify),10,21,117,51,4,203,1,21,37,32,0,91,294
42,ASSAM,2012,Total,37,695,983,627,50,2392,16,362,322,163,9,872,3264
43,ASSAM,2012,Total Salaried,0,70,111,75,2,258,0,19,19,7,0,45,303
44,ASSAM,2012,Total Self-employed,21,476,741,468,33,1739,8,99,88,32,5,232,1971
45,BIHAR,2012,House Wife,0,0,0,0,0,0,0,59,55,11,5,130,130
46,BIHAR,2012,Service (Government),0,0,2,10,0,12,0,1,2,0,0,3,15
47,BIHAR,2012,Service (Private),0,12,5,4,1,22,0,2,0,0,0,2,24
48,BIHAR,2012,Public Sector Undertaking,0,0,0,0,0,0,0,0,0,0,0,0,0
49,BIHAR,2012,Student,1,29,6,0,0,36,1,22,5,0,0,28,64
50,BIHAR,2012,Unemployed,0,3,9,1,0,13,0,0,0,1,0,1,14
51,BIHAR,2012,Self-employed (Business activity),0,1,2,0,0,3,0,0,0,0,0,0,3
52,BIHAR,2012,Professional Activity,0,1,0,0,0,1,0,0,0,0,0,0,1
53,BIHAR,2012,Farming/Agriculture Activity,0,20,30,9,5,64,0,4,0,0,0,4,68
54,BIHAR,2012,Others (Please Specify),0,16,18,8,1,43,0,6,3,2,1,12,55
55,BIHAR,2012,Retired Person,0,0,0,0,1,1,0,0,0,0,0,0,1
56,BIHAR,2012,Others (Please Specify),4,73,140,31,12,260,5,41,58,15,5,124,384
57,BIHAR,2012,Total,5,155,212,63,20,455,6,135,123,29,11,304,759
58,BIHAR,2012,Total Salaried,0,12,7,14,1,34,0,3,2,0,0,5,39
59,BIHAR,2012,Total Self-employed,0,38,50,17,6,111,0,10,3,2,1,16,127
60,CHHATTISGARH,2012,House Wife,0,0,0,0,0,0,0,353,262,125,39,779,779
61,CHHATTISGARH,2012,Service (Government),0,6,22,34,0,62,0,3,1,0,0,4,66
62,CHHATTISGARH,2012,Service (Private),4,133,109,85,20,351,2,25,18,9,1,55,406
63,CHHATTISGARH,2012,Public Sector Undertaking,0,0,4,6,0,10,0,0,0,0,0,0,10
64,CHHATTISGARH,2012,Student,13,145,3,0,0,161,25,103,1,0,0,129,290
65,CHHATTISGARH,2012,Unemployed,0,108,131,94,8,341,0,11,3,2,2,18,359
66,CHHATTISGARH,2012,Self-employed (Business activity),0,33,51,19,3,106,0,2,2,0,0,4,110
67,CHHATTISGARH,2012,Professional Activity,0,72,75,63,19,229,0,0,0,0,0,0,229
68,CHHATTISGARH,2012,Farming/Agriculture Activity,0,1,2,1,0,4,0,0,0,0,0,0,4
69,CHHATTISGARH,2012,Others (Please Specify),14,416,549,432,93,1504,16,139,87,55,25,322,1826
70,CHHATTISGARH,2012,Retired Person,0,0,0,6,11,17,0,0,0,0,0,0,17
71,CHHATTISGARH,2012,Others (Please Specify),52,390,448,179,160,1229,35,130,69,41,54,329,1558
72,CHHATTISGARH,2012,Total,83,1304,1394,919,314,4014,78,766,443,232,121,1640,5654
73,CHHATTISGARH,2012,Total Salaried,4,139,135,125,20,423,2,28,19,9,1,59,482
74,CHHATTISGARH,2012,Total Self-employed,14,522,677,515,115,1843,16,141,89,55,25,326,2169
75,GOA,2012,House Wife,0,0,0,0,0,0,0,11,24,7,13,55,55
76,GOA,2012,Service (Government),0,1,5,3,0,9,0,0,1,0,0,1,10
77,GOA,2012,Service (Private),0,23,17,8,2,50,0,4,1,0,0,5,55
78,GOA,2012,Public Sector Undertaking,0,2,2,1,1,6,0,1,1,0,0,2,8
79,GOA,2012,Student,3,5,0,0,0,8,2,13,0,0,0,15,23
80,GOA,2012,Unemployed,0,12,20,12,2,46,0,3,0,0,0,3,49
81,GOA,2012,Self-employed (Business activity),0,1,10,6,1,18,0,0,0,0,0,0,18
82,GOA,2012,Professional Activity,0,1,1,1,1,4,0,0,0,0,0,0,4
83,GOA,2012,Farming/Agriculture Activity,0,0,0,1,0,1,0,0,0,0,0,0,1
84,GOA,2012,Others (Please Specify),0,2,9,2,0,13,0,1,0,0,1,2,15
85,GOA,2012,Retired Person,0,0,0,0,5,5,0,0,0,0,0,0,5
86,GOA,2012,Others (Please Specify),2,6,14,10,4,36,1,4,3,2,0,10,46
87,GOA,2012,Total,5,53,78,44,16,196,3,37,30,9,14,93,289
88,GOA,2012,Total Salaried,0,26,24,12,3,65,0,5,3,0,0,8,73
89,GOA,2012,Total Self-employed,0,4,20,10,2,36,0,1,0,0,1,2,38
90,GUJARAT,2012,House Wife,0,0,0,0,0,0,2,800,595,310,88,1795,1795
91,GUJARAT,2012,Service (Government),0,20,35,20,0,75,0,6,3,7,0,16,91
92,GUJARAT,2012,Service (Private),1,277,329,137,14,758,0,61,54,22,0,137,895
93,GUJARAT,2012,Public Sector Undertaking,0,38,52,21,4,115,0,12,17,5,1,35,150
94,GUJARAT,2012,Student,23,188,4,0,0,215,23,148,2,0,0,173,388
95,GUJARAT,2012,Unemployed,7,191,215,91,7,511,4,18,14,10,0,46,557
96,GUJARAT,2012,Self-employed (Business activity),0,79,105,68,13,265,0,4,0,0,0,4,269
97,GUJARAT,2012,Professional Activity,1,189,168,97,23,478,0,20,9,2,1,32,510
98,GUJARAT,2012,Farming/Agriculture Activity,2,138,193,110,29,472,4,46,23,16,3,92,564
99,GUJARAT,2012,Others (Please Specify),4,256,283,157,37,737,5,60,46,32,11,154,891
100,GUJARAT,2012,Retired Person,0,4,4,29,102,139,3,3,2,6,33,47,186
101,GUJARAT,2012,Others (Please Specify),14,174,200,152,57,597,16,68,79,39,15,217,814
102,GUJARAT,2012,Total,52,1554,1588,882,286,4362,57,1246,844,449,152,2748,7110
103,GUJARAT,2012,Total Salaried,1,335,416,178,18,948,0,79,74,34,1,188,1136
104,GUJARAT,2012,Total Self-employed,7,662,749,432,102,1952,9,130,78,50,15,282,2234
105,HARYANA,2012,House Wife,0,0,0,0,0,0,0,221,119,37,12,389,389
106,HARYANA,2012,Service (Government),0,15,17,16,0,48,0,2,1,0,0,3,51
107,HARYANA,2012,Service (Private),4,88,102,38,3,235,0,4,4,4,0,12,247
108,HARYANA,2012,Public Sector Undertaking,0,25,22,5,0,52,0,1,4,0,0,5,57
109,HARYANA,2012,Student,11,86,7,5,0,109,6,27,0,0,0,33,142
110,HARYANA,2012,Unemployed,2,120,108,52,11,293,1,12,16,4,1,34,327
111,HARYANA,2012,Self-employed (Business activity),0,14,20,11,0,45,0,0,0,0,0,0,45
112,HARYANA,2012,Professional Activity,0,11,21,9,0,41,0,0,0,0,0,0,41
113,HARYANA,2012,Farming/Agriculture Activity,0,53,100,73,25,251,0,9,12,2,2,25,276
114,HARYANA,2012,Others (Please Specify),15,232,210,110,59,626,16,55,42,21,3,137,763
115,HARYANA,2012,Retired Person,0,0,0,2,1,3,0,0,0,0,0,0,3
116,HARYANA,2012,Others (Please Specify),11,122,130,76,29,368,5,26,36,35,16,118,486
117,HARYANA,2012,Total,43,766,737,397,128,2071,28,357,234,103,34,756,2827
118,HARYANA,2012,Total Salaried,4,128,141,59,3,335,0,7,9,4,0,20,355
119,HARYANA,2012,Total Self-employed,15,310,351,203,84,963,16,64,54,23,5,162,1125
120,HIMACHAL PRADESH,2012,House Wife,0,0,0,0,0,0,0,40,25,12,3,80,80
121,HIMACHAL PRADESH,2012,Service (Government),0,0,3,3,0,6,0,2,1,1,0,4,10
122,HIMACHAL PRADESH,2012,Service (Private),0,10,12,9,1,32,0,2,4,1,0,7,39
123,HIMACHAL PRADESH,2012,Public Sector Undertaking,0,6,9,4,1,20,0,3,2,2,1,8,28
124,HIMACHAL PRADESH,2012,Student,5,24,0,0,0,29,3,15,0,0,0,18,47
125,HIMACHAL PRADESH,2012,Unemployed,1,19,14,5,1,40,0,3,1,0,0,4,44
126,HIMACHAL PRADESH,2012,Self-employed (Business activity),0,10,10,8,4,32,0,1,2,1,0,4,36
127,HIMACHAL PRADESH,2012,Professional Activity,0,1,2,2,1,6,0,1,1,0,0,2,8
128,HIMACHAL PRADESH,2012,Farming/Agriculture Activity,0,4,12,8,3,27,0,0,1,1,0,2,29
129,HIMACHAL PRADESH,2012,Others (Please Specify),0,8,14,11,4,37,1,0,3,4,4,12,49
130,HIMACHAL PRADESH,2012,Retired Person,0,0,0,0,3,3,0,0,0,0,0,0,3
131,HIMACHAL PRADESH,2012,Others (Please Specify),4,30,43,22,23,122,2,8,12,4,7,33,155
132,HIMACHAL PRADESH,2012,Total,10,112,119,72,41,354,6,75,52,26,15,174,528
133,HIMACHAL PRADESH,2012,Total Salaried,0,16,24,16,2,58,0,7,7,4,1,19,77
134,HIMACHAL PRADESH,2012,Total Self-employed,0,23,38,29,12,102,1,2,7,6,4,20,122
135,JAMMU & KASHMIR,2012,House Wife,0,0,0,0,0,0,0,29,39,6,1,75,75
136,JAMMU & KASHMIR,2012,Service (Government),0,3,10,5,3,21,0,1,0,2,0,3,24
137,JAMMU & KASHMIR,2012,Service (Private),0,1,3,0,1,5,0,1,1,1,10,13,18
138,JAMMU & KASHMIR,2012,Public Sector Undertaking,0,0,0,0,0,0,0,0,0,0,0,0,0
139,JAMMU & KASHMIR,2012,Student,2,13,5,0,0,20,1,36,0,1,4,42,62
140,JAMMU & KASHMIR,2012,Unemployed,0,11,14,5,3,33,0,8,12,0,0,20,53
141,JAMMU & KASHMIR,2012,Self-employed (Business activity),0,5,3,2,0,10,0,0,0,0,0,0,10
142,JAMMU & KASHMIR,2012,Professional Activity,0,1,4,1,1,7,0,1,2,1,0,4,11
143,JAMMU & KASHMIR,2012,Farming/Agriculture Activity,0,3,5,2,0,10,0,0,0,0,0,0,10
144,JAMMU & KASHMIR,2012,Others (Please Specify),0,1,3,5,3,12,0,6,3,5,5,19,31
145,JAMMU & KASHMIR,2012,Retired Person,0,0,0,1,4,5,0,0,0,0,0,0,5
146,JAMMU & KASHMIR,2012,Others (Please Specify),0,18,27,19,5,69,1,19,11,3,12,46,115
147,JAMMU & KASHMIR,2012,Total,2,56,74,40,20,192,2,101,68,19,32,222,414
148,JAMMU & KASHMIR,2012,Total Salaried,0,4,13,5,4,26,0,2,1,3,10,16,42
149,JAMMU & KASHMIR,2012,Total Self-employed,0,10,15,10,4,39,0,7,5,6,5,23,62
150,JHARKHAND,2012,House Wife,0,0,0,0,0,0,6,65,93,44,4,212,212
151,JHARKHAND,2012,Service (Government),0,2,7,3,5,17,0,1,0,1,0,2,19
152,JHARKHAND,2012,Service (Private),0,27,32,19,0,78,0,8,3,0,0,11,89
153,JHARKHAND,2012,Public Sector Undertaking,0,6,7,0,0,13,0,4,2,0,0,6,19
154,JHARKHAND,2012,Student,17,90,11,0,0,118,12,41,3,0,1,57,175
155,JHARKHAND,2012,Unemployed,0,41,53,32,0,126,2,24,5,1,0,32,158
156,JHARKHAND,2012,Self-employed (Business activity),3,9,18,11,7,48,3,6,3,5,0,17,65
157,JHARKHAND,2012,Professional Activity,0,5,7,10,0,22,0,0,0,0,0,0,22
158,JHARKHAND,2012,Farming/Agriculture Activity,0,24,37,29,3,93,0,7,11,6,2,26,119
159,JHARKHAND,2012,Others (Please Specify),1,36,32,32,6,107,1,17,2,2,0,22,129
160,JHARKHAND,2012,Retired Person,0,0,0,0,3,3,0,0,0,0,0,0,3
161,JHARKHAND,2012,Others (Please Specify),2,57,63,62,29,213,10,44,30,11,1,96,309
162,JHARKHAND,2012,Total,23,297,267,198,53,838,34,217,152,70,8,481,1319
163,JHARKHAND,2012,Total Salaried,0,35,46,22,5,108,0,13,5,1,0,19,127
164,JHARKHAND,2012,Total Self-employed,4,74,94,82,16,270,4,30,16,13,2,65,335
165,KARNATAKA,2012,House Wife,0,0,0,0,0,0,0,717,601,373,159,1850,1850
166,KARNATAKA,2012,Service (Government),0,24,68,78,4,174,0,14,13,2,0,29,203
167,KARNATAKA,2012,Service (Private),0,392,338,233,37,1000,4,126,82,40,9,261,1261
168,KARNATAKA,2012,Public Sector Undertaking,0,71,98,70,15,254,0,19,47,21,1,88,342
169,KARNATAKA,2012,Student,33,257,6,0,0,296,51,198,9,5,1,264,560
170,KARNATAKA,2012,Unemployed,0,166,299,134,34,633,0,47,16,13,6,82,715
171,KARNATAKA,2012,Self-employed (Business activity),0,107,243,189,69,608,0,18,9,7,0,34,642
172,KARNATAKA,2012,Professional Activity,6,67,83,83,29,268,0,14,12,5,2,33,301
173,KARNATAKA,2012,Farming/Agriculture Activity,0,289,554,482,191,1516,0,113,124,100,22,359,1875
174,KARNATAKA,2012,Others (Please Specify),26,715,971,655,260,2627,7,319,185,79,24,614,3241
175,KARNATAKA,2012,Retired Person,0,0,1,28,31,60,0,0,0,1,8,9,69
176,KARNATAKA,2012,Others (Please Specify),13,270,496,288,93,1160,16,201,165,110,42,534,1694
177,KARNATAKA,2012,Total,78,2358,3157,2240,763,8596,78,1786,1263,756,274,4157,12753
178,KARNATAKA,2012,Total Salaried,0,487,504,381,56,1428,4,159,142,63,10,378,1806
179,KARNATAKA,2012,Total Self-employed,32,1178,1851,1409,549,5019,7,464,330,191,48,1040,6059
180,KERALA,2012,House Wife,0,0,0,0,0,0,0,250,323,372,249,1194,1194
181,KERALA,2012,Service (Government),0,4,21,27,0,52,0,1,4,4,0,9,61
182,KERALA,2012,Service (Private),0,92,190,163,38,483,0,36,25,19,0,80,563
183,KERALA,2012,Public Sector Undertaking,0,9,33,31,2,75,0,1,2,3,1,7,82
184,KERALA,2012,Student,31,59,0,0,0,90,27,146,0,0,0,173,263
185,KERALA,2012,Unemployed,0,80,194,214,123,611,0,39,51,27,25,142,753
186,KERALA,2012,Self-employed (Business activity),0,52,145,203,68,468,0,0,5,4,2,11,479
187,KERALA,2012,Professional Activity,0,20,50,81,11,162,0,6,2,2,0,10,172
188,KERALA,2012,Farming/Agriculture Activity,0,71,293,360,258,982,0,25,30,26,18,99,1081
189,KERALA,2012,Others (Please Specify),0,364,622,515,360,1861,1,49,53,47,53,203,2064
190,KERALA,2012,Retired Person,0,0,0,28,51,79,0,0,0,3,8,11,90
191,KERALA,2012,Others (Please Specify),0,170,428,613,335,1546,2,21,35,49,35,142,1688
192,KERALA,2012,Total,31,921,1976,2235,1246,6409,30,574,530,556,391,2081,8490
193,KERALA,2012,Total Salaried,0,105,244,221,40,610,0,38,31,26,1,96,706
194,KERALA,2012,Total Self-employed,0,507,1110,1159,697,3473,1,80,90,79,73,323,3796
195,MADHYA PRADESH,2012,House Wife,0,0,0,0,0,0,4,1463,824,314,135,2740,2740
196,MADHYA PRADESH,2012,Service (Government),0,21,42,18,2,83,1,5,11,0,0,17,100
197,MADHYA PRADESH,2012,Service (Private),2,236,251,103,19,611,0,38,35,14,0,87,698
198,MADHYA PRADESH,2012,Public Sector Undertaking,0,48,62,27,13,150,0,2,12,8,2,24,174
199,MADHYA PRADESH,2012,Student,85,235,11,0,0,331,74,187,2,1,0,264,595
200,MADHYA PRADESH,2012,Unemployed,6,177,118,42,8,351,4,23,31,29,4,91,442
201,MADHYA PRADESH,2012,Self-employed (Business activity),0,114,151,121,36,422,0,22,12,11,2,47,469
202,MADHYA PRADESH,2012,Professional Activity,0,129,145,90,38,402,0,24,17,14,6,61,463
203,MADHYA PRADESH,2012,Farming/Agriculture Activity,0,270,413,253,102,1038,3,70,39,18,4,134,1172
204,MADHYA PRADESH,2012,Others (Please Specify),34,478,513,300,162,1487,33,127,91,64,30,345,1832
205,MADHYA PRADESH,2012,Retired Person,0,0,0,1,26,27,0,0,0,0,2,2,29
206,MADHYA PRADESH,2012,Others (Please Specify),17,288,282,193,92,872,15,99,40,13,22,189,1061
207,MADHYA PRADESH,2012,Total,144,1996,1988,1148,498,5774,134,2060,1114,486,207,4001,9775
208,MADHYA PRADESH,2012,Total Salaried,2,305,355,148,34,844,1,45,58,22,2,128,972
209,MADHYA PRADESH,2012,Total Self-employed,34,991,1222,764,338,3349,36,243,159,107,42,587,3936
210,MAHARASHTRA,2012,House Wife,0,0,0,0,0,0,3,1637,1010,438,262,3350,3350
211,MAHARASHTRA,2012,Service (Government),0,32,70,58,1,161,0,19,8,1,0,28,189
212,MAHARASHTRA,2012,Service (Private),0,721,826,477,77,2101,0,108,41,12,2,163,2264
213,MAHARASHTRA,2012,Public Sector Undertaking,0,60,77,66,6,209,0,8,4,1,0,13,222
214,MAHARASHTRA,2012,Student,64,376,9,0,0,449,68,401,3,0,0,472,921
215,MAHARASHTRA,2012,Unemployed,0,370,296,143,23,832,0,91,27,14,0,132,964
216,MAHARASHTRA,2012,Self-employed (Business activity),0,164,224,136,45,569,0,2,4,1,1,8,577
217,MAHARASHTRA,2012,Professional Activity,0,116,156,98,33,403,0,13,6,5,2,26,429
218,MAHARASHTRA,2012,Farming/Agriculture Activity,0,804,1267,980,432,3483,0,100,131,55,17,303,3786
219,MAHARASHTRA,2012,Others (Please Specify),6,607,758,517,245,2133,9,111,62,35,12,229,2362
220,MAHARASHTRA,2012,Retired Person,0,0,0,22,121,143,0,0,0,0,3,3,146
221,MAHARASHTRA,2012,Others (Please Specify),3,246,315,182,75,821,3,41,17,12,8,81,902
222,MAHARASHTRA,2012,Total,73,3496,3998,2679,1058,11304,83,2531,1313,574,307,4808,16112
223,MAHARASHTRA,2012,Total Salaried,0,813,973,601,84,2471,0,135,53,14,2,204,2675
224,MAHARASHTRA,2012,Total Self-employed,6,1691,2405,1731,755,6588,9,226,203,96,32,566,7154
225,MANIPUR,2012,House Wife,0,0,0,0,0,0,0,3,4,1,1,9,9
226,MANIPUR,2012,Service (Government),0,1,4,0,0,5,0,0,0,0,0,0,5
227,MANIPUR,2012,Service (Private),0,0,0,0,0,0,0,0,0,0,0,0,0
228,MANIPUR,2012,Public Sector Undertaking,0,0,0,0,0,0,0,0,0,0,0,0,0
229,MANIPUR,2012,Student,0,8,0,0,0,8,1,5,0,0,0,6,14
230,MANIPUR,2012,Unemployed,0,0,0,0,0,0,0,0,0,0,0,0,0
231,MANIPUR,2012,Self-employed (Business activity),0,0,0,0,0,0,0,0,0,0,0,0,0
232,MANIPUR,2012,Professional Activity,0,0,0,0,0,0,0,0,0,0,0,0,0
233,MANIPUR,2012,Farming/Agriculture Activity,0,0,0,0,0,0,0,0,0,0,0,0,0
234,MANIPUR,2012,Others (Please Specify),0,0,0,0,0,0,0,0,0,0,0,0,0
235,MANIPUR,2012,Retired Person,0,0,0,0,0,0,0,0,0,0,0,0,0
236,MANIPUR,2012,Others (Please Specify),0,5,5,0,0,10,0,3,0,0,0,3,13
237,MANIPUR,2012,Total,0,14,9,0,0,23,1,11,4,1,1,18,41
238,MANIPUR,2012,Total Salaried,0,1,4,0,0,5,0,0,0,0,0,0,5
239,MANIPUR,2012,Total Self-employed,0,0,0,0,0,0,0,0,0,0,0,0,0
240,MEGHALAYA,2012,House Wife,0,0,0,0,0,0,0,6,6,2,0,14,14
241,MEGHALAYA,2012,Service (Government),0,2,1,1,0,4,0,0,0,0,0,0,4
242,MEGHALAYA,2012,Service (Private),1,2,1,1,0,5,0,0,0,0,0,0,5
243,MEGHALAYA,2012,Public Sector Undertaking,0,0,1,0,0,1,0,0,0,0,0,0,1
244,MEGHALAYA,2012,Student,2,12,0,0,0,14,1,10,0,0,0,11,25
245,MEGHALAYA,2012,Unemployed,0,8,5,4,0,17,0,5,1,0,0,6,23
246,MEGHALAYA,2012,Self-employed (Business activity),0,9,6,3,0,18,0,0,0,0,0,0,18
247,MEGHALAYA,2012,Professional Activity,0,1,2,0,0,3,0,0,0,0,0,0,3
248,MEGHALAYA,2012,Farming/Agriculture Activity,0,3,3,3,0,9,0,1,0,0,0,1,10
249,MEGHALAYA,2012,Others (Please Specify),0,2,8,4,0,14,0,2,0,0,0,2,16
250,MEGHALAYA,2012,Retired Person,0,0,0,0,0,0,0,0,0,0,0,0,0
251,MEGHALAYA,2012,Others (Please Specify),0,1,3,0,1,5,1,3,0,0,0,4,9
252,MEGHALAYA,2012,Total,3,40,30,16,1,90,2,27,7,2,0,38,128
253,MEGHALAYA,2012,Total Salaried,1,4,3,2,0,10,0,0,0,0,0,0,10
254,MEGHALAYA,2012,Total Self-employed,0,15,19,10,0,44,0,3,0,0,0,3,47
255,MIZORAM,2012,House Wife,0,0,0,0,0,0,0,0,1,0,0,1,1
256,MIZORAM,2012,Service (Government),0,0,1,1,0,2,0,0,0,0,0,0,2
257,MIZORAM,2012,Service (Private),3,0,13,0,0,16,0,4,0,0,0,4,20
258,MIZORAM,2012,Public Sector Undertaking,0,0,0,0,0,0,0,0,0,0,0,0,0
259,MIZORAM,2012,Student,0,1,5,0,0,6,0,1,0,0,0,1,7
260,MIZORAM,2012,Unemployed,2,28,17,10,6,63,3,0,0,0,0,3,66
261,MIZORAM,2012,Self-employed (Business activity),1,22,13,3,0,39,0,0,0,0,0,0,39
262,MIZORAM,2012,Professional Activity,0,0,0,0,0,0,0,0,0,0,0,0,0
263,MIZORAM,2012,Farming/Agriculture Activity,0,3,5,1,0,9,0,0,0,1,0,1,10
264,MIZORAM,2012,Others (Please Specify),0,8,0,0,0,8,0,0,0,2,0,2,10
265,MIZORAM,2012,Retired Person,0,0,0,0,2,2,0,2,0,0,0,2,4
266,MIZORAM,2012,Others (Please Specify),1,8,3,0,0,12,0,0,0,1,1,2,14
267,MIZORAM,2012,Total,7,70,57,15,8,157,3,7,1,4,1,16,173
268,MIZORAM,2012,Total Salaried,3,0,14,1,0,18,0,4,0,0,0,4,22
269,MIZORAM,2012,Total Self-employed,1,33,18,4,0,56,0,0,0,3,0,3,59
270,NAGALAND,2012,House Wife,0,0,0,0,0,0,0,2,1,0,0,3,3
271,NAGALAND,2012,Service (Government),0,3,2,1,0,6,0,0,0,0,0,0,6
272,NAGALAND,2012,Service (Private),0,0,0,0,0,0,0,0,0,0,0,0,0
273,NAGALAND,2012,Public Sector Undertaking,0,0,0,0,0,0,0,0,0,0,0,0,0
274,NAGALAND,2012,Student,0,2,0,0,0,2,1,1,0,0,0,2,4
275,NAGALAND,2012,Unemployed,0,0,1,0,0,1,0,0,0,0,0,0,1
276,NAGALAND,2012,Self-employed (Business activity),0,1,1,1,0,3,0,0,0,0,0,0,3
277,NAGALAND,2012,Professional Activity,0,0,2,1,0,3,0,0,0,0,0,0,3
278,NAGALAND,2012,Farming/Agriculture Activity,0,4,2,2,0,8,0,1,0,0,0,1,9
279,NAGALAND,2012,Others (Please Specify),0,1,0,0,0,1,0,0,0,0,0,0,1
280,NAGALAND,2012,Retired Person,0,0,0,0,0,0,0,0,0,0,0,0,0
281,NAGALAND,2012,Others (Please Specify),0,0,0,0,0,0,0,0,0,0,0,0,0
282,NAGALAND,2012,Total,0,11,8,5,0,24,1,4,1,0,0,6,30
283,NAGALAND,2012,Total Salaried,0,3,2,1,0,6,0,0,0,0,0,0,6
284,NAGALAND,2012,Total Self-employed,0,6,5,4,0,15,0,1,0,0,0,1,16
285,ODISHA,2012,House Wife,0,0,0,0,0,0,0,363,362,124,21,870,870
286,ODISHA,2012,Service (Government),0,12,11,4,1,28,1,8,18,6,3,36,64
287,ODISHA,2012,Service (Private),5,109,141,84,7,346,2,43,69,22,5,141,487
288,ODISHA,2012,Public Sector Undertaking,0,34,34,21,0,89,8,7,13,10,0,38,127
289,ODISHA,2012,Student,28,165,24,16,0,233,49,115,26,0,0,190,423
290,ODISHA,2012,Unemployed,10,158,186,68,2,424,7,49,50,22,2,130,554
291,ODISHA,2012,Self-employed (Business activity),6,63,166,121,21,377,1,17,9,11,1,39,416
292,ODISHA,2012,Professional Activity,0,8,97,35,10,150,0,2,9,2,0,13,163
293,ODISHA,2012,Farming/Agriculture Activity,0,14,45,53,9,121,1,10,6,8,0,25,146
294,ODISHA,2012,Others (Please Specify),34,132,139,142,91,538,28,122,84,69,31,334,872
295,ODISHA,2012,Retired Person,0,5,5,16,19,45,2,4,0,3,6,15,60
296,ODISHA,2012,Others (Please Specify),61,167,116,119,82,545,44,89,75,52,40,300,845
297,ODISHA,2012,Total,144,867,964,679,242,2896,143,829,721,329,109,2131,5027
298,ODISHA,2012,Total Salaried,5,155,186,109,8,463,11,58,100,38,8,215,678
299,ODISHA,2012,Total Self-employed,40,217,447,351,131,1186,30,151,108,90,32,411,1597
300,PUNJAB,2012,House Wife,0,0,0,0,0,0,1,71,84,15,2,173,173
301,PUNJAB,2012,Service (Government),0,6,5,2,0,13,0,1,0,0,0,1,14
302,PUNJAB,2012,Service (Private),0,68,69,26,6,169,0,2,8,2,0,12,181
303,PUNJAB,2012,Public Sector Undertaking,0,6,6,1,0,13,0,4,0,0,0,4,17
304,PUNJAB,2012,Student,5,25,0,0,0,30,1,26,0,0,0,27,57
305,PUNJAB,2012,Unemployed,0,50,19,10,4,83,0,4,1,2,0,7,90
306,PUNJAB,2012,Self-employed (Business activity),0,10,18,8,3,39,0,0,0,0,0,0,39
307,PUNJAB,2012,Professional Activity,0,6,15,4,0,25,0,0,0,0,0,0,25
308,PUNJAB,2012,Farming/Agriculture Activity,0,23,34,8,10,75,0,0,0,0,0,0,75
309,PUNJAB,2012,Others (Please Specify),0,80,96,47,20,243,0,9,3,1,0,13,256
310,PUNJAB,2012,Retired Person,0,0,1,2,4,7,0,0,0,1,0,1,8
311,PUNJAB,2012,Others (Please Specify),2,25,36,17,7,87,0,4,4,0,0,8,95
312,PUNJAB,2012,Total,7,299,299,125,54,784,2,121,100,21,2,246,1030
313,PUNJAB,2012,Total Salaried,0,80,80,29,6,195,0,7,8,2,0,17,212
314,PUNJAB,2012,Total Self-employed,0,119,163,67,33,382,0,9,3,1,0,13,395
315,RAJASTHAN,2012,House Wife,0,0,0,0,0,0,1,413,337,106,37,894,894
316,RAJASTHAN,2012,Service (Government),0,12,19,16,1,48,0,2,3,0,0,5,53
317,RAJASTHAN,2012,Service (Private),0,153,148,62,7,370,0,12,12,2,2,28,398
318,RAJASTHAN,2012,Public Sector Undertaking,0,7,8,20,6,41,0,1,2,0,0,3,44
319,RAJASTHAN,2012,Student,15,119,4,0,0,138,14,84,3,0,1,102,240
320,RAJASTHAN,2012,Unemployed,0,56,47,21,8,132,1,9,27,6,0,43,175
321,RAJASTHAN,2012,Self-employed (Business activity),0,49,78,31,7,165,0,1,11,1,0,13,178
322,RAJASTHAN,2012,Professional Activity,0,23,47,26,0,96,0,0,0,1,0,1,97
323,RAJASTHAN,2012,Farming/Agriculture Activity,0,68,88,66,20,242,1,16,7,4,0,28,270
324,RAJASTHAN,2012,Others (Please Specify),10,232,287,142,27,698,4,36,23,12,3,78,776
325,RAJASTHAN,2012,Retired Person,0,0,1,2,8,11,0,0,0,0,0,0,11
326,RAJASTHAN,2012,Others (Please Specify),43,367,433,373,70,1286,19,167,137,59,17,399,1685
327,RAJASTHAN,2012,Total,68,1086,1160,759,154,3227,40,741,562,191,60,1594,4821
328,RAJASTHAN,2012,Total Salaried,0,172,175,98,14,459,0,15,17,2,2,36,495
329,RAJASTHAN,2012,Total Self-employed,10,372,500,265,54,1201,5,53,41,18,3,120,1321
330,SIKKIM,2012,House Wife,0,0,0,0,0,0,0,9,7,4,2,22,22
331,SIKKIM,2012,Service (Government),0,7,7,3,0,17,0,5,0,1,0,6,23
332,SIKKIM,2012,Service (Private),0,5,5,4,0,14,0,4,3,1,0,8,22
333,SIKKIM,2012,Public Sector Undertaking,0,2,2,4,0,8,0,0,2,0,0,2,10
334,SIKKIM,2012,Student,5,2,0,0,0,7,6,4,3,0,0,13,20
335,SIKKIM,2012,Unemployed,0,5,0,0,0,5,0,6,8,0,0,14,19
336,SIKKIM,2012,Self-employed (Business activity),0,5,4,3,3,15,0,0,0,0,0,0,15
337,SIKKIM,2012,Professional Activity,0,2,2,5,2,11,0,0,0,0,0,0,11
338,SIKKIM,2012,Farming/Agriculture Activity,0,5,4,1,0,10,0,5,2,0,2,9,19
339,SIKKIM,2012,Others (Please Specify),0,2,2,0,5,9,0,2,5,3,1,11,20
340,SIKKIM,2012,Retired Person,0,0,0,0,0,0,0,0,0,0,0,0,0
341,SIKKIM,2012,Others (Please Specify),0,0,0,0,0,0,0,0,0,0,0,0,0
342,SIKKIM,2012,Total,5,35,26,20,10,96,6,35,30,9,5,85,181
343,SIKKIM,2012,Total Salaried,0,14,14,11,0,39,0,9,5,2,0,16,55
344,SIKKIM,2012,Total Self-employed,0,14,12,9,10,45,0,7,7,3,3,20,65
345,TAMIL NADU,2012,House Wife,0,0,0,0,0,0,3,1097,1031,575,205,2911,2911
346,TAMIL NADU,2012,Service (Government),0,39,101,93,4,237,0,17,22,8,0,47,284
347,TAMIL NADU,2012,Service (Private),0,202,381,244,34,861,0,85,72,25,4,186,1047
348,TAMIL NADU,2012,Public Sector Undertaking,0,41,76,67,7,191,0,22,27,17,1,67,258
349,TAMIL NADU,2012,Student,101,274,12,0,0,387,95,294,19,0,0,408,795
350,TAMIL NADU,2012,Unemployed,5,316,425,594,177,1517,4,175,141,83,18,421,1938
351,TAMIL NADU,2012,Self-employed (Business activity),0,164,262,226,78,730,0,20,29,19,3,71,801
352,TAMIL NADU,2012,Professional Activity,0,40,40,46,19,145,0,31,32,10,2,75,220
353,TAMIL NADU,2012,Farming/Agriculture Activity,0,68,137,123,81,409,0,31,32,22,5,90,499
354,TAMIL NADU,2012,Others (Please Specify),10,626,891,638,281,2446,23,241,174,108,40,586,3032
355,TAMIL NADU,2012,Retired Person,0,0,3,13,46,62,0,0,0,0,9,9,71
356,TAMIL NADU,2012,Others (Please Specify),33,993,1568,607,562,3763,57,534,198,247,272,1308,5071
357,TAMIL NADU,2012,Total,149,2763,3896,2651,1289,10748,182,2547,1777,1114,559,6179,16927
358,TAMIL NADU,2012,Total Salaried,0,282,558,404,45,1289,0,124,121,50,5,300,1589
359,TAMIL NADU,2012,Total Self-employed,10,898,1330,1033,459,3730,23,323,267,159,50,822,4552
360,TRIPURA,2012,House Wife,0,0,0,0,0,0,0,44,36,24,24,128,128
361,TRIPURA,2012,Service (Government),0,1,0,1,0,2,0,0,0,0,0,0,2
362,TRIPURA,2012,Service (Private),0,3,3,0,0,6,0,0,0,0,0,0,6
363,TRIPURA,2012,Public Sector Undertaking,0,0,0,0,0,0,0,0,0,0,0,0,0
364,TRIPURA,2012,Student,7,38,0,0,0,45,4,27,0,0,0,31,76
365,TRIPURA,2012,Unemployed,0,9,10,6,0,25,0,1,2,0,0,3,28
366,TRIPURA,2012,Self-employed (Business activity),0,2,15,23,15,55,0,0,0,0,0,0,55
367,TRIPURA,2012,Professional Activity,0,0,0,2,4,6,0,0,0,0,0,0,6
368,TRIPURA,2012,Farming/Agriculture Activity,0,5,6,5,2,18,0,0,0,0,0,0,18
369,TRIPURA,2012,Others (Please Specify),5,49,33,29,19,135,2,15,5,1,0,23,158
370,TRIPURA,2012,Retired Person,0,0,0,0,0,0,0,0,0,0,0,0,0
371,TRIPURA,2012,Others (Please Specify),4,63,144,46,11,268,9,29,42,12,7,99,367
372,TRIPURA,2012,Total,16,170,211,112,51,560,15,116,85,37,31,284,844
373,TRIPURA,2012,Total Salaried,0,4,3,1,0,8,0,0,0,0,0,0,8
374,TRIPURA,2012,Total Self-employed,5,56,54,59,40,214,2,15,5,1,0,23,237
375,UTTAR PRADESH,2012,House Wife,0,0,0,0,0,0,7,546,393,98,33,1077,1077
376,UTTAR PRADESH,2012,Service (Government),0,24,23,15,0,62,4,10,12,1,0,27,89
377,UTTAR PRADESH,2012,Service (Private),1,94,142,73,15,325,14,93,24,14,0,145,470
378,UTTAR PRADESH,2012,Public Sector Undertaking,0,12,8,11,0,31,0,6,10,9,0,25,56
379,UTTAR PRADESH,2012,Student,20,122,11,1,0,154,15,104,31,0,1,151,305
380,UTTAR PRADESH,2012,Unemployed,2,98,80,26,3,209,0,21,15,1,0,37,246
381,UTTAR PRADESH,2012,Self-employed (Business activity),0,85,80,32,13,210,0,6,6,5,0,17,227
382,UTTAR PRADESH,2012,Professional Activity,0,22,53,28,22,125,0,5,0,0,0,5,130
383,UTTAR PRADESH,2012,Farming/Agriculture Activity,2,161,230,170,56,619,2,36,44,27,17,126,745
384,UTTAR PRADESH,2012,Others (Please Specify),3,96,95,75,13,282,4,89,27,39,6,165,447
385,UTTAR PRADESH,2012,Retired Person,0,0,2,1,5,8,0,0,0,0,2,2,10
386,UTTAR PRADESH,2012,Others (Please Specify),3,131,118,142,76,470,8,73,29,24,16,150,620
387,UTTAR PRADESH,2012,Total,31,845,842,574,203,2495,54,989,591,218,75,1927,4422
388,UTTAR PRADESH,2012,Total Salaried,1,130,173,99,15,418,18,109,46,24,0,197,615
389,UTTAR PRADESH,2012,Total Self-employed,5,364,458,305,104,1236,6,136,77,71,23,313,1549
390,UTTARAKHAND,2012,House Wife,0,0,0,0,0,0,0,43,15,2,3,63,63
391,UTTARAKHAND,2012,Service (Government),0,1,6,0,0,7,0,0,0,0,0,0,7
392,UTTARAKHAND,2012,Service (Private),0,11,21,13,0,45,0,1,1,0,0,2,47
393,UTTARAKHAND,2012,Public Sector Undertaking,0,0,5,2,0,7,1,0,0,0,0,1,8
394,UTTARAKHAND,2012,Student,1,8,2,0,0,11,1,6,2,0,0,9,20
395,UTTARAKHAND,2012,Unemployed,0,10,11,0,0,21,0,4,1,0,0,5,26
396,UTTARAKHAND,2012,Self-employed (Business activity),0,7,5,6,2,20,0,0,0,0,0,0,20
397,UTTARAKHAND,2012,Professional Activity,0,0,0,1,0,1,0,0,0,0,0,0,1
398,UTTARAKHAND,2012,Farming/Agriculture Activity,0,3,5,1,3,12,0,1,1,0,0,2,14
399,UTTARAKHAND,2012,Others (Please Specify),1,6,18,5,2,32,3,7,4,2,0,16,48
400,UTTARAKHAND,2012,Retired Person,0,0,0,0,0,0,0,0,0,0,0,0,0
401,UTTARAKHAND,2012,Others (Please Specify),5,27,33,19,9,93,4,38,23,8,4,77,170
402,UTTARAKHAND,2012,Total,7,73,106,47,16,249,9,100,47,12,7,175,424
403,UTTARAKHAND,2012,Total Salaried,0,12,32,15,0,59,1,1,1,0,0,3,62
404,UTTARAKHAND,2012,Total Self-employed,1,16,28,13,7,65,3,8,5,2,0,18,83
405,WEST BENGAL,2012,House Wife,0,0,0,0,0,0,0,0,0,0,0,0,0
406,WEST BENGAL,2012,Service (Government),0,0,0,0,0,0,0,0,0,0,0,0,0
407,WEST BENGAL,2012,Service (Private),0,0,0,0,0,0,0,0,0,0,0,0,0
408,WEST BENGAL,2012,Public Sector Undertaking,0,0,0,0,0,0,0,0,0,0,0,0,0
409,WEST BENGAL,2012,Student,0,0,0,0,0,0,0,0,0,0,0,0,0
410,WEST BENGAL,2012,Unemployed,0,0,0,0,0,0,0,0,0,0,0,0,0
411,WEST BENGAL,2012,Self-employed (Business activity),0,0,0,0,0,0,0,0,0,0,0,0,0
412,WEST BENGAL,2012,Professional Activity,0,0,0,0,0,0,0,0,0,0,0,0,0
413,WEST BENGAL,2012,Farming/Agriculture Activity,0,0,0,0,0,0,0,0,0,0,0,0,0
414,WEST BENGAL,2012,Others (Please Specify),0,0,0,0,0,0,0,0,0,0,0,0,0
415,WEST BENGAL,2012,Retired Person,0,0,0,0,0,0,0,0,0,0,0,0,0
416,WEST BENGAL,2012,Others (Please Specify),0,0,0,0,0,0,0,0,0,0,0,0,0
417,WEST BENGAL,2012,Total,0,0,0,0,0,0,0,0,0,0,0,0,0
418,WEST BENGAL,2012,Total Salaried,0,0,0,0,0,0,0,0,0,0,0,0,0
419,WEST BENGAL,2012,Total Self-employed,0,0,0,0,0,0,0,0,0,0,0,0,0
420,TOTAL (STATES),2012,House Wife,0,0,0,0,0,0,28,9330,7100,3493,1428,21379,21379
421,TOTAL (STATES),2012,Service (Government),0,256,535,476,25,1292,6,122,125,44,3,300,1592
422,TOTAL (STATES),2012,Service (Private),21,3118,3764,2067,332,9302,22,747,530,214,43,1556,10858
423,TOTAL (STATES),2012,Public Sector Undertaking,0,464,681,447,82,1674,9,104,187,79,9,388,2062
424,TOTAL (STATES),2012,Student,514,2630,141,22,0,3307,542,2330,115,7,8,3002,6309
425,TOTAL (STATES),2012,Unemployed,35,2246,2558,1735,473,7047,26,636,456,227,60,1405,8452
426,TOTAL (STATES),2012,Self-employed (Business activity),10,1312,2049,1498,437,5306,4,118,127,73,10,332,5638
427,TOTAL (STATES),2012,Professional Activity,7,830,1167,805,223,3032,1,136,112,46,13,308,3340
428,TOTAL (STATES),2012,Farming/Agriculture Activity,6,2612,4368,3448,1490,11924,18,607,674,356,148,1803,13727
429,TOTAL (STATES),2012,Others (Please Specify),193,5214,6959,4745,1991,19102,210,1783,1227,735,341,4296,23398
430,TOTAL (STATES),2012,Retired Person,0,9,18,182,499,708,5,9,2,14,71,101,809
431,TOTAL (STATES),2012,Others (Please Specify),303,3916,5606,3493,1921,15239,285,1918,1234,853,617,4907,20146
432,TOTAL (STATES),2012,Total,1089,22607,27846,18918,7473,77933,1156,17840,11889,6141,2751,39777,117710
433,TOTAL (STATES),2012,Total Salaried,21,3838,4980,2990,439,12268,37,973,842,337,55,2244,14512
434,TOTAL (STATES),2012,Total Self-employed,216,9968,14543,10496,4141,39364,233,2644,2140,1210,512,6739,46103
435,A & N ISLANDS,2012,House Wife,0,0,0,0,0,0,0,11,11,2,4,28,28
436,A & N ISLANDS,2012,Service (Government),0,1,5,11,1,18,0,1,1,1,0,3,21
437,A & N ISLANDS,2012,Service (Private),0,12,21,9,7,49,0,1,0,0,0,1,50
438,A & N ISLANDS,2012,Public Sector Undertaking,0,0,0,0,0,0,0,0,0,0,0,0,0
439,A & N ISLANDS,2012,Student,2,2,0,0,0,4,1,4,0,0,0,5,9
440,A & N ISLANDS,2012,Unemployed,0,4,0,0,0,4,0,1,0,0,0,1,5
441,A & N ISLANDS,2012,Self-employed (Business activity),0,0,0,0,0,0,0,0,0,0,0,0,0
442,A & N ISLANDS,2012,Professional Activity,0,0,0,0,0,0,0,0,0,0,0,0,0
443,A & N ISLANDS,2012,Farming/Agriculture Activity,0,0,0,0,0,0,0,0,0,0,0,0,0
444,A & N ISLANDS,2012,Others (Please Specify),0,3,0,0,1,4,0,3,0,0,0,3,7
445,A & N ISLANDS,2012,Retired Person,0,0,0,0,1,1,0,0,0,0,0,0,1
446,A & N ISLANDS,2012,Others (Please Specify),0,0,0,0,0,0,0,0,0,0,0,0,0
447,A & N ISLANDS,2012,Total,2,22,26,20,10,80,1,21,12,3,4,41,121
448,A & N ISLANDS,2012,Total Salaried,0,13,26,20,8,67,0,2,1,1,0,4,71
449,A & N ISLANDS,2012,Total Self-employed,0,3,0,0,1,4,0,3,0,0,0,3,7
450,CHANDIGARH,2012,House Wife,0,0,0,0,0,0,0,9,8,0,1,18,18
451,CHANDIGARH,2012,Service (Government),0,1,5,2,0,8,0,0,0,0,0,0,8
452,CHANDIGARH,2012,Service (Private),0,12,13,3,0,28,0,1,0,0,0,1,29
453,CHANDIGARH,2012,Public Sector Undertaking,0,1,2,1,0,4,0,1,0,0,0,1,5
454,CHANDIGARH,2012,Student,2,3,0,0,0,5,1,11,0,0,0,12,17
455,CHANDIGARH,2012,Unemployed,0,9,3,0,0,12,0,1,0,0,0,1,13
456,CHANDIGARH,2012,Self-employed (Business activity),0,1,1,1,0,3,0,0,0,0,0,0,3
457,CHANDIGARH,2012,Professional Activity,0,0,0,0,0,0,0,0,0,0,0,0,0
458,CHANDIGARH,2012,Farming/Agriculture Activity,0,0,0,0,0,0,0,0,0,0,0,0,0
459,CHANDIGARH,2012,Others (Please Specify),0,6,7,1,1,15,0,3,0,0,0,3,18
460,CHANDIGARH,2012,Retired Person,0,0,0,0,0,0,0,0,0,0,0,0,0
461,CHANDIGARH,2012,Others (Please Specify),0,0,0,0,0,0,0,3,0,0,0,3,3
462,CHANDIGARH,2012,Total,2,33,31,8,1,75,1,29,8,0,1,39,114
463,CHANDIGARH,2012,Total Salaried,0,14,20,6,0,40,0,2,0,0,0,2,42
464,CHANDIGARH,2012,Total Self-employed,0,7,8,2,1,18,0,3,0,0,0,3,21
465,D & N HAVELI,2012,House Wife,0,0,0,0,0,0,0,6,2,2,3,13,13
466,D & N HAVELI,2012,Service (Government),0,0,0,0,0,0,0,0,0,0,0,0,0
467,D & N HAVELI,2012,Service (Private),0,11,13,2,0,26,0,2,0,0,0,2,28
468,D & N HAVELI,2012,Public Sector Undertaking,0,0,0,0,0,0,0,0,0,0,0,0,0
469,D & N HAVELI,2012,Student,0,0,0,0,0,0,0,6,0,0,0,6,6
470,D & N HAVELI,2012,Unemployed,0,1,0,0,1,2,0,2,0,0,0,2,4
471,D & N HAVELI,2012,Self-employed (Business activity),0,2,0,1,0,3,0,0,0,0,0,0,3
472,D & N HAVELI,2012,Professional Activity,0,0,0,0,0,0,0,0,0,0,0,0,0
473,D & N HAVELI,2012,Farming/Agriculture Activity,0,0,3,2,1,6,0,0,0,0,0,0,6
474,D & N HAVELI,2012,Others (Please Specify),0,0,0,0,0,0,0,0,0,0,0,0,0
475,D & N HAVELI,2012,Retired Person,0,0,0,0,0,0,0,0,0,0,0,0,0
476,D & N HAVELI,2012,Others (Please Specify),0,3,0,0,1,4,0,2,0,0,0,2,6
477,D & N HAVELI,2012,Total,0,17,16,5,3,41,0,18,2,2,3,25,66
478,D & N HAVELI,2012,Total Salaried,0,11,13,2,0,26,0,2,0,0,0,2,28
479,D & N HAVELI,2012,Total Self-employed,0,2,3,3,1,9,0,0,0,0,0,0,9
480,DAMAN & DIU,2012,House Wife,0,0,0,0,0,0,0,3,5,0,0,8,8
481,DAMAN & DIU,2012,Service (Government),0,0,0,0,0,0,0,0,0,0,0,0,0
482,DAMAN & DIU,2012,Service (Private),0,1,5,2,0,8,0,0,0,0,0,0,8
483,DAMAN & DIU,2012,Public Sector Undertaking,0,0,0,0,0,0,0,0,0,0,0,0,0
484,DAMAN & DIU,2012,Student,0,1,0,0,0,1,1,0,0,0,0,1,2
485,DAMAN & DIU,2012,Unemployed,0,0,1,0,0,1,0,0,0,0,0,0,1
486,DAMAN & DIU,2012,Self-employed (Business activity),0,0,0,0,0,0,0,0,0,0,0,0,0
487,DAMAN & DIU,2012,Professional Activity,0,0,0,0,0,0,0,0,0,0,0,0,0
488,DAMAN & DIU,2012,Farming/Agriculture Activity,0,0,0,0,0,0,0,0,0,0,0,0,0
489,DAMAN & DIU,2012,Others (Please Specify),0,0,1,0,0,1,0,0,0,0,0,0,1
490,DAMAN & DIU,2012,Retired Person,0,0,0,0,0,0,0,0,0,0,0,0,0
491,DAMAN & DIU,2012,Others (Please Specify),0,4,6,4,0,14,0,2,0,0,0,2,16
492,DAMAN & DIU,2012,Total,0,6,13,6,0,25,1,5,5,0,0,11,36
493,DAMAN & DIU,2012,Total Salaried,0,1,5,2,0,8,0,0,0,0,0,0,8
494,DAMAN & DIU,2012,Total Self-employed,0,0,1,0,0,1,0,0,0,0,0,0,1
495,DELHI (UT),2012,House Wife,0,0,0,0,0,0,0,194,114,36,11,355,355
496,DELHI (UT),2012,Service (Government),0,4,10,10,0,24,0,0,0,1,0,1,25
497,DELHI (UT),2012,Service (Private),0,120,107,35,2,264,0,14,2,0,0,16,280
498,DELHI (UT),2012,Public Sector Undertaking,0,15,20,3,0,38,0,3,0,0,0,3,41
499,DELHI (UT),2012,Student,19,118,0,0,0,137,22,101,6,0,0,129,266
500,DELHI (UT),2012,Unemployed,3,177,109,27,4,320,4,43,2,0,0,49,369
501,DELHI (UT),2012,Self-employed (Business activity),0,11,30,1,2,44,0,0,0,0,0,0,44
502,DELHI (UT),2012,Professional Activity,0,3,3,1,0,7,0,0,3,0,0,3,10
503,DELHI (UT),2012,Farming/Agriculture Activity,0,12,3,6,0,21,0,0,0,0,0,0,21
504,DELHI (UT),2012,Others (Please Specify),1,71,60,25,10,167,1,14,8,1,1,25,192
505,DELHI (UT),2012,Retired Person,0,0,1,2,14,17,0,0,0,0,0,0,17
506,DELHI (UT),2012,Others (Please Specify),3,90,83,27,4,207,4,40,24,3,1,72,279
507,DELHI (UT),2012,Total,26,621,426,137,36,1246,31,409,159,41,13,653,1899
508,DELHI (UT),2012,Total Salaried,0,139,137,48,2,326,0,17,2,1,0,20,346
509,DELHI (UT),2012,Total Self-employed,1,97,96,33,12,239,1,14,11,1,1,28,267
510,LAKSHADWEEP,2012,House Wife,0,0,0,0,0,0,0,0,0,0,0,0,0
511,LAKSHADWEEP,2012,Service (Government),0,0,0,0,0,0,0,0,0,0,0,0,0
512,LAKSHADWEEP,2012,Service (Private),0,0,0,0,0,0,0,0,0,0,0,0,0
513,LAKSHADWEEP,2012,Public Sector Undertaking,0,0,0,0,0,0,0,0,0,0,0,0,0
514,LAKSHADWEEP,2012,Student,0,0,0,0,0,0,0,0,0,0,0,0,0
515,LAKSHADWEEP,2012,Unemployed,0,0,0,0,0,0,0,0,0,0,0,0,0
516,LAKSHADWEEP,2012,Self-employed (Business activity),0,0,0,0,0,0,0,0,0,0,0,0,0
517,LAKSHADWEEP,2012,Professional Activity,0,0,0,0,0,0,0,0,0,0,0,0,0
518,LAKSHADWEEP,2012,Farming/Agriculture Activity,0,0,0,0,0,0,0,0,0,0,0,0,0
519,LAKSHADWEEP,2012,Others (Please Specify),0,0,0,0,0,0,0,0,0,0,0,0,0
520,LAKSHADWEEP,2012,Retired Person,0,0,0,0,0,0,0,0,0,0,0,0,0
521,LAKSHADWEEP,2012,Others (Please Specify),0,0,1,0,0,1,0,0,0,0,0,0,1
522,LAKSHADWEEP,2012,Total,0,0,1,0,0,1,0,0,0,0,0,0,1
523,LAKSHADWEEP,2012,Total Salaried,0,0,0,0,0,0,0,0,0,0,0,0,0
524,LAKSHADWEEP,2012,Total Self-employed,0,0,0,0,0,0,0,0,0,0,0,0,0
525,PUDUCHERRY,2012,House Wife,0,0,0,0,0,0,0,32,42,17,12,103,103
526,PUDUCHERRY,2012,Service (Government),0,5,5,5,1,16,0,2,1,1,0,4,20
527,PUDUCHERRY,2012,Service (Private),0,4,5,2,0,11,0,9,0,0,0,9,20
528,PUDUCHERRY,2012,Public Sector Undertaking,0,0,0,0,0,0,0,2,0,0,0,2,2
529,PUDUCHERRY,2012,Student,0,23,0,0,0,23,4,17,1,0,0,22,45
530,PUDUCHERRY,2012,Unemployed,0,14,11,13,26,64,0,10,2,1,6,19,83
531,PUDUCHERRY,2012,Self-employed (Business activity),0,1,7,5,3,16,0,0,2,0,0,2,18
532,PUDUCHERRY,2012,Professional Activity,0,23,47,29,6,105,0,0,1,0,0,1,106
533,PUDUCHERRY,2012,Farming/Agriculture Activity,0,0,0,0,0,0,0,0,0,0,0,0,0
534,PUDUCHERRY,2012,Others (Please Specify),0,22,52,48,7,129,0,0,5,1,0,6,135
535,PUDUCHERRY,2012,Retired Person,0,0,0,0,6,6,0,0,0,0,0,0,6
536,PUDUCHERRY,2012,Others (Please Specify),1,0,0,1,0,2,0,1,0,0,0,1,3
537,PUDUCHERRY,2012,Total,1,92,127,103,49,372,4,73,54,20,18,169,541
538,PUDUCHERRY,2012,Total Salaried,0,9,10,7,1,27,0,13,1,1,0,15,42
539,PUDUCHERRY,2012,Total Self-employed,0,46,106,82,16,250,0,0,8,1,0,9,259
540,TOTAL (UTs),2012,House Wife,0,0,0,0,0,0,0,255,182,57,31,525,525
541,TOTAL (UTs),2012,Service (Government),0,11,25,28,2,66,0,3,2,3,0,8,74
542,TOTAL (UTs),2012,Service (Private),0,160,164,53,9,386,0,27,2,0,0,29,415
543,TOTAL (UTs),2012,Public Sector Undertaking,0,16,22,4,0,42,0,6,0,0,0,6,48
544,TOTAL (UTs),2012,Student,23,147,0,0,0,170,29,139,7,0,0,175,345
545,TOTAL (UTs),2012,Unemployed,3,205,124,40,31,403,4,57,4,1,6,72,475
546,TOTAL (UTs),2012,Self-employed (Business activity),0,15,38,8,5,66,0,0,2,0,0,2,68
547,TOTAL (UTs),2012,Professional Activity,0,26,50,30,6,112,0,0,4,0,0,4,116
548,TOTAL (UTs),2012,Farming/Agriculture Activity,0,12,6,8,1,27,0,0,0,0,0,0,27
549,TOTAL (UTs),2012,Others (Please Specify),1,102,120,74,19,316,1,20,13,2,1,37,353
550,TOTAL (UTs),2012,Retired Person,0,0,1,2,21,24,0,0,0,0,0,0,24
551,TOTAL (UTs),2012,Others (Please Specify),4,97,90,32,5,228,4,48,24,3,1,80,308
552,TOTAL (UTs),2012,Total,31,791,640,279,99,1840,38,555,240,66,39,938,2778
553,TOTAL (UTs),2012,Total Salaried,0,187,211,85,11,494,0,36,4,3,0,43,537
554,TOTAL (UTs),2012,Total Self-employed,1,155,214,120,31,521,1,20,19,2,1,43,564
555,TOTAL (ALL INDIA),2012,House Wife,0,0,0,0,0,0,28,9585,7282,3550,1459,21904,21904
556,TOTAL (ALL INDIA),2012,Service (Government),0,267,560,504,27,1358,6,125,127,47,3,308,1666
557,TOTAL (ALL INDIA),2012,Service (Private),21,3278,3928,2120,341,9688,22,774,532,214,43,1585,11273
558,TOTAL (ALL INDIA),2012,Public Sector Undertaking,0,480,703,451,82,1716,9,110,187,79,9,394,2110
559,TOTAL (ALL INDIA),2012,Student,537,2777,141,22,0,3477,571,2469,122,7,8,3177,6654
560,TOTAL (ALL INDIA),2012,Unemployed,38,2451,2682,1775,504,7450,30,693,460,228,66,1477,8927
561,TOTAL (ALL INDIA),2012,Self-employed (Business activity),10,1327,2087,1506,442,5372,4,118,129,73,10,334,5706
562,TOTAL (ALL INDIA),2012,Professional Activity,7,856,1217,835,229,3144,1,136,116,46,13,312,3456
563,TOTAL (ALL INDIA),2012,Farming/Agriculture Activity,6,2624,4374,3456,1491,11951,18,607,674,356,148,1803,13754
564,TOTAL (ALL INDIA),2012,Others (Please Specify),194,5316,7079,4819,2010,19418,211,1803,1240,737,342,4333,23751
565,TOTAL (ALL INDIA),2012,Retired Person,0,9,19,184,520,732,5,9,2,14,71,101,833
566,TOTAL (ALL INDIA),2012,Others (Please Specify),307,4013,5696,3525,1926,15467,289,1966,1258,856,618,4987,20454
567,TOTAL (ALL INDIA),2012,Total,1120,23398,28486,19197,7572,79773,1194,18395,12129,6207,2790,40715,120488
568,TOTAL (ALL INDIA),2012,Total Salaried,21,4025,5191,3075,450,12762,37,1009,846,340,55,2287,15049
569,TOTAL (ALL INDIA),2012,Total Self-employed,217,10123,14757,10616,4172,39885,234,2664,2159,1212,513,6782,46667
0,TOTAL (ALL INDIA),2013,House Wife,0,0,0,0,0,0,26,9697,7809,3546,1664,22742,22742
1,TOTAL (ALL INDIA),2013,Service (Government),0,305,646,516,52,1519,0,131,97,47,17,292,1811
2,TOTAL (ALL INDIA),2013,Service (Private),2,3301,4352,2561,481,10697,6,809,552,238,53,1658,12355
3,TOTAL (ALL INDIA),2013,Public Sector Undertaking,0,633,859,547,102,2141,2,149,164,72,12,399,2540
4,TOTAL (ALL INDIA),2013,Student,709,3660,231,23,11,4634,614,3064,90,16,5,3789,8423
5,TOTAL (ALL INDIA),2013,Unemployed,15,2776,3102,1846,532,8271,17,698,467,234,81,1497,9768
6,TOTAL (ALL INDIA),2013,Self-employed (Business activity),1,1521,2774,1771,411,6478,3,170,230,77,10,490,6968
7,TOTAL (ALL INDIA),2013,Professional Activity,4,988,1495,934,210,3631,0,119,105,67,24,315,3946
8,TOTAL (ALL INDIA),2013,Farming/Agriculture Activity,13,2379,3834,3050,1213,10489,9,426,440,257,151,1283,11772
9,TOTAL (ALL INDIA),2013,Others (Please Specify),241,6247,8676,5938,2633,23735,259,1913,1416,813,412,4813,28548
10,TOTAL (ALL INDIA),2013,Retired Person,0,0,44,175,697,916,0,24,19,41,117,201,1117
11,TOTAL (ALL INDIA),2013,Others (Please Specify),561,4906,6086,4464,2015,18032,409,2452,2118,1252,546,6777,24809
12,TOTAL (ALL INDIA),2013,Total,1546,26716,32099,21825,8357,90543,1345,19652,13507,6660,3092,44256,134799
13,TOTAL (ALL INDIA),2013,Total Salaried,2,4239,5857,3624,635,14357,8,1089,813,357,82,2349,16706
14,TOTAL (ALL INDIA),2013,Total Self-employed,259,11135,16779,11693,4467,44333,271,2628,2191,1214,597,6901,51234
15,TOTAL (STATES),2013,House Wife,0,0,0,0,0,0,26,9465,7664,3504,1638,22297,22297
16,TOTAL (STATES),2013,Service (Government),0,290,619,481,52,1442,0,126,93,43,17,279,1721
17,TOTAL (STATES),2013,Service (Private),2,3184,4244,2501,470,10401,6,789,544,237,53,1629,12030
18,TOTAL (STATES),2013,Public Sector Undertaking,0,602,826,537,101,2066,2,141,163,71,12,389,2455
19,TOTAL (STATES),2013,Student,689,3520,229,23,11,4472,590,2909,85,16,5,3605,8077
20,TOTAL (STATES),2013,Unemployed,15,2608,2971,1787,502,7883,17,666,461,232,80,1456,9339
21,TOTAL (STATES),2013,Self-employed (Business activity),1,1481,2708,1714,406,6310,3,167,228,77,10,485,6795
22,TOTAL (STATES),2013,Professional Activity,4,984,1491,933,207,3619,0,119,105,67,24,315,3934
23,TOTAL (STATES),2013,Farming/Agriculture Activity,13,2376,3828,3038,1207,10462,9,425,440,257,151,1282,11744
24,TOTAL (STATES),2013,Others (Please Specify),241,6166,8532,5845,2618,23402,259,1883,1408,811,410,4771,28173
25,TOTAL (STATES),2013,Retired Person,0,0,43,172,676,891,0,24,19,41,117,201,1092
26,TOTAL (STATES),2013,Others (Please Specify),553,4738,5905,4387,1948,17531,404,2382,2073,1242,541,6642,24173
27,TOTAL (STATES),2013,Total,1518,25949,31396,21418,8198,88479,1316,19096,13283,6598,3058,43351,131830
28,TOTAL (STATES),2013,Total Salaried,2,4076,5689,3519,623,13909,8,1056,800,351,82,2297,16206
29,TOTAL (STATES),2013,Total Self-employed,259,11007,16559,11530,4438,43793,271,2594,2181,1212,595,6853,50646
30,TOTAL (UTs),2013,House Wife,0,0,0,0,0,0,0,232,145,42,26,445,445
31,TOTAL (UTs),2013,Service (Government),0,15,27,35,0,77,0,5,4,4,0,13,90
32,TOTAL (UTs),2013,Service (Private),0,117,108,60,11,296,0,20,8,1,0,29,325
33,TOTAL (UTs),2013,Public Sector Undertaking,0,31,33,10,1,75,0,8,1,1,0,10,85
34,TOTAL (UTs),2013,Student,20,140,2,0,0,162,24,155,5,0,0,184,346
35,TOTAL (UTs),2013,Unemployed,0,168,131,59,30,388,0,32,6,2,1,41,429
36,TOTAL (UTs),2013,Self-employed (Business activity),0,40,66,57,5,168,0,3,2,0,0,5,173
37,TOTAL (UTs),2013,Professional Activity,0,4,4,1,3,12,0,0,0,0,0,0,12
38,TOTAL (UTs),2013,Farming/Agriculture Activity,0,3,6,12,6,27,0,1,0,0,0,1,28
39,TOTAL (UTs),2013,Others (Please Specify),0,81,144,93,15,333,0,30,8,2,2,42,375
40,TOTAL (UTs),2013,Retired Person,0,0,1,3,21,25,0,0,0,0,0,0,25
41,TOTAL (UTs),2013,Others (Please Specify),8,168,181,77,67,501,5,70,45,10,5,135,636
42,TOTAL (UTs),2013,Total,28,767,703,407,159,2064,29,556,224,62,34,905,2969
43,TOTAL (UTs),2013,Total Salaried,0,163,168,105,12,448,0,33,13,6,0,52,500
44,TOTAL (UTs),2013,Total Self-employed,0,128,220,163,29,540,0,34,10,2,2,48,588
45,ANDHRA PRADESH,2013,House Wife,0,0,0,0,0,0,1,803,600,347,161,1912,1912
46,ANDHRA PRADESH,2013,Service (Government),0,41,56,49,3,149,0,11,8,1,0,20,169
47,ANDHRA PRADESH,2013,Service (Private),0,384,551,280,84,1299,3,156,88,29,19,295,1594
48,ANDHRA PRADESH,2013,Public Sector Undertaking,0,67,108,68,20,263,0,11,36,3,0,50,313
49,ANDHRA PRADESH,2013,Student,45,324,34,0,0,403,43,257,16,0,0,316,719
50,ANDHRA PRADESH,2013,Unemployed,0,170,226,125,42,563,0,33,39,3,1,76,639
51,ANDHRA PRADESH,2013,Self-employed (Business activity),0,190,305,188,41,724,0,5,34,2,0,41,765
52,ANDHRA PRADESH,2013,Professional Activity,0,150,222,103,22,497,0,7,9,5,7,28,525
53,ANDHRA PRADESH,2013,Farming/Agriculture Activity,0,345,598,467,144,1554,1,138,175,94,52,460,2014
54,ANDHRA PRADESH,2013,Others (Please Specify),5,700,965,715,311,2696,13,280,205,123,89,710,3406
55,ANDHRA PRADESH,2013,Retired Person,0,0,3,26,51,80,0,0,0,22,13,35,115
56,ANDHRA PRADESH,2013,Others (Please Specify),18,476,580,418,182,1674,20,222,290,145,85,762,2436
57,ANDHRA PRADESH,2013,Total,68,2847,3648,2439,900,9902,81,1923,1500,774,427,4705,14607
58,ANDHRA PRADESH,2013,Total Salaried,0,492,715,397,107,1711,3,178,132,33,19,365,2076
59,ANDHRA PRADESH,2013,Total Self-employed,5,1385,2090,1473,518,5471,14,430,423,224,148,1239,6710
60,ARUNACHAL PRADESH,2013,House Wife,0,0,0,0,0,0,0,9,8,2,1,20,20
61,ARUNACHAL PRADESH,2013,Service (Government),0,8,14,6,0,28,0,2,1,0,0,3,31
62,ARUNACHAL PRADESH,2013,Service (Private),0,7,3,6,0,16,0,0,1,0,0,1,17
63,ARUNACHAL PRADESH,2013,Public Sector Undertaking,0,0,1,1,0,2,0,0,0,0,0,0,2
64,ARUNACHAL PRADESH,2013,Student,3,13,1,0,0,17,2,8,1,0,0,11,28
65,ARUNACHAL PRADESH,2013,Unemployed,0,6,16,4,1,27,0,4,2,0,0,6,33
66,ARUNACHAL PRADESH,2013,Self-employed (Business activity),1,2,3,2,1,9,0,0,0,0,0,0,9
67,ARUNACHAL PRADESH,2013,Professional Activity,0,1,0,0,0,1,0,0,0,0,0,0,1
68,ARUNACHAL PRADESH,2013,Farming/Agriculture Activity,0,5,8,13,6,32,0,3,2,0,0,5,37
69,ARUNACHAL PRADESH,2013,Others (Please Specify),3,5,2,0,0,10,1,1,0,0,0,2,12
70,ARUNACHAL PRADESH,2013,Retired Person,0,0,0,0,0,0,0,0,0,0,0,0,0
71,ARUNACHAL PRADESH,2013,Others (Please Specify),0,9,17,1,2,29,1,4,4,1,0,10,39
72,ARUNACHAL PRADESH,2013,Total,7,56,65,33,10,171,4,31,19,3,1,58,229
73,ARUNACHAL PRADESH,2013,Total Salaried,0,15,18,13,0,46,0,2,2,0,0,4,50
74,ARUNACHAL PRADESH,2013,Total Self-employed,4,13,13,15,7,52,1,4,2,0,0,7,59
75,ASSAM,2013,House Wife,0,0,0,0,0,0,0,155,284,129,9,577,577
76,ASSAM,2013,Service (Government),0,0,6,1,0,7,0,3,1,0,0,4,11
77,ASSAM,2013,Service (Private),0,9,33,11,0,53,0,5,8,1,0,14,67
78,ASSAM,2013,Public Sector Undertaking,0,53,93,61,0,207,0,2,7,0,0,9,216
79,ASSAM,2013,Student,5,234,0,0,0,239,1,124,0,0,0,125,364
80,ASSAM,2013,Unemployed,0,4,59,133,3,199,0,5,3,4,0,12,211
81,ASSAM,2013,Self-employed (Business activity),0,98,177,95,4,374,0,10,11,3,0,24,398
82,ASSAM,2013,Professional Activity,0,38,68,39,3,148,0,3,2,2,0,7,155
83,ASSAM,2013,Farming/Agriculture Activity,0,74,124,77,3,278,0,11,9,7,0,27,305
84,ASSAM,2013,Others (Please Specify),1,281,449,143,10,884,1,61,41,20,0,123,1007
85,ASSAM,2013,Retired Person,0,0,0,0,4,4,0,0,0,0,0,0,4
86,ASSAM,2013,Others (Please Specify),5,32,81,44,3,165,5,20,27,17,4,73,238
87,ASSAM,2013,Total,11,823,1090,604,30,2558,7,399,393,183,13,995,3553
88,ASSAM,2013,Total Salaried,0,62,132,73,0,267,0,10,16,1,0,27,294
89,ASSAM,2013,Total Self-employed,1,491,818,354,20,1684,1,85,63,32,0,181,1865
90,BIHAR,2013,House Wife,0,0,0,0,0,0,0,55,93,18,2,168,168
91,BIHAR,2013,Service (Government),0,3,4,0,0,7,0,4,3,0,0,7,14
92,BIHAR,2013,Service (Private),0,18,20,14,0,52,0,11,8,3,0,22,74
93,BIHAR,2013,Public Sector Undertaking,0,0,0,0,0,0,0,0,0,0,0,0,0
94,BIHAR,2013,Student,18,22,6,0,0,46,12,20,4,0,0,36,82
95,BIHAR,2013,Unemployed,0,30,43,14,7,94,0,10,5,0,0,15,109
96,BIHAR,2013,Self-employed (Business activity),0,1,1,2,0,4,0,0,0,0,0,0,4
97,BIHAR,2013,Professional Activity,0,1,3,1,1,6,0,0,0,0,0,0,6
98,BIHAR,2013,Farming/Agriculture Activity,0,29,60,16,14,119,0,3,4,1,0,8,127
99,BIHAR,2013,Others (Please Specify),5,20,35,26,4,90,17,39,15,2,1,74,164
100,BIHAR,2013,Retired Person,0,0,0,0,0,0,0,0,0,0,0,0,0
101,BIHAR,2013,Others (Please Specify),3,52,81,53,23,212,18,39,28,8,4,97,309
102,BIHAR,2013,Total,26,176,253,126,49,630,47,181,160,32,7,427,1057
103,BIHAR,2013,Total Salaried,0,21,24,14,0,59,0,15,11,3,0,29,88
104,BIHAR,2013,Total Self-employed,5,51,99,45,19,219,17,42,19,3,1,82,301
105,CHHATTISGARH,2013,House Wife,0,0,0,0,0,0,2,458,275,118,44,897,897
106,CHHATTISGARH,2013,Service (Government),0,3,9,6,0,18,0,3,0,0,0,3,21
107,CHHATTISGARH,2013,Service (Private),1,69,88,30,8,196,1,9,11,9,4,34,230
108,CHHATTISGARH,2013,Public Sector Undertaking,0,14,14,13,0,41,0,0,0,0,0,0,41
109,CHHATTISGARH,2013,Student,35,130,3,0,0,168,42,149,0,0,0,191,359
110,CHHATTISGARH,2013,Unemployed,1,100,85,22,0,208,0,4,1,1,0,6,214
111,CHHATTISGARH,2013,Self-employed (Business activity),0,14,17,8,0,39,0,0,0,0,0,0,39
112,CHHATTISGARH,2013,Professional Activity,0,58,79,33,3,173,0,2,2,0,0,4,177
113,CHHATTISGARH,2013,Farming/Agriculture Activity,0,0,0,0,0,0,0,0,0,0,0,0,0
114,CHHATTISGARH,2013,Others (Please Specify),12,597,641,383,160,1793,14,119,88,41,22,284,2077
115,CHHATTISGARH,2013,Retired Person,0,0,32,32,19,83,0,0,11,8,2,21,104
116,CHHATTISGARH,2013,Others (Please Specify),33,316,309,170,101,929,33,121,71,73,50,348,1277
117,CHHATTISGARH,2013,Total,82,1301,1277,697,291,3648,92,865,459,250,122,1788,5436
118,CHHATTISGARH,2013,Total Salaried,1,86,111,49,8,255,1,12,11,9,4,37,292
119,CHHATTISGARH,2013,Total Self-employed,12,669,737,424,163,2005,14,121,90,41,22,288,2293
120,GOA,2013,House Wife,0,0,0,0,0,0,1,17,24,7,7,56,56
121,GOA,2013,Service (Government),0,0,2,2,0,4,0,0,2,0,0,2,6
122,GOA,2013,Service (Private),0,27,24,8,0,59,0,3,2,0,0,5,64
123,GOA,2013,Public Sector Undertaking,0,0,0,0,0,0,0,1,0,0,0,1,1
124,GOA,2013,Student,0,12,0,0,0,12,2,9,0,0,0,11,23
125,GOA,2013,Unemployed,0,20,19,23,11,73,0,8,2,0,1,11,84
126,GOA,2013,Self-employed (Business activity),0,7,6,4,0,17,0,0,0,0,0,0,17
127,GOA,2013,Professional Activity,0,1,2,2,0,5,0,0,0,0,0,0,5
128,GOA,2013,Farming/Agriculture Activity,0,0,0,1,0,1,0,0,0,0,0,0,1
129,GOA,2013,Others (Please Specify),0,4,6,5,2,17,0,2,0,0,0,2,19
130,GOA,2013,Retired Person,0,0,1,1,2,4,0,0,0,0,0,0,4
131,GOA,2013,Others (Please Specify),0,11,20,2,5,38,2,6,2,0,0,10,48
132,GOA,2013,Total,0,82,80,48,20,230,5,46,32,7,8,98,328
133,GOA,2013,Total Salaried,0,27,26,10,0,63,0,4,4,0,0,8,71
134,GOA,2013,Total Self-employed,0,12,14,12,2,40,0,2,0,0,0,2,42
135,GUJARAT,2013,House Wife,0,0,0,0,0,0,3,754,575,295,105,1732,1732
136,GUJARAT,2013,Service (Government),0,20,58,31,0,109,0,10,7,1,0,18,127
137,GUJARAT,2013,Service (Private),0,228,284,145,15,672,0,48,28,12,0,88,760
138,GUJARAT,2013,Public Sector Undertaking,0,39,37,26,4,106,1,13,15,7,0,36,142
139,GUJARAT,2013,Student,19,170,8,0,0,197,20,165,4,0,0,189,386
140,GUJARAT,2013,Unemployed,0,173,231,117,3,524,1,23,14,5,3,46,570
141,GUJARAT,2013,Self-employed (Business activity),0,108,165,91,23,387,0,6,5,6,0,17,404
142,GUJARAT,2013,Professional Activity,1,215,237,169,32,654,0,34,8,12,2,56,710
143,GUJARAT,2013,Farming/Agriculture Activity,2,158,181,121,27,489,0,42,30,15,6,93,582
144,GUJARAT,2013,Others (Please Specify),1,196,233,138,42,610,1,48,24,9,9,91,701
145,GUJARAT,2013,Retired Person,0,0,0,34,136,170,0,2,1,0,50,53,223
146,GUJARAT,2013,Others (Please Specify),22,188,229,135,40,614,14,112,45,27,17,215,829
147,GUJARAT,2013,Total,45,1495,1663,1007,322,4532,40,1257,756,389,192,2634,7166
148,GUJARAT,2013,Total Salaried,0,287,379,202,19,887,1,71,50,20,0,142,1029
149,GUJARAT,2013,Total Self-employed,4,677,816,519,124,2140,1,130,67,42,17,257,2397
150,HARYANA,2013,House Wife,0,0,0,0,0,0,0,239,112,38,12,401,401
151,HARYANA,2013,Service (Government),0,7,12,18,0,37,0,1,2,0,0,3,40
152,HARYANA,2013,Service (Private),1,84,112,53,4,254,0,14,13,6,0,33,287
153,HARYANA,2013,Public Sector Undertaking,0,48,43,18,0,109,0,2,7,2,0,11,120
154,HARYANA,2013,Student,18,97,6,0,0,121,10,44,0,1,1,56,177
155,HARYANA,2013,Unemployed,1,111,110,63,7,292,0,8,5,5,1,19,311
156,HARYANA,2013,Self-employed (Business activity),0,32,55,8,2,97,0,0,0,0,0,0,97
157,HARYANA,2013,Professional Activity,0,8,12,8,1,29,0,0,0,0,0,0,29
158,HARYANA,2013,Farming/Agriculture Activity,0,79,110,114,33,336,0,13,12,12,1,38,374
159,HARYANA,2013,Others (Please Specify),20,121,214,197,77,629,18,45,29,18,15,125,754
160,HARYANA,2013,Retired Person,0,0,1,2,1,4,0,0,0,2,0,2,6
161,HARYANA,2013,Others (Please Specify),18,184,196,146,50,594,15,45,38,17,11,126,720
162,HARYANA,2013,Total,58,771,871,627,175,2502,43,411,218,101,41,814,3316
163,HARYANA,2013,Total Salaried,1,139,167,89,4,400,0,17,22,8,0,47,447
164,HARYANA,2013,Total Self-employed,20,240,391,327,113,1091,18,58,41,30,16,163,1254
165,HIMACHAL PRADESH,2013,House Wife,0,0,0,0,0,0,0,41,30,15,2,88,88
166,HIMACHAL PRADESH,2013,Service (Government),0,1,8,9,0,18,0,0,2,0,0,2,20
167,HIMACHAL PRADESH,2013,Service (Private),0,8,12,6,3,29,0,1,4,1,0,6,35
168,HIMACHAL PRADESH,2013,Public Sector Undertaking,0,6,6,4,1,17,0,1,3,1,0,5,22
169,HIMACHAL PRADESH,2013,Student,4,21,0,0,0,25,2,20,0,0,0,22,47
170,HIMACHAL PRADESH,2013,Unemployed,0,27,22,3,1,53,0,1,2,1,0,4,57
171,HIMACHAL PRADESH,2013,Self-employed (Business activity),0,4,7,3,1,15,0,1,0,1,0,2,17
172,HIMACHAL PRADESH,2013,Professional Activity,0,2,2,2,1,7,0,1,1,0,0,2,9
173,HIMACHAL PRADESH,2013,Farming/Agriculture Activity,0,6,13,11,2,32,0,0,1,0,0,1,33
174,HIMACHAL PRADESH,2013,Others (Please Specify),0,22,21,7,4,54,0,6,1,2,2,11,65
175,HIMACHAL PRADESH,2013,Retired Person,0,0,0,0,5,5,0,0,0,0,0,0,5
176,HIMACHAL PRADESH,2013,Others (Please Specify),1,45,31,26,6,109,4,18,9,10,6,47,156
177,HIMACHAL PRADESH,2013,Total,5,142,122,71,24,364,6,90,53,31,10,190,554
178,HIMACHAL PRADESH,2013,Total Salaried,0,15,26,19,4,64,0,2,9,2,0,13,77
179,HIMACHAL PRADESH,2013,Total Self-employed,0,34,43,23,8,108,0,8,3,3,2,16,124
180,JAMMU & KASHMIR,2013,House Wife,0,0,0,0,0,0,0,17,43,6,5,71,71
181,JAMMU & KASHMIR,2013,Service (Government),0,4,5,6,0,15,0,0,0,0,0,0,15
182,JAMMU & KASHMIR,2013,Service (Private),0,1,0,4,2,7,0,0,0,0,0,0,7
183,JAMMU & KASHMIR,2013,Public Sector Undertaking,0,0,3,2,5,10,0,0,0,0,0,0,10
184,JAMMU & KASHMIR,2013,Student,1,13,0,0,0,14,1,14,0,0,0,15,29
185,JAMMU & KASHMIR,2013,Unemployed,0,5,12,1,0,18,0,10,3,0,0,13,31
186,JAMMU & KASHMIR,2013,Self-employed (Business activity),0,0,6,2,3,11,0,0,0,0,0,0,11
187,JAMMU & KASHMIR,2013,Professional Activity,0,0,2,0,0,2,0,0,0,0,0,0,2
188,JAMMU & KASHMIR,2013,Farming/Agriculture Activity,0,3,7,6,2,18,0,0,0,0,0,0,18
189,JAMMU & KASHMIR,2013,Others (Please Specify),0,6,27,22,4,59,2,23,5,1,0,31,90
190,JAMMU & KASHMIR,2013,Retired Person,0,0,0,0,0,0,0,0,0,0,0,0,0
191,JAMMU & KASHMIR,2013,Others (Please Specify),0,6,7,1,0,14,0,1,1,2,0,4,18
192,JAMMU & KASHMIR,2013,Total,1,38,69,44,16,168,3,65,52,9,5,134,302
193,JAMMU & KASHMIR,2013,Total Salaried,0,5,8,12,7,32,0,0,0,0,0,0,32
194,JAMMU & KASHMIR,2013,Total Self-employed,0,9,42,30,9,90,2,23,5,1,0,31,121
195,JHARKHAND,2013,House Wife,0,0,0,0,0,0,0,70,90,29,4,193,193
196,JHARKHAND,2013,Service (Government),0,4,7,4,0,15,0,0,1,0,0,1,16
197,JHARKHAND,2013,Service (Private),0,34,44,24,2,104,0,2,8,1,0,11,115
198,JHARKHAND,2013,Public Sector Undertaking,0,3,3,6,1,13,0,7,0,0,0,7,20
199,JHARKHAND,2013,Student,7,84,8,0,0,99,8,41,2,0,0,51,150
200,JHARKHAND,2013,Unemployed,0,35,51,33,6,125,0,10,1,3,0,14,139
201,JHARKHAND,2013,Self-employed (Business activity),0,3,16,13,3,35,0,1,0,0,0,1,36
202,JHARKHAND,2013,Professional Activity,0,5,11,0,2,18,0,3,3,0,0,6,24
203,JHARKHAND,2013,Farming/Agriculture Activity,0,30,34,69,2,135,0,2,2,3,0,7,142
204,JHARKHAND,2013,Others (Please Specify),0,28,25,18,12,83,0,21,10,6,1,38,121
205,JHARKHAND,2013,Retired Person,0,0,0,0,3,3,0,0,0,0,0,0,3
206,JHARKHAND,2013,Others (Please Specify),43,92,96,82,41,354,14,49,34,38,12,147,501
207,JHARKHAND,2013,Total,50,318,295,249,72,984,22,206,151,80,17,476,1460
208,JHARKHAND,2013,Total Salaried,0,41,54,34,3,132,0,9,9,1,0,19,151
209,JHARKHAND,2013,Total Self-employed,0,66,86,100,19,271,0,27,15,9,1,52,323
210,KARNATAKA,2013,House Wife,0,0,0,0,0,0,3,703,583,258,127,1674,1674
211,KARNATAKA,2013,Service (Government),0,31,66,67,19,183,0,29,13,6,4,52,235
212,KARNATAKA,2013,Service (Private),0,307,339,204,37,887,0,105,54,23,4,186,1073
213,KARNATAKA,2013,Public Sector Undertaking,0,45,52,48,14,159,0,20,11,8,6,45,204
214,KARNATAKA,2013,Student,59,283,27,7,10,386,46,224,4,8,4,286,672
215,KARNATAKA,2013,Unemployed,3,226,265,136,60,690,2,59,16,8,5,90,780
216,KARNATAKA,2013,Self-employed (Business activity),0,134,213,145,32,524,3,9,27,14,4,57,581
217,KARNATAKA,2013,Professional Activity,3,64,59,58,19,203,0,2,4,3,1,10,213
218,KARNATAKA,2013,Farming/Agriculture Activity,0,220,461,374,177,1232,3,38,49,43,38,171,1403
219,KARNATAKA,2013,Others (Please Specify),19,579,985,589,182,2354,42,171,179,123,34,549,2903
220,KARNATAKA,2013,Retired Person,0,0,0,2,41,43,0,0,0,0,3,3,46
221,KARNATAKA,2013,Others (Please Specify),28,310,348,277,109,1072,14,111,153,81,51,410,1482
222,KARNATAKA,2013,Total,112,2199,2815,1907,700,7733,113,1471,1093,575,281,3533,11266
223,KARNATAKA,2013,Total Salaried,0,383,457,319,70,1229,0,154,78,37,14,283,1512
224,KARNATAKA,2013,Total Self-employed,22,997,1718,1166,410,4313,48,220,259,183,77,787,5100
225,KERALA,2013,House Wife,0,0,0,0,0,0,0,196,326,302,221,1045,1045
226,KERALA,2013,Service (Government),0,10,28,29,17,84,0,4,7,10,11,32,116
227,KERALA,2013,Service (Private),0,122,221,199,38,580,0,21,28,11,4,64,644
228,KERALA,2013,Public Sector Undertaking,0,4,40,35,2,81,0,2,7,10,1,20,101
229,KERALA,2013,Student,38,82,6,8,0,134,43,122,2,0,0,167,301
230,KERALA,2013,Unemployed,0,87,249,191,120,647,0,37,37,24,31,129,776
231,KERALA,2013,Self-employed (Business activity),0,49,169,149,67,434,0,4,6,4,1,15,449
232,KERALA,2013,Professional Activity,0,37,61,75,14,187,0,5,7,6,1,19,206
233,KERALA,2013,Farming/Agriculture Activity,0,94,243,341,204,882,0,27,15,17,31,90,972
234,KERALA,2013,Others (Please Specify),0,471,776,796,502,2545,0,83,49,49,84,265,2810
235,KERALA,2013,Retired Person,0,0,1,27,86,114,0,0,0,7,17,24,138
236,KERALA,2013,Others (Please Specify),0,168,279,342,224,1013,0,23,7,23,22,75,1088
237,KERALA,2013,Total,38,1124,2073,2192,1274,6701,43,524,491,463,424,1945,8646
238,KERALA,2013,Total Salaried,0,136,289,263,57,745,0,27,42,31,16,116,861
239,KERALA,2013,Total Self-employed,0,651,1249,1361,787,4048,0,119,77,76,117,389,4437
240,MADHYA PRADESH,2013,House Wife,0,0,0,0,0,0,9,1300,704,229,133,2375,2375
241,MADHYA PRADESH,2013,Service (Government),0,31,37,24,1,93,0,5,6,3,1,15,108
242,MADHYA PRADESH,2013,Service (Private),0,223,250,111,18,602,0,37,35,9,2,83,685
243,MADHYA PRADESH,2013,Public Sector Undertaking,0,30,41,18,8,97,0,13,3,2,1,19,116
244,MADHYA PRADESH,2013,Student,77,251,28,0,1,357,66,239,2,3,0,310,667
245,MADHYA PRADESH,2013,Unemployed,5,140,95,59,23,322,0,18,8,7,2,35,357
246,MADHYA PRADESH,2013,Self-employed (Business activity),0,126,132,87,27,372,0,4,3,3,1,11,383
247,MADHYA PRADESH,2013,Professional Activity,0,97,111,59,34,301,0,23,28,14,6,71,372
248,MADHYA PRADESH,2013,Farming/Agriculture Activity,5,312,349,232,99,997,0,42,35,12,4,93,1090
249,MADHYA PRADESH,2013,Others (Please Specify),62,612,541,331,173,1719,28,180,91,35,15,349,2068
250,MADHYA PRADESH,2013,Retired Person,0,0,1,0,21,22,0,20,2,0,0,22,44
251,MADHYA PRADESH,2013,Others (Please Specify),42,241,249,161,95,788,55,167,94,64,13,393,1181
252,MADHYA PRADESH,2013,Total,191,2063,1834,1082,500,5670,158,2048,1011,381,178,3776,9446
253,MADHYA PRADESH,2013,Total Salaried,0,284,328,153,27,792,0,55,44,14,4,117,909
254,MADHYA PRADESH,2013,Total Self-employed,67,1147,1133,709,333,3389,28,249,157,64,26,524,3913
255,MAHARASHTRA,2013,House Wife,0,0,0,0,0,0,0,1539,1110,415,284,3348,3348
256,MAHARASHTRA,2013,Service (Government),0,37,87,76,2,202,0,17,11,1,0,29,231
257,MAHARASHTRA,2013,Service (Private),0,720,850,481,99,2150,0,81,34,19,0,134,2284
258,MAHARASHTRA,2013,Public Sector Undertaking,0,34,61,45,11,151,0,4,2,2,0,8,159
259,MAHARASHTRA,2013,Student,75,474,16,1,0,566,92,479,2,2,0,575,1141
260,MAHARASHTRA,2013,Unemployed,1,397,369,144,36,947,0,60,6,2,1,69,1016
261,MAHARASHTRA,2013,Self-employed (Business activity),0,112,263,112,30,517,0,7,29,1,1,38,555
262,MAHARASHTRA,2013,Professional Activity,0,117,156,101,35,409,0,4,9,5,3,21,430
263,MAHARASHTRA,2013,Farming/Agriculture Activity,1,629,1157,841,392,3020,0,38,41,34,13,126,3146
264,MAHARASHTRA,2013,Others (Please Specify),7,893,1160,738,364,3162,8,134,74,36,25,277,3439
265,MAHARASHTRA,2013,Retired Person,0,0,0,13,127,140,0,0,0,0,2,2,142
266,MAHARASHTRA,2013,Others (Please Specify),7,148,248,158,67,628,6,22,45,27,3,103,731
267,MAHARASHTRA,2013,Total,91,3561,4367,2710,1163,11892,106,2385,1363,544,332,4730,16622
268,MAHARASHTRA,2013,Total Salaried,0,791,998,602,112,2503,0,102,47,22,0,171,2674
269,MAHARASHTRA,2013,Total Self-employed,8,1751,2736,1792,821,7108,8,183,153,76,42,462,7570
270,MANIPUR,2013,House Wife,0,0,0,0,0,0,0,7,1,1,0,9,9
271,MANIPUR,2013,Service (Government),0,1,4,0,0,5,0,1,0,0,0,1,6
272,MANIPUR,2013,Service (Private),0,0,0,0,0,0,0,0,0,0,0,0,0
273,MANIPUR,2013,Public Sector Undertaking,0,0,0,0,0,0,0,0,0,0,0,0,0
274,MANIPUR,2013,Student,1,0,0,0,0,1,1,2,0,0,0,3,4
275,MANIPUR,2013,Unemployed,0,0,2,1,1,4,0,0,0,0,0,0,4
276,MANIPUR,2013,Self-employed (Business activity),0,0,0,0,0,0,0,0,0,0,0,0,0
277,MANIPUR,2013,Professional Activity,0,0,0,0,0,0,0,0,0,0,0,0,0
278,MANIPUR,2013,Farming/Agriculture Activity,0,0,1,0,0,1,0,0,0,0,0,0,1
279,MANIPUR,2013,Others (Please Specify),0,0,0,0,0,0,0,0,0,0,0,0,0
280,MANIPUR,2013,Retired Person,0,0,0,0,0,0,0,0,0,0,0,0,0
281,MANIPUR,2013,Others (Please Specify),0,6,3,2,0,11,1,0,1,0,0,2,13
282,MANIPUR,2013,Total,1,7,10,3,1,22,2,10,2,1,0,15,37
283,MANIPUR,2013,Total Salaried,0,1,4,0,0,5,0,1,0,0,0,1,6
284,MANIPUR,2013,Total Self-employed,0,0,1,0,0,1,0,0,0,0,0,0,1
285,MEGHALAYA,2013,House Wife,0,0,0,0,0,0,0,7,9,1,0,17,17
286,MEGHALAYA,2013,Service (Government),0,0,5,2,0,7,0,0,0,0,0,0,7
287,MEGHALAYA,2013,Service (Private),0,5,3,2,0,10,0,0,0,0,0,0,10
288,MEGHALAYA,2013,Public Sector Undertaking,0,0,0,0,2,2,0,0,0,0,0,0,2
289,MEGHALAYA,2013,Student,1,13,0,0,0,14,6,10,0,0,0,16,30
290,MEGHALAYA,2013,Unemployed,0,20,9,1,1,31,0,2,0,0,0,2,33
291,MEGHALAYA,2013,Self-employed (Business activity),0,2,4,4,0,10,0,1,0,0,0,1,11
292,MEGHALAYA,2013,Professional Activity,0,0,0,0,0,0,0,0,0,0,0,0,0
293,MEGHALAYA,2013,Farming/Agriculture Activity,0,0,3,1,0,4,0,1,0,0,0,1,5
294,MEGHALAYA,2013,Others (Please Specify),0,6,1,0,0,7,0,0,0,0,0,0,7
295,MEGHALAYA,2013,Retired Person,0,0,0,0,0,0,0,0,0,0,0,0,0
296,MEGHALAYA,2013,Others (Please Specify),2,5,3,1,0,11,0,3,0,1,0,4,15
297,MEGHALAYA,2013,Total,3,51,28,11,3,96,6,24,9,2,0,41,137
298,MEGHALAYA,2013,Total Salaried,0,5,8,4,2,19,0,0,0,0,0,0,19
299,MEGHALAYA,2013,Total Self-employed,0,8,8,5,0,21,0,2,0,0,0,2,23
300,MIZORAM,2013,House Wife,0,0,0,0,0,0,0,1,3,1,0,5,5
301,MIZORAM,2013,Service (Government),0,3,2,1,0,6,0,0,0,0,0,0,6
302,MIZORAM,2013,Service (Private),0,4,1,2,0,7,0,0,0,0,0,0,7
303,MIZORAM,2013,Public Sector Undertaking,0,0,0,0,0,0,0,0,0,0,0,0,0
304,MIZORAM,2013,Student,1,5,0,0,0,6,0,2,0,0,0,2,8
305,MIZORAM,2013,Unemployed,0,23,11,4,0,38,0,1,1,0,0,2,40
306,MIZORAM,2013,Self-employed (Business activity),0,3,0,1,0,4,0,0,0,0,0,0,4
307,MIZORAM,2013,Professional Activity,0,0,0,1,0,1,0,0,0,0,0,0,1
308,MIZORAM,2013,Farming/Agriculture Activity,0,1,4,1,0,6,0,0,0,0,0,0,6
309,MIZORAM,2013,Others (Please Specify),1,2,2,1,0,6,2,1,0,0,0,3,9
310,MIZORAM,2013,Retired Person,0,0,0,0,1,1,0,0,0,0,0,0,1
311,MIZORAM,2013,Others (Please Specify),1,3,0,0,0,4,0,2,0,2,0,4,8
312,MIZORAM,2013,Total,3,44,20,11,1,79,2,7,4,3,0,16,95
313,MIZORAM,2013,Total Salaried,0,7,3,3,0,13,0,0,0,0,0,0,13
314,MIZORAM,2013,Total Self-employed,1,6,6,4,0,17,2,1,0,0,0,3,20
315,NAGALAND,2013,House Wife,0,0,0,0,0,0,0,3,0,1,2,6,6
316,NAGALAND,2013,Service (Government),0,0,4,0,0,4,0,0,0,0,0,0,4
317,NAGALAND,2013,Service (Private),0,0,0,0,0,0,0,0,0,0,0,0,0
318,NAGALAND,2013,Public Sector Undertaking,0,0,0,0,0,0,0,0,0,0,0,0,0
319,NAGALAND,2013,Student,1,2,0,0,0,3,0,3,0,0,0,3,6
320,NAGALAND,2013,Unemployed,0,0,2,0,0,2,0,0,0,0,0,0,2
321,NAGALAND,2013,Self-employed (Business activity),0,1,0,0,0,1,0,0,0,0,0,0,1
322,NAGALAND,2013,Professional Activity,0,2,0,0,0,2,0,0,0,0,0,0,2
323,NAGALAND,2013,Farming/Agriculture Activity,0,0,1,0,1,2,0,0,0,0,0,0,2
324,NAGALAND,2013,Others (Please Specify),0,2,8,1,0,11,0,1,2,0,0,3,14
325,NAGALAND,2013,Retired Person,0,0,0,0,0,0,0,0,0,0,0,0,0
326,NAGALAND,2013,Others (Please Specify),0,0,0,0,0,0,0,0,0,0,0,0,0
327,NAGALAND,2013,Total,1,7,15,1,1,25,0,7,2,1,2,12,37
328,NAGALAND,2013,Total Salaried,0,0,4,0,0,4,0,0,0,0,0,0,4
329,NAGALAND,2013,Total Self-employed,0,5,9,1,1,16,0,1,2,0,0,3,19
330,ODISHA,2013,House Wife,0,0,0,0,0,0,0,236,261,137,51,685,685
331,ODISHA,2013,Service (Government),0,13,41,16,3,73,0,5,8,7,0,20,93
332,ODISHA,2013,Service (Private),0,98,148,80,32,358,2,32,47,15,8,104,462
333,ODISHA,2013,Public Sector Undertaking,0,35,42,36,5,118,0,9,17,8,0,34,152
334,ODISHA,2013,Student,30,143,0,0,0,173,30,110,0,0,0,140,313
335,ODISHA,2013,Unemployed,0,129,139,58,21,347,0,54,31,8,0,93,440
336,ODISHA,2013,Self-employed (Business activity),0,53,134,84,30,301,0,16,18,13,0,47,348
337,ODISHA,2013,Professional Activity,0,5,12,18,1,36,0,0,2,1,0,3,39
338,ODISHA,2013,Farming/Agriculture Activity,0,18,58,51,16,143,0,2,1,2,2,7,150
339,ODISHA,2013,Others (Please Specify),43,187,208,231,184,853,77,162,142,90,52,523,1376
340,ODISHA,2013,Retired Person,0,0,0,0,13,13,0,0,0,0,4,4,17
341,ODISHA,2013,Others (Please Specify),80,257,258,196,66,857,30,106,105,67,12,320,1177
342,ODISHA,2013,Total,153,938,1040,770,371,3272,139,732,632,348,129,1980,5252
343,ODISHA,2013,Total Salaried,0,146,231,132,40,549,2,46,72,30,8,158,707
344,ODISHA,2013,Total Self-employed,43,263,412,384,231,1333,77,180,163,106,54,580,1913
345,PUNJAB,2013,House Wife,0,0,0,0,0,0,0,73,50,22,11,156,156
346,PUNJAB,2013,Service (Government),0,5,13,5,0,23,0,1,3,0,0,4,27
347,PUNJAB,2013,Service (Private),0,55,40,24,6,125,0,11,0,0,0,11,136
348,PUNJAB,2013,Public Sector Undertaking,0,5,2,0,0,7,0,1,0,0,0,1,8
349,PUNJAB,2013,Student,4,37,1,0,0,42,2,31,0,0,0,33,75
350,PUNJAB,2013,Unemployed,0,44,24,6,6,80,0,9,1,2,0,12,92
351,PUNJAB,2013,Self-employed (Business activity),0,6,15,12,1,34,0,0,0,0,0,0,34
352,PUNJAB,2013,Professional Activity,0,7,8,9,0,24,0,1,0,0,0,1,25
353,PUNJAB,2013,Farming/Agriculture Activity,0,33,30,15,5,83,0,0,0,0,0,0,83
354,PUNJAB,2013,Others (Please Specify),0,58,61,33,23,175,2,9,3,2,0,16,191
355,PUNJAB,2013,Retired Person,0,0,1,3,7,11,0,2,0,1,0,3,14
356,PUNJAB,2013,Others (Please Specify),2,42,29,24,12,109,2,13,6,0,1,22,131
357,PUNJAB,2013,Total,6,292,224,131,60,713,6,151,63,27,12,259,972
358,PUNJAB,2013,Total Salaried,0,65,55,29,6,155,0,13,3,0,0,16,171
359,PUNJAB,2013,Total Self-employed,0,104,114,69,29,316,2,10,3,2,0,17,333
360,RAJASTHAN,2013,House Wife,0,0,0,0,0,0,2,353,281,109,42,787,787
361,RAJASTHAN,2013,Service (Government),0,13,16,10,1,40,0,3,1,0,1,5,45
362,RAJASTHAN,2013,Service (Private),0,162,166,83,5,416,0,11,13,4,2,30,446
363,RAJASTHAN,2013,Public Sector Undertaking,0,7,5,3,0,15,0,1,3,0,0,4,19
364,RAJASTHAN,2013,Student,20,117,9,0,0,146,10,88,12,0,0,110,256
365,RAJASTHAN,2013,Unemployed,0,58,83,33,7,181,0,11,14,7,2,34,215
366,RAJASTHAN,2013,Self-employed (Business activity),0,32,88,36,4,160,0,5,7,2,0,14,174
367,RAJASTHAN,2013,Professional Activity,0,11,40,29,1,81,0,0,1,0,0,1,82
368,RAJASTHAN,2013,Farming/Agriculture Activity,0,96,99,56,16,267,0,14,9,2,0,25,292
369,RAJASTHAN,2013,Others (Please Specify),0,312,437,256,43,1048,1,43,86,89,2,221,1269
370,RAJASTHAN,2013,Retired Person,0,0,1,3,6,10,0,0,0,0,0,0,10
371,RAJASTHAN,2013,Others (Please Specify),27,306,347,265,68,1013,14,83,87,55,13,252,1265
372,RAJASTHAN,2013,Total,47,1114,1291,774,151,3377,27,612,514,268,62,1483,4860
373,RAJASTHAN,2013,Total Salaried,0,182,187,96,6,471,0,15,17,4,3,39,510
374,RAJASTHAN,2013,Total Self-employed,0,451,664,377,64,1556,1,62,103,93,2,261,1817
375,SIKKIM,2013,House Wife,0,0,0,0,0,0,0,5,3,1,0,9,9
376,SIKKIM,2013,Service (Government),0,2,4,3,0,9,0,2,1,0,0,3,12
377,SIKKIM,2013,Service (Private),0,6,7,2,2,17,0,4,3,2,0,9,26
378,SIKKIM,2013,Public Sector Undertaking,0,3,11,2,0,16,0,0,2,0,0,2,18
379,SIKKIM,2013,Student,3,3,0,0,0,6,2,3,0,0,0,5,11
380,SIKKIM,2013,Unemployed,0,7,5,1,0,13,0,7,0,0,0,7,20
381,SIKKIM,2013,Self-employed (Business activity),0,17,14,3,0,34,0,6,0,0,0,6,40
382,SIKKIM,2013,Professional Activity,0,0,2,1,0,3,0,2,0,0,0,2,5
383,SIKKIM,2013,Farming/Agriculture Activity,0,9,5,4,3,21,0,8,2,2,2,14,35
384,SIKKIM,2013,Others (Please Specify),0,2,0,0,0,2,0,0,0,0,0,0,2
385,SIKKIM,2013,Retired Person,0,0,0,0,2,2,0,0,0,0,1,1,3
386,SIKKIM,2013,Others (Please Specify),2,0,0,0,0,2,1,0,0,0,0,1,3
387,SIKKIM,2013,Total,5,49,48,16,7,125,3,37,11,5,3,59,184
388,SIKKIM,2013,Total Salaried,0,11,22,7,2,42,0,6,6,2,0,14,56
389,SIKKIM,2013,Total Self-employed,0,28,21,8,3,60,0,16,2,2,2,22,82
390,TAMIL NADU,2013,House Wife,0,0,0,0,0,0,0,993,924,435,244,2596,2596
391,TAMIL NADU,2013,Service (Government),0,26,73,63,0,162,0,12,9,11,0,32,194
392,TAMIL NADU,2013,Service (Private),0,343,582,424,94,1443,0,133,70,39,9,251,1694
393,TAMIL NADU,2013,Public Sector Undertaking,0,54,65,64,16,199,0,16,17,9,1,43,242
394,TAMIL NADU,2013,Student,96,384,17,0,0,497,76,282,11,0,0,369,866
395,TAMIL NADU,2013,Unemployed,0,400,382,332,98,1212,0,139,77,63,18,297,1509
396,TAMIL NADU,2013,Self-employed (Business activity),0,220,372,340,68,1000,0,20,23,16,3,62,1062
397,TAMIL NADU,2013,Professional Activity,0,97,233,128,32,490,0,17,19,12,3,51,541
398,TAMIL NADU,2013,Farming/Agriculture Activity,0,12,24,43,17,96,0,4,3,2,0,9,105
399,TAMIL NADU,2013,Others (Please Specify),21,551,1019,777,428,2796,5,138,150,62,37,392,3188
400,TAMIL NADU,2013,Retired Person,0,0,0,22,80,102,0,0,0,0,14,14,116
401,TAMIL NADU,2013,Others (Please Specify),73,729,1049,853,481,3185,74,532,330,241,126,1303,4488
402,TAMIL NADU,2013,Total,190,2816,3816,3046,1314,11182,155,2286,1633,890,455,5419,16601
403,TAMIL NADU,2013,Total Salaried,0,423,720,551,110,1804,0,161,96,59,10,326,2130
404,TAMIL NADU,2013,Total Self-employed,21,880,1648,1288,545,4382,5,179,195,92,43,514,4896
405,TRIPURA,2013,House Wife,0,0,0,0,0,0,0,72,44,34,13,163,163
406,TRIPURA,2013,Service (Government),0,1,3,0,0,4,0,0,0,0,0,0,4
407,TRIPURA,2013,Service (Private),0,2,2,0,0,4,0,0,0,0,0,0,4
408,TRIPURA,2013,Public Sector Undertaking,0,0,1,0,0,1,0,0,0,0,0,0,1
409,TRIPURA,2013,Student,8,71,5,0,0,84,4,42,0,0,0,46,130
410,TRIPURA,2013,Unemployed,0,20,31,5,1,57,0,6,2,1,0,9,66
411,TRIPURA,2013,Self-employed (Business activity),0,2,34,26,10,72,0,1,1,0,0,2,74
412,TRIPURA,2013,Professional Activity,0,0,0,0,0,0,0,0,0,0,0,0,0
413,TRIPURA,2013,Farming/Agriculture Activity,0,4,17,24,11,56,0,0,0,0,0,0,56
414,TRIPURA,2013,Others (Please Specify),0,0,0,0,0,0,0,0,0,0,0,0,0
415,TRIPURA,2013,Retired Person,0,0,0,0,0,0,0,0,0,0,0,0,0
416,TRIPURA,2013,Others (Please Specify),16,114,124,80,24,358,19,27,22,17,20,105,463
417,TRIPURA,2013,Total,24,214,217,135,46,636,23,148,69,52,33,325,961
418,TRIPURA,2013,Total Salaried,0,3,6,0,0,9,0,0,0,0,0,0,9
419,TRIPURA,2013,Total Self-employed,0,6,51,50,21,128,0,1,1,0,0,2,130
420,UTTAR PRADESH,2013,House Wife,0,0,0,0,0,0,5,605,375,145,40,1170,1170
421,UTTAR PRADESH,2013,Service (Government),0,8,22,13,2,45,0,11,5,2,0,18,63
422,UTTAR PRADESH,2013,Service (Private),0,151,186,97,12,446,0,67,39,20,1,127,573
423,UTTAR PRADESH,2013,Public Sector Undertaking,0,36,31,19,4,90,1,10,6,4,1,22,112
424,UTTAR PRADESH,2013,Student,41,154,26,6,0,227,20,149,7,2,0,178,405
425,UTTAR PRADESH,2013,Unemployed,3,111,100,83,16,313,2,16,22,17,0,57,370
426,UTTAR PRADESH,2013,Self-employed (Business activity),0,83,98,57,11,249,0,9,9,3,0,21,270
427,UTTAR PRADESH,2013,Professional Activity,0,26,29,13,0,68,0,4,3,0,0,7,75
428,UTTAR PRADESH,2013,Farming/Agriculture Activity,5,215,235,156,33,644,5,39,49,11,2,106,750
429,UTTAR PRADESH,2013,Others (Please Specify),7,108,151,89,26,381,6,72,36,35,2,151,532
430,UTTAR PRADESH,2013,Retired Person,0,0,2,0,7,9,0,0,5,1,3,9,18
431,UTTAR PRADESH,2013,Others (Please Specify),56,145,246,156,88,691,23,125,69,32,8,257,948
432,UTTAR PRADESH,2013,Total,112,1037,1126,689,199,3163,62,1107,625,272,57,2123,5286
433,UTTAR PRADESH,2013,Total Salaried,0,195,239,129,18,581,1,88,50,26,2,167,748
434,UTTAR PRADESH,2013,Total Self-employed,12,432,513,315,70,1342,11,124,97,49,4,285,1627
435,UTTARAKHAND,2013,House Wife,0,0,0,0,0,0,0,14,9,10,1,34,34
436,UTTARAKHAND,2013,Service (Government),0,5,4,4,1,14,0,0,0,0,0,0,14
437,UTTARAKHAND,2013,Service (Private),0,12,15,5,1,33,0,2,0,0,0,2,35
438,UTTARAKHAND,2013,Public Sector Undertaking,0,4,3,1,0,8,0,0,0,0,0,0,8
439,UTTARAKHAND,2013,Student,0,24,0,1,0,25,0,15,0,0,0,15,40
440,UTTARAKHAND,2013,Unemployed,0,16,5,4,0,25,0,2,0,0,0,2,27
441,UTTARAKHAND,2013,Self-employed (Business activity),0,2,8,3,0,13,0,0,0,0,0,0,13
442,UTTARAKHAND,2013,Professional Activity,0,0,0,0,0,0,0,0,0,0,0,0,0
443,UTTARAKHAND,2013,Farming/Agriculture Activity,0,4,6,4,0,14,0,0,1,0,0,1,15
444,UTTARAKHAND,2013,Others (Please Specify),0,14,6,7,0,27,2,1,1,0,1,5,32
445,UTTARAKHAND,2013,Retired Person,0,0,0,2,2,4,0,0,0,0,0,0,4
446,UTTARAKHAND,2013,Others (Please Specify),4,13,45,12,7,81,5,25,28,3,1,62,143
447,UTTARAKHAND,2013,Total,4,94,92,43,11,244,7,59,39,13,3,121,365
448,UTTARAKHAND,2013,Total Salaried,0,21,22,10,2,55,0,2,0,0,0,2,57
449,UTTARAKHAND,2013,Total Self-employed,0,20,20,14,0,54,2,1,2,0,1,6,60
450,WEST BENGAL,2013,House Wife,0,0,0,0,0,0,0,740,847,399,117,2103,2103
451,WEST BENGAL,2013,Service (Government),0,13,29,36,3,81,0,2,2,1,0,5,86
452,WEST BENGAL,2013,Service (Private),0,105,263,206,8,582,0,36,50,33,0,119,701
453,WEST BENGAL,2013,Public Sector Undertaking,0,115,164,67,8,354,0,28,27,15,2,72,426
454,WEST BENGAL,2013,Student,79,357,28,0,0,464,49,257,18,0,0,324,788
455,WEST BENGAL,2013,Unemployed,1,249,326,191,31,798,12,129,169,71,15,396,1194
456,WEST BENGAL,2013,Self-employed (Business activity),0,180,406,239,48,873,0,62,55,9,0,126,999
457,WEST BENGAL,2013,Professional Activity,0,42,142,84,6,274,0,11,7,7,1,26,300
458,WEST BENGAL,2013,Farming/Agriculture Activity,0,0,0,0,0,0,0,0,0,0,0,0,0
459,WEST BENGAL,2013,Others (Please Specify),34,389,559,342,67,1391,19,243,177,68,19,526,1917
460,WEST BENGAL,2013,Retired Person,0,0,0,5,62,67,0,0,0,0,8,8,75
461,WEST BENGAL,2013,Others (Please Specify),70,840,1030,782,254,2976,34,506,577,291,82,1490,4466
462,WEST BENGAL,2013,Total,184,2290,2947,1952,487,7860,114,2014,1929,894,244,5195,13055
463,WEST BENGAL,2013,Total Salaried,0,233,456,309,19,1017,0,66,79,49,2,196,1213
464,WEST BENGAL,2013,Total Self-employed,34,611,1107,665,121,2538,19,316,239,84,20,678,3216
465,A & N ISLANDS,2013,House Wife,0,0,0,0,0,0,0,10,7,3,1,21,21
466,A & N ISLANDS,2013,Service (Government),0,2,8,9,0,19,0,0,1,1,0,2,21
467,A & N ISLANDS,2013,Service (Private),0,25,18,16,5,64,0,0,1,0,0,1,65
468,A & N ISLANDS,2013,Public Sector Undertaking,0,0,0,0,1,1,0,0,0,0,0,0,1
469,A & N ISLANDS,2013,Student,4,8,0,0,0,12,2,8,0,0,0,10,22
470,A & N ISLANDS,2013,Unemployed,0,0,2,0,1,3,0,4,2,0,0,6,9
471,A & N ISLANDS,2013,Self-employed (Business activity),0,0,1,2,0,3,0,0,0,0,0,0,3
472,A & N ISLANDS,2013,Professional Activity,0,0,0,0,0,0,0,0,0,0,0,0,0
473,A & N ISLANDS,2013,Farming/Agriculture Activity,0,0,0,1,4,5,0,0,0,0,0,0,5
474,A & N ISLANDS,2013,Others (Please Specify),0,0,0,0,0,0,0,0,0,0,0,0,0
475,A & N ISLANDS,2013,Retired Person,0,0,0,0,4,4,0,0,0,0,0,0,4
476,A & N ISLANDS,2013,Others (Please Specify),0,0,0,0,0,0,0,0,0,0,0,0,0
477,A & N ISLANDS,2013,Total,4,35,29,28,15,111,2,22,11,4,1,40,151
478,A & N ISLANDS,2013,Total Salaried,0,27,26,25,6,84,0,0,2,1,0,3,87
479,A & N ISLANDS,2013,Total Self-employed,0,0,1,3,4,8,0,0,0,0,0,0,8
480,CHANDIGARH,2013,House Wife,0,0,0,0,0,0,0,10,9,2,0,21,21
481,CHANDIGARH,2013,Service (Government),0,0,0,3,0,3,0,0,0,0,0,0,3
482,CHANDIGARH,2013,Service (Private),0,10,11,6,2,29,0,0,0,0,0,0,29
483,CHANDIGARH,2013,Public Sector Undertaking,0,0,3,0,0,3,0,0,0,0,0,0,3
484,CHANDIGARH,2013,Student,0,8,0,0,0,8,1,14,0,0,0,15,23
485,CHANDIGARH,2013,Unemployed,0,2,0,0,0,2,0,0,0,0,0,0,2
486,CHANDIGARH,2013,Self-employed (Business activity),0,1,0,0,0,1,0,0,0,0,0,0,1
487,CHANDIGARH,2013,Professional Activity,0,0,0,0,0,0,0,0,0,0,0,0,0
488,CHANDIGARH,2013,Farming/Agriculture Activity,0,0,0,0,0,0,0,0,0,0,0,0,0
489,CHANDIGARH,2013,Others (Please Specify),0,7,4,2,0,13,0,2,0,0,0,2,15
490,CHANDIGARH,2013,Retired Person,0,0,0,0,0,0,0,0,0,0,0,0,0
491,CHANDIGARH,2013,Others (Please Specify),0,0,0,0,0,0,0,0,0,0,0,0,0
492,CHANDIGARH,2013,Total,0,28,18,11,2,59,1,26,9,2,0,38,97
493,CHANDIGARH,2013,Total Salaried,0,10,14,9,2,35,0,0,0,0,0,0,35
494,CHANDIGARH,2013,Total Self-employed,0,8,4,2,0,14,0,2,0,0,0,2,16
495,D & N HAVELI,2013,House Wife,0,0,0,0,0,0,0,7,4,4,3,18,18
496,D & N HAVELI,2013,Service (Government),0,0,0,0,0,0,0,1,1,0,0,2,2
497,D & N HAVELI,2013,Service (Private),0,0,0,0,0,0,0,0,0,0,0,0,0
498,D & N HAVELI,2013,Public Sector Undertaking,0,11,4,2,0,17,0,0,0,1,0,1,18
499,D & N HAVELI,2013,Student,0,4,0,0,0,4,0,5,0,0,0,5,9
500,D & N HAVELI,2013,Unemployed,0,8,0,0,0,8,0,0,0,0,0,0,8
501,D & N HAVELI,2013,Self-employed (Business activity),0,0,0,0,0,0,0,0,0,0,0,0,0
502,D & N HAVELI,2013,Professional Activity,0,0,0,0,0,0,0,0,0,0,0,0,0
503,D & N HAVELI,2013,Farming/Agriculture Activity,0,0,4,9,2,15,0,0,0,0,0,0,15
504,D & N HAVELI,2013,Others (Please Specify),0,0,0,0,0,0,0,0,0,0,0,0,0
505,D & N HAVELI,2013,Retired Person,0,0,0,0,0,0,0,0,0,0,0,0,0
506,D & N HAVELI,2013,Others (Please Specify),0,1,4,6,0,11,0,0,0,0,3,3,14
507,D & N HAVELI,2013,Total,0,24,12,17,2,55,0,13,5,5,6,29,84
508,D & N HAVELI,2013,Total Salaried,0,11,4,2,0,17,0,1,1,1,0,3,20
509,D & N HAVELI,2013,Total Self-employed,0,0,4,9,2,15,0,0,0,0,0,0,15
510,DAMAN & DIU,2013,House Wife,0,0,0,0,0,0,0,4,4,2,0,10,10
511,DAMAN & DIU,2013,Service (Government),0,0,0,1,0,1,0,0,0,0,0,0,1
512,DAMAN & DIU,2013,Service (Private),0,6,2,2,0,10,0,1,1,1,0,3,13
513,DAMAN & DIU,2013,Public Sector Undertaking,0,0,0,0,0,0,0,0,0,0,0,0,0
514,DAMAN & DIU,2013,Student,0,1,0,0,0,1,0,3,0,0,0,3,4
515,DAMAN & DIU,2013,Unemployed,0,0,0,0,0,0,0,0,0,0,0,0,0
516,DAMAN & DIU,2013,Self-employed (Business activity),0,0,0,0,0,0,0,0,0,0,0,0,0
517,DAMAN & DIU,2013,Professional Activity,0,0,0,0,0,0,0,0,0,0,0,0,0
518,DAMAN & DIU,2013,Farming/Agriculture Activity,0,0,0,0,0,0,0,0,0,0,0,0,0
519,DAMAN & DIU,2013,Others (Please Specify),0,1,0,0,0,1,0,0,0,0,0,0,1
520,DAMAN & DIU,2013,Retired Person,0,0,0,0,0,0,0,0,0,0,0,0,0
521,DAMAN & DIU,2013,Others (Please Specify),0,0,0,0,0,0,0,0,0,0,0,0,0
522,DAMAN & DIU,2013,Total,0,8,2,3,0,13,0,8,5,3,0,16,29
523,DAMAN & DIU,2013,Total Salaried,0,6,2,3,0,11,0,1,1,1,0,3,14
524,DAMAN & DIU,2013,Total Self-employed,0,1,0,0,0,1,0,0,0,0,0,0,1
525,DELHI (UT),2013,House Wife,0,0,0,0,0,0,0,175,86,21,4,286,286
526,DELHI (UT),2013,Service (Government),0,8,15,7,0,30,0,4,2,2,0,8,38
527,DELHI (UT),2013,Service (Private),0,62,65,32,0,159,0,9,4,0,0,13,172
528,DELHI (UT),2013,Public Sector Undertaking,0,20,25,8,0,53,0,8,1,0,0,9,62
529,DELHI (UT),2013,Student,13,110,2,0,0,125,19,102,4,0,0,125,250
530,DELHI (UT),2013,Unemployed,0,145,118,37,9,309,0,23,4,1,1,29,338
531,DELHI (UT),2013,Self-employed (Business activity),0,14,9,11,2,36,0,0,0,0,0,0,36
532,DELHI (UT),2013,Professional Activity,0,4,4,1,3,12,0,0,0,0,0,0,12
533,DELHI (UT),2013,Farming/Agriculture Activity,0,3,2,2,0,7,0,1,0,0,0,1,8
534,DELHI (UT),2013,Others (Please Specify),0,55,92,28,7,182,0,28,7,2,2,39,221
535,DELHI (UT),2013,Retired Person,0,0,1,1,13,15,0,0,0,0,0,0,15
536,DELHI (UT),2013,Others (Please Specify),8,167,177,71,66,489,5,70,45,10,2,132,621
537,DELHI (UT),2013,Total,21,588,510,198,100,1417,24,420,153,36,9,642,2059
538,DELHI (UT),2013,Total Salaried,0,90,105,47,0,242,0,21,7,2,0,30,272
539,DELHI (UT),2013,Total Self-employed,0,76,107,42,12,237,0,29,7,2,2,40,277
540,LAKSHADWEEP,2013,House Wife,0,0,0,0,0,0,0,0,1,0,0,1,1
541,LAKSHADWEEP,2013,Service (Government),0,0,0,0,0,0,0,0,0,0,0,0,0
542,LAKSHADWEEP,2013,Service (Private),0,0,0,0,0,0,0,0,0,0,0,0,0
543,LAKSHADWEEP,2013,Public Sector Undertaking,0,0,0,0,0,0,0,0,0,0,0,0,0
544,LAKSHADWEEP,2013,Student,0,0,0,0,0,0,0,0,0,0,0,0,0
545,LAKSHADWEEP,2013,Unemployed,0,0,0,0,0,0,0,1,0,0,0,1,1
546,LAKSHADWEEP,2013,Self-employed (Business activity),0,0,0,0,0,0,0,0,0,0,0,0,0
547,LAKSHADWEEP,2013,Professional Activity,0,0,0,0,0,0,0,0,0,0,0,0,0
548,LAKSHADWEEP,2013,Farming/Agriculture Activity,0,0,0,0,0,0,0,0,0,0,0,0,0
549,LAKSHADWEEP,2013,Others (Please Specify),0,0,0,0,0,0,0,0,0,0,0,0,0
550,LAKSHADWEEP,2013,Retired Person,0,0,0,0,0,0,0,0,0,0,0,0,0
551,LAKSHADWEEP,2013,Others (Please Specify),0,0,0,0,1,1,0,0,0,0,0,0,1
552,LAKSHADWEEP,2013,Total,0,0,0,0,1,1,0,1,1,0,0,2,3
553,LAKSHADWEEP,2013,Total Salaried,0,0,0,0,0,0,0,0,0,0,0,0,0
554,LAKSHADWEEP,2013,Total Self-employed,0,0,0,0,0,0,0,0,0,0,0,0,0
555,PUDUCHERRY,2013,House Wife,0,0,0,0,0,0,0,26,34,10,18,88,88
556,PUDUCHERRY,2013,Service (Government),0,5,4,15,0,24,0,0,0,1,0,1,25
557,PUDUCHERRY,2013,Service (Private),0,14,12,4,4,34,0,10,2,0,0,12,46
558,PUDUCHERRY,2013,Public Sector Undertaking,0,0,1,0,0,1,0,0,0,0,0,0,1
559,PUDUCHERRY,2013,Student,3,9,0,0,0,12,2,23,1,0,0,26,38
560,PUDUCHERRY,2013,Unemployed,0,13,11,22,20,66,0,4,0,1,0,5,71
561,PUDUCHERRY,2013,Self-employed (Business activity),0,25,56,44,3,128,0,3,2,0,0,5,133
562,PUDUCHERRY,2013,Professional Activity,0,0,0,0,0,0,0,0,0,0,0,0,0
563,PUDUCHERRY,2013,Farming/Agriculture Activity,0,0,0,0,0,0,0,0,0,0,0,0,0
564,PUDUCHERRY,2013,Others (Please Specify),0,18,48,63,8,137,0,0,1,0,0,1,138
565,PUDUCHERRY,2013,Retired Person,0,0,0,2,4,6,0,0,0,0,0,0,6
566,PUDUCHERRY,2013,Others (Please Specify),0,0,0,0,0,0,0,0,0,0,0,0,0
567,PUDUCHERRY,2013,Total,3,84,132,150,39,408,2,66,40,12,18,138,546
568,PUDUCHERRY,2013,Total Salaried,0,19,17,19,4,59,0,10,2,1,0,13,72
569,PUDUCHERRY,2013,Total Self-employed,0,43,104,107,11,265,0,3,3,0,0,6,271
